4,2.5,2680,7200,3,8,1380,1300,800000
3,1,970,6600,3,7,970,0,165000
3,1.75,1680,8460,3,7,1180,500,419600
3,1.5,1490,10367,3,7,1010,480,285000
2,1,800,6016,3,6,800,0,405000
4,4.5,5250,48352,3,10,5250,0,915000
6,4.25,5480,189050,4,10,5140,340,800000
2,1,970,2700,4,7,770,200,425000
3,3.25,2670,5108,3,9,2670,0,535000
3,1.75,1920,4500,5,7,960,960,675000
4,2.5,1900,5001,3,8,1200,700,500000
4,2.5,5760,32033,4,12,4390,1370,2.88E+06
2,2,750,6553,3,7,750,0,258000
4,4,5280,17677,3,11,3220,2060,1.55E+06
3,2,1678,13862,3,7,1678,0,353000
4,3.25,3610,4000,3,9,2640,970,1.01E+06
6,2.5,3060,17112,4,8,1530,1530,400000
4,2.5,2010,7972,4,8,2010,0,590000
2,2,1440,1170,3,9,960,480,435000
4,2.25,3380,9900,4,8,1690,1690,470000
3,2.25,1670,7606,3,7,1670,0,235000
4,2.5,2090,10306,3,10,2090,0,632500
3,2.5,1610,3516,3,8,1610,0,305000
5,4.5,5130,43123,3,11,5130,0,1.60E+06
3,3.25,1760,1778,3,8,1760,0,469950
4,1,1390,17739,3,7,1390,0,261000
4,3.5,3280,6603,3,10,3280,0,963000
3,1,1340,18000,4,7,1340,0,297000
3,2,1790,42399,4,7,1790,0,280000
4,2.75,2930,22000,4,9,1580,1350,560000
3,2.25,1900,46609,4,7,1440,460,600000
3,1.75,2170,26460,3,8,1450,720,510000
3,2,1410,10625,3,7,1410,0,230000
3,2,1360,2500,3,7,730,630,499950
4,2.5,2870,8995,5,8,1870,1000,710000
3,2.5,1690,7460,3,7,870,820,285000
4,2.75,2650,6717,3,10,2650,0,545000
3,2.25,1780,191228,3,8,1780,0,545000
4,2.5,2240,4616,3,7,1840,400,450000
4,1,1340,5800,3,7,1340,0,455000
3,2.75,1440,7350,4,7,1040,400,330490
4,2.5,2160,8049,3,9,2160,0,317000
3,2.5,1480,1961,3,8,1480,0,450000
2,1,1280,21750,5,6,1280,0,170000
4,3.5,3440,9776,3,10,3440,0,1.33E+06
4,1,1620,4080,3,7,1620,0,485000
4,1.75,1830,29110,3,8,1230,600,610000
3,2,1560,2589,3,7,790,770,604000
3,1.75,2180,9220,4,7,1090,1090,389000
3,2.25,2000,18099,4,8,1250,750,526000
3,2,1600,16530,5,7,1600,0,525000
3,2.5,2380,214315,3,9,2380,0,446250
4,2.75,2760,18306,3,7,1630,1130,492500
4,2.75,3140,10918,3,8,1900,1240,570000
4,2.5,2580,10631,4,9,2580,0,865000
3,3,4040,7200,4,9,3340,700,2.25E+06
3,1,1260,6000,3,7,1260,0,550000
3,2.5,1910,4755,3,8,1910,0,390000
3,2.5,2470,4565,3,7,2470,0,445000
4,2,2240,11040,5,8,1120,1120,649000
3,1.75,1050,9871,5,7,1050,0,199000
4,2.5,2540,5760,3,9,2540,0,759990
4,2.25,2100,3671,3,8,1750,350,840000
4,2.5,2160,3139,3,7,1080,1080,650000
5,3,3880,8432,3,7,3880,0,430000
4,3.25,3830,8331,3,9,3830,0,1.05E+06
3,2.5,2190,5071,3,8,2190,0,379900
4,3.75,3920,4500,3,8,3920,0,1.17E+06
3,1.75,1660,9600,3,8,1380,280,420000
2,1,910,3600,4,7,910,0,605000
3,1.75,2150,8925,4,7,2150,0,437400
2,1,650,5400,3,6,650,0,295000
3,1.5,1420,5000,3,7,920,500,205000
3,1,980,8000,4,6,980,0,204000
4,2.5,3360,11548,3,9,3360,0,950000
3,2.5,2240,3691,3,7,2240,0,300000
3,2,1870,3388,4,8,1230,640,650000
3,1,1010,9611,4,6,1010,0,241000
3,2,1810,10684,3,8,1810,0,252500
3,3.25,2660,17852,3,8,2660,0,379000
3,2,1200,7320,3,7,1200,0,460000
2,1,830,4000,4,6,830,0,455000
3,2.5,1470,1445,3,8,1160,310,420000
3,2.5,2080,9612,4,8,1700,380,689000
3,1.75,1400,13775,3,8,1400,0,450000
4,2.25,2240,5000,3,8,2240,0,635000
3,2.5,2150,5193,3,8,2150,0,587000
4,2.5,2020,7200,5,7,1010,1010,495000
4,2.5,2440,11005,3,9,2440,0,548000
4,1,1420,6000,3,7,1420,0,475000
3,2.25,1780,9969,3,8,1450,330,450000
5,4,5610,22529,3,11,4090,1520,995000
3,1.75,2190,7021,4,7,1390,800,353000
6,3.5,3600,6875,3,8,2740,860,620000
3,1.75,1540,7490,5,7,1540,0,450000
2,2,1050,1173,3,8,720,330,400000
3,1.75,1830,27468,3,7,1830,0,398000
3,2.5,1850,3400,3,7,1850,0,359782
4,2.75,2890,6825,3,8,1560,1330,585000
4,2.5,2880,9202,3,8,1780,1100,680000
3,2.5,1890,4808,3,8,1890,0,465000
3,3.25,2210,3600,3,8,1820,390,429000
3,1.75,1160,5200,4,7,1160,0,199500
3,1,1010,3520,3,7,1010,0,525000
3,2.75,2780,7200,4,8,1870,910,709000
3,2,970,10000,5,7,970,0,339300
3,2,1570,5706,3,7,1570,0,265000
4,3,3090,35074,3,9,3090,0,855000
3,2.75,1830,208216,3,8,1830,0,495000
3,1.75,2050,10519,3,7,1240,810,265000
3,1,1200,5525,2,7,1200,0,289500
4,2.5,1780,6000,3,7,1780,0,175000
2,1,990,4000,4,7,990,0,747000
5,5,3960,94089,3,10,3960,0,1.18E+06
5,2.5,3670,8960,3,8,3670,0,731000
4,1.75,2420,520,3,7,2420,0,700000
5,2.75,2870,6593,3,9,2870,0,730000
4,2.75,1800,7750,4,8,1400,400,550000
3,1,1010,5864,3,7,1010,0,425000
5,2.5,2600,3839,3,7,2600,0,330000
3,1,1790,3876,5,7,1090,700,350000
3,2,1290,6150,5,6,1290,0,310000
4,2.5,2780,7985,4,10,2780,0,717000
3,2,2080,4549,5,7,1040,1040,616500
2,1.5,1076,1060,3,7,1076,0,290000
3,1,1380,5864,3,7,790,590,322000
6,3,2530,9000,3,6,2530,0,830000
3,1.75,1290,9760,3,7,1290,0,275000
3,3.25,2620,7215,4,8,1770,850,900000
4,2.5,3430,43560,5,10,3430,0,960000
3,2,1110,8724,4,7,1110,0,235000
2,1,890,6000,2,6,890,0,180000
4,3,2240,6000,4,8,1270,970,1.19E+06
7,2.5,1940,5458,3,7,1940,0,280000
2,1,1200,8063,4,6,1200,0,232000
4,2.75,3010,15992,3,11,3010,0,775000
3,1,1170,7560,3,6,1170,0,145600
4,2.75,4020,18745,4,10,2830,1190,1.95E+06
3,2.5,1640,7668,3,7,1640,0,265000
3,2,1420,9828,4,7,1420,0,241400
5,3.5,4180,17935,3,11,4180,0,1.89E+06
2,1.5,1450,3840,3,7,950,500,557000
5,2.25,2590,7245,3,8,1510,1080,539000
3,2.75,2680,20104,5,9,1820,860,1.32E+06
5,3.25,4230,21455,3,10,2720,1510,875000
4,2.25,2410,4250,5,7,1460,950,735000
3,2.25,1860,1386,3,9,1860,0,799950
2,2.25,1550,2285,3,8,1550,0,325000
4,3.5,2770,24140,3,8,2770,0,550000
3,1,1400,6879,3,7,1400,0,403000
2,1,1050,6317,4,7,1050,0,349950
4,2.5,2850,6809,3,9,2850,0,550000
4,4,4500,11795,3,12,4500,0,1.52E+06
3,1,1290,10125,4,7,1290,0,362000
4,2.5,3560,6187,3,9,3560,0,770000
4,2.5,1940,7607,3,8,1940,0,500000
3,1,1130,7014,3,7,1130,0,205000
4,2.5,2300,4249,3,8,2300,0,353000
3,2,1570,5600,3,8,1570,0,325000
3,2.5,1880,6008,3,7,1880,0,284000
3,2.25,1970,4564,3,8,1470,500,625000
5,1,2010,5210,3,9,1890,120,1.00E+06
5,2.5,3810,15916,5,8,3810,0,515000
3,1.75,1120,98445,4,7,1120,0,316000
4,2.5,3650,7784,3,9,3650,0,835000
4,2.5,2550,5395,3,8,2550,0,561000
3,2.5,2400,99752,3,9,2400,0,590000
6,1.75,2740,6360,3,8,1370,1370,675000
3,2.5,2410,11900,4,9,1600,810,490000
4,2.5,2245,4301,3,8,2245,0,362865
2,2,1880,5400,3,8,1880,0,751750
4,3,2090,7500,3,7,1370,720,338000
4,2.5,3510,6745,3,10,3510,0,900000
4,2.75,2810,5497,3,9,2810,0,750000
4,2.75,2930,4408,5,8,1660,1270,718000
3,2.25,2100,3000,3,7,2100,0,495000
4,4.5,6640,53330,3,12,6640,0,1.82E+06
2,1.75,1280,6774,3,7,1280,0,193000
4,2.5,2790,45902,3,9,2790,0,654950
3,2.5,2000,9202,4,7,2000,0,225000
3,2,1400,1657,3,8,1060,340,570000
3,2,1490,7929,3,7,1490,0,245000
4,2.5,2140,7350,3,8,2140,0,365000
3,1.5,2390,32109,3,7,2390,0,400000
3,1.75,1320,6530,4,7,1320,0,262000
5,4.25,4050,18827,4,10,2150,1900,1.38E+06
4,2.25,1900,9600,4,7,1900,0,215000
2,1,670,4500,3,5,670,0,157500
3,1,1290,189486,4,7,1290,0,359950
2,1,920,5250,4,6,920,0,200000
4,2.5,2170,7700,3,7,1420,750,465000
3,1.75,1590,9636,4,6,1590,0,346000
2,1,910,7617,3,6,910,0,235000
5,2,3930,10150,4,8,3070,860,589000
4,2.5,3200,7282,3,9,3200,0,360000
3,1,1460,8227,3,6,880,580,470000
2,1.5,1660,4680,5,6,830,830,368000
2,1,1360,69260,4,5,1360,0,335000
4,2.25,2810,25990,3,8,1860,950,571500
4,2.5,2340,8548,3,8,2340,0,390000
4,2.5,1714,3080,3,8,1714,0,307000
4,1.75,2100,10358,5,8,1280,820,457000
2,1,740,7380,4,6,740,0,213000
3,1.75,2060,3500,5,7,1030,1030,499950
3,1.5,1330,8636,4,7,1330,0,374500
4,2,1220,7489,3,7,1220,0,935000
4,2,2130,2800,5,7,1070,1060,800000
2,1,1240,5000,3,7,1000,240,645000
5,2.75,3130,9450,4,8,1580,1550,302300
3,2.25,1630,1598,3,8,1630,0,385000
4,2.5,1620,4000,3,7,1620,0,305000
3,3.5,1650,2262,3,8,1650,0,547500
3,3,1460,1180,3,8,1460,0,437000
3,1,1090,10000,3,6,1090,0,240000
4,2.25,2270,9600,3,7,1290,980,304999
4,2,2070,9822,5,7,2070,0,550000
3,1,1330,45738,2,6,1330,0,235000
3,1.5,1900,9630,3,8,1900,0,230000
3,2.25,1420,8549,4,7,1420,0,275000
4,2.5,2070,7007,3,7,2070,0,320000
5,2.25,2480,12614,4,8,1860,620,585000
4,2.25,3390,39356,4,8,1640,1750,490000
4,2.5,2270,9247,5,8,1500,770,619850
3,1.75,1380,4590,2,7,930,450,350000
3,1.75,1610,10229,5,8,1610,0,648000
3,2.5,2360,9938,3,8,1690,670,572000
5,3,3070,9804,4,9,1740,1330,718000
4,2,1960,5008,3,6,980,980,450000
4,1.75,2350,5946,3,8,1350,1000,555000
3,2.75,1960,2500,5,7,1410,550,599000
4,1,1600,10183,4,6,1600,0,154950
2,1.75,1170,4887,3,6,1020,150,459000
4,2.25,3220,7889,3,8,3220,0,335000
4,2.5,3130,12463,4,8,1620,1510,675000
4,2.5,2570,8178,3,8,1710,860,752000
4,2.5,2760,5000,5,7,1680,1080,734200
2,1,970,5750,4,6,970,0,345000
4,2.5,2628,11466,3,9,2628,0,499160
4,2.5,3090,12511,4,10,3090,0,780000
2,1,880,4000,3,7,880,0,427550
3,1,1290,12005,4,7,1290,0,658000
2,1,670,4720,4,6,670,0,107000
2,1,1310,7697,3,6,850,460,187300
4,2.25,2320,8760,4,8,1160,1160,248000
4,2.5,2400,10364,3,8,2400,0,485000
2,1.75,1460,4800,5,7,850,610,540000
3,1.75,1470,873,3,10,1470,0,687015
3,3.25,2170,12508,5,9,1650,520,876650
2,1,950,4080,4,7,950,0,550000
3,2.25,1480,1384,3,8,1480,0,436000
3,2.25,1646,7364,3,7,1646,0,307500
4,3.5,4010,10880,4,11,3150,860,1.39E+06
3,3.25,2640,16090,4,8,1960,680,885000
3,1.75,1470,9750,4,7,1470,0,490000
4,2.5,2810,4922,3,9,2810,0,702000
3,1,1490,7200,3,7,1490,0,300000
3,2.5,2300,9752,3,8,2300,0,765000
4,1.75,2690,46609,3,7,2690,0,390000
3,2.5,1760,2688,3,7,1760,0,294500
3,1,1400,9690,3,7,1400,0,128000
2,1.75,2430,23400,3,10,2430,0,1.00E+06
3,2.75,2150,6576,4,7,1900,250,310000
3,1,960,5264,3,7,960,0,406000
4,3.5,4490,5805,3,9,3390,1100,689000
4,2.75,2630,15000,4,7,1690,940,500000
4,2.25,2780,15075,3,7,2780,0,439950
3,1,950,6951,4,7,950,0,395000
6,1.75,2180,4000,4,7,1380,800,580000
3,2.5,2010,2778,3,8,1390,620,462608
4,2,1370,8100,2,7,1370,0,420550
4,2.5,3110,5868,3,8,3110,0,399950
3,2.5,1650,4218,3,8,1650,0,485000
4,2.5,3770,10893,3,11,3770,0,1.04E+06
3,2.5,2538,4600,3,8,2538,0,335606
3,1.75,1440,7112,3,7,1180,260,410000
2,1,1350,3880,3,6,950,400,350000
3,2.5,1800,8518,3,7,1800,0,180500
3,2.5,1890,11036,3,8,1460,430,441000
4,3,2380,5125,4,7,1680,700,470000
5,3,2570,5590,3,8,1580,990,540000
2,2.25,1060,925,3,8,980,80,475000
3,2.5,2430,54059,3,10,2430,0,770000
5,3.5,5470,35071,3,11,4590,880,975000
4,2.5,2830,6536,3,8,2830,0,533000
5,3.25,3160,10000,4,8,3160,0,574950
4,2.5,3753,7204,3,10,3336,417,363000
3,1.5,2310,3360,3,8,1790,520,817000
3,2.5,2040,11211,3,8,2040,0,417000
3,1,1080,16000,3,6,1080,0,225000
3,2.75,3860,12786,4,10,3860,0,903000
3,2.75,2692,6197,3,9,2692,0,435000
3,1,1710,6556,4,7,1200,510,440000
3,1,1370,11050,3,7,1370,0,280000
3,2.5,2310,7348,3,8,2310,0,739000
3,2.5,2170,5866,3,7,2170,0,443500
2,1,1110,6411,3,6,1110,0,222900
2,1,960,8450,5,6,960,0,244000
3,1,1730,7210,3,7,1430,300,210000
3,2.25,1540,5449,2,7,1180,360,176000
9,4,4620,5508,3,11,3870,750,1.40E+06
3,2.5,2300,4307,3,8,2300,0,500000
3,1,1620,13803,4,6,1620,0,260656
4,2.5,2990,5122,3,8,2990,0,600000
4,1.75,2570,8640,4,8,2570,0,762450
3,2,1480,3876,5,7,860,620,663000
4,1.75,2260,41236,4,8,1690,570,679000
3,1,1480,7374,3,6,760,720,270000
4,3,2990,6695,3,10,2990,0,1.06E+06
3,1.75,1440,8040,3,7,960,480,315275
3,2.25,1430,9150,3,7,1070,360,210000
5,2.5,2820,9956,4,7,1410,1410,318000
3,1.75,1420,7650,4,7,1100,320,310000
6,2.5,2270,11970,3,7,1470,800,435000
4,2.5,2030,9905,4,8,2030,0,621000
5,2.5,2450,6994,3,8,2450,0,345000
3,1.75,1820,22320,3,7,1250,570,420000
5,3.25,5790,12739,3,10,4430,1360,1.75E+06
4,2.5,2430,5366,3,8,2430,0,321000
3,1.75,1570,8750,3,7,1570,0,240000
4,1,1880,6288,3,7,1120,760,280000
4,1.5,2190,13660,3,8,2190,0,625000
3,2,2160,105415,3,10,2160,0,895000
2,2.5,1350,944,3,9,870,480,439000
3,1,1660,9600,3,7,1660,0,360000
2,1,1130,8160,4,6,1130,0,207000
3,2.25,1250,871,3,8,1250,0,344000
3,2,1990,3000,3,7,1230,760,569000
2,1.75,1540,4025,4,7,1190,350,570000
4,1,1740,4400,3,7,1740,0,382000
4,1.5,1810,6583,3,7,1500,310,799000
6,4.5,3600,6110,3,9,2510,1090,729999
3,1,1330,10500,3,7,960,370,386900
3,1.5,1660,8738,4,7,1080,580,235000
4,2.5,2110,6069,3,9,2110,0,689000
3,2,2020,10584,3,10,2020,0,629500
4,2.25,2130,10650,4,8,2130,0,686000
3,2,1640,9750,3,7,1640,0,375000
4,2.5,2640,8625,3,8,2640,0,429900
4,1,1350,11507,3,7,1350,0,200000
3,2.5,2330,15536,3,10,2330,0,665000
3,2.5,1470,3971,3,7,1470,0,491150
3,1,1150,10132,4,7,1150,0,200000
3,2.5,1610,10022,3,7,1610,0,280000
3,1,910,10240,4,6,910,0,330000
4,2.5,1982,6406,3,8,1982,0,283200
5,2.5,2510,8050,4,7,1490,1020,475000
3,1,1440,11330,3,7,1440,0,255000
3,1,1990,15375,3,7,1140,850,234550
3,1,1250,6180,3,7,1250,0,233000
5,1.75,1890,9600,4,7,1890,0,322968
3,2.75,3200,12682,3,9,3200,0,618000
5,3.25,3960,321908,4,9,2690,1270,525000
3,3,2980,3730,3,9,2980,0,670000
4,2.75,2270,7375,4,7,1290,980,498000
4,2.5,3030,9687,3,8,2020,1010,471000
3,0.75,2510,20000,4,7,2510,0,363000
4,1,1370,8499,3,7,1370,0,300000
1,0.75,1170,14149,5,7,880,290,275000
4,1.75,1770,9011,5,7,1050,720,264950
3,2.5,1560,4244,3,7,1560,0,275000
3,2.5,1820,8085,3,7,1820,0,329950
3,1,1840,8100,4,7,920,920,340000
4,2.5,2570,4412,3,9,2570,0,655000
3,2.5,1440,5434,3,7,1440,0,440000
2,1.75,1870,6625,3,7,960,910,229500
3,2.5,1861,1587,3,8,1578,283,499000
3,2.25,2510,43995,3,8,2510,0,520000
3,2.25,2580,11060,3,8,2580,0,898000
2,1,910,4635,4,6,910,0,425000
3,2.5,2840,48716,3,9,1870,970,500000
3,1,1020,9835,5,7,1020,0,485000
1,1,680,21727,3,5,680,0,291970
3,2,1680,7900,4,7,1680,0,250000
4,2.75,3980,9209,3,11,3980,0,970000
7,3.5,2870,29699,3,7,1520,1350,475000
3,4,3880,13095,3,11,3700,180,1.03E+06
3,1.75,1510,9837,3,7,1510,0,227000
3,2.5,2160,3738,3,8,2160,0,440000
4,2.25,2020,4840,5,8,1200,820,430000
4,1.75,1980,2700,3,8,1210,770,560000
3,2.5,1300,1187,3,8,1300,0,505500
4,2,2420,31465,3,9,2420,0,399950
3,2,1010,7896,3,7,1010,0,200000
3,1.75,2430,8820,3,8,1630,800,499900
3,1,1060,9126,5,7,1060,0,220000
3,1,940,4700,4,6,940,0,267000
5,3.25,2850,4551,3,8,2370,480,535000
4,1.75,1680,9966,3,7,1100,580,268000
4,2.5,2441,7316,3,8,2441,0,340000
2,1,800,9450,3,6,800,0,180000
2,1,900,23000,2,7,900,0,157340
3,1.75,1500,7560,3,7,1500,0,242000
2,2,2370,155130,3,7,2370,0,750000
4,2.5,2170,9796,4,8,1650,520,840000
4,2.5,2120,10202,4,7,1620,500,755000
3,2.5,1720,1916,3,7,1720,0,280000
4,2.5,3640,10576,3,11,3640,0,913000
3,2.25,1400,31626,2,7,1140,260,315000
4,3.75,3070,5850,5,9,2400,670,1.57E+06
4,2.5,2400,9612,3,8,1230,1170,500012
3,1.75,1130,7500,4,7,1130,0,315450
3,2.5,1909,1300,3,8,1766,143,630500
7,4.5,4290,37607,5,10,4290,0,840000
3,1.5,1620,9310,4,7,1620,0,219950
4,1.75,1880,7953,4,7,1880,0,538000
4,2.5,3170,3862,3,8,3170,0,820000
5,3,2010,7264,3,7,1290,720,465000
3,1,1600,7324,4,7,1600,0,340000
3,2,2500,6733,3,8,1770,730,685000
5,3.5,3550,9600,3,9,2550,1000,810000
4,2.5,2510,6853,3,9,2510,0,448000
4,2.5,2600,4506,3,9,2600,0,512000
3,1.5,1210,12500,3,7,1210,0,257500
5,2.75,3230,13572,3,8,1880,1350,530000
2,1,1140,11480,3,6,1140,0,455000
5,3.75,4220,9240,5,11,3420,800,1.58E+06
4,1.75,2460,7560,4,8,2460,0,635000
2,1,990,4920,3,6,990,0,430000
4,2.25,1850,2340,3,8,1850,0,496800
3,1.75,1510,8385,3,7,1510,0,400000
2,1,1060,6100,3,6,1060,0,228000
2,1,950,2784,4,8,950,0,162950
3,2.5,2240,7500,3,8,2240,0,319950
3,2.5,1150,683,3,7,1150,0,335000
4,3,2940,7108,3,9,2220,720,870000
2,1,810,6827,3,6,810,0,325000
3,2.25,1830,25641,3,8,1830,0,379500
3,1.75,2290,8234,4,7,1250,1040,367950
3,2.5,2480,37843,4,8,2480,0,663000
4,1,1130,13927,3,6,1130,0,182200
5,2.5,2820,14062,4,7,2380,440,669950
3,3.5,1500,1471,3,7,1500,0,337900
4,3,1780,4228,3,7,1780,0,350000
3,1.75,1550,4708,4,7,860,690,460000
3,2.25,2350,6000,5,7,1020,1330,735000
4,3,3520,128502,4,10,3520,0,1.40E+06
3,1.5,1240,5000,3,7,1240,0,336000
3,2.5,1540,3237,3,7,1540,0,345000
3,2.5,2090,9847,3,9,2090,0,725000
3,1.5,1110,9762,4,7,1110,0,416000
2,1,1040,20524,3,6,1040,0,154000
4,2.5,2430,9103,3,8,2430,0,305000
4,2.25,2600,9900,3,7,1600,1000,270000
4,1.75,1820,7700,4,7,1100,720,344900
4,2,1190,8190,3,7,1190,0,900000
4,2.5,2040,7800,3,7,2040,0,294000
2,1,670,7952,4,6,670,0,295000
3,2.5,2160,1912,3,9,1970,190,629000
3,2.25,1650,7218,3,7,1230,420,359000
4,3.5,2850,5577,3,8,1950,900,608500
4,2.75,1700,7495,4,7,1200,500,461000
3,1.75,1930,9600,3,8,1930,0,795000
4,2.5,2980,5674,3,8,2980,0,330000
4,3.75,2810,10840,4,8,2070,740,492000
4,3.25,4350,7090,3,8,2870,1480,472000
4,2.5,2740,5700,3,9,2740,0,438900
4,1.75,2090,12750,3,8,1360,730,290000
2,2.5,1780,1311,3,8,1350,430,398500
3,1,990,6750,4,6,990,0,325000
3,1,1380,4000,3,7,1380,0,505000
4,1,1730,177657,3,5,1730,0,300000
4,2.5,3180,31931,4,10,2390,790,1.12E+06
4,3,4750,21701,5,11,4750,0,2.18E+06
3,2.25,1910,35015,4,8,1430,480,532000
3,1.75,1720,7800,4,7,1170,550,583500
3,1,1000,9150,3,7,1000,0,265000
4,1.75,2270,27122,5,8,1300,970,585000
2,1,770,7000,3,6,770,0,212000
4,2.5,1600,14000,3,8,1310,290,427000
3,2.25,2570,8491,4,8,2570,0,348000
4,3,2050,4000,3,8,2050,0,370228
4,2.5,2800,6567,3,9,2800,0,459950
7,3.5,4640,15235,3,11,2860,1780,1.95E+06
4,2.75,1830,8384,3,7,1320,510,485000
4,2.5,3220,7875,4,8,3220,0,590000
2,1,720,5750,2,6,720,0,310000
2,1,990,39964,2,4,990,0,120000
5,1.75,2490,24969,4,8,1540,950,630000
3,2.5,1510,1493,3,8,1510,0,599950
4,2.5,3170,5340,3,7,3170,0,505000
4,2,2270,5760,4,8,2270,0,724950
4,2.5,3190,7399,3,10,3190,0,609900
4,3,3180,12070,4,9,3180,0,790000
3,1.5,2520,37616,3,8,2520,0,496000
3,2.5,3040,5326,3,9,3040,0,500000
3,1,1580,3774,3,6,1580,0,465000
4,2.5,1850,9248,3,8,1850,0,515000
3,1.75,2300,6200,4,7,1150,1150,325000
3,2.5,3240,8016,3,8,2910,330,600000
3,3.25,1280,1730,3,8,1090,190,375000
3,2,2030,24829,4,7,1220,810,225000
3,2,2210,5000,3,7,1710,500,685000
3,1.75,2380,12681,1,6,1380,1000,227000
3,1.75,1290,4000,3,6,1170,120,250800
4,1,1060,7200,3,6,880,180,510000
3,2.5,2000,35438,3,7,2000,0,430000
3,1.75,2660,7800,4,8,1330,1330,615000
2,1,1340,8100,3,8,1340,0,452000
3,1,1070,8250,3,7,1070,0,164000
4,2,1200,8470,4,7,1200,0,223000
3,1.75,1250,4120,4,7,980,270,579500
4,3.5,3760,5000,3,9,2860,900,919204
6,2.75,2040,8560,4,7,1100,940,610000
4,3,2790,3600,3,8,1880,910,1.05E+06
4,2.5,2380,12067,3,7,2380,0,439950
4,2.75,1240,3867,3,7,800,440,400000
3,2.5,2220,20531,3,8,2220,0,382450
4,2,1620,7992,4,7,1620,0,260000
3,2,1340,10200,3,7,1340,0,339950
3,2.25,2720,54450,3,11,2720,0,873000
3,1.75,1840,7300,3,8,1840,0,265000
3,2,1340,1384,3,8,1340,0,376000
4,3.25,3460,7749,3,10,3020,440,1.75E+06
4,2.5,3480,12164,4,11,3480,0,1.19E+06
2,1.5,1160,1648,3,7,1160,0,375000
2,1,880,17743,4,5,880,0,292500
4,3,2290,5105,3,8,2290,0,530000
3,2.5,1690,8564,4,7,1690,0,295000
3,1,1100,4600,3,7,1100,0,450000
3,2.25,1240,1250,3,8,1240,0,529950
4,2.25,2420,59800,4,8,1350,1070,549000
4,2.5,2370,4000,5,8,1980,390,834000
3,2.25,1400,3814,3,7,1400,0,250000
4,2.25,1940,9144,4,7,1430,510,495000
4,2,1670,12056,3,7,1670,0,400000
5,2.5,4170,33310,4,11,4170,0,1.30E+06
3,1.75,2920,10573,4,7,2920,0,325000
3,2.25,2070,7800,3,7,1170,900,279000
4,2.25,1830,6136,3,7,1830,0,249000
5,2.75,2920,5250,5,7,1800,1120,265000
4,4,7850,89651,3,12,7850,0,2.70E+06
3,2,1220,14645,3,6,1220,0,315000
4,2.5,2890,5801,3,9,2890,0,570000
3,1,1260,7250,3,7,960,300,485000
3,2.5,2960,9350,4,9,2960,0,740000
4,2,1600,10160,4,7,1600,0,265000
4,3,3070,7150,3,9,3070,0,850000
3,1,1590,8470,4,7,1140,450,314950
3,1,1320,7341,3,7,1320,0,370000
3,2.5,2230,5717,3,7,2230,0,368750
3,3.25,1710,2171,3,7,1400,310,358990
3,2.5,2470,4948,3,8,2470,0,338000
3,2.5,1760,8584,5,7,1760,0,289950
4,3.5,3460,3997,3,10,2560,900,1.32E+06
3,2.5,1860,3690,3,7,1860,0,384950
4,2.5,3440,6915,3,10,3440,0,616000
3,2,1840,3432,3,7,1840,0,467000
3,1.75,1880,8424,4,7,1380,500,410000
2,1,1220,6000,3,6,880,340,452000
4,3,5940,11533,3,11,4950,990,1.15E+06
2,1,1070,8750,3,7,1070,0,325000
3,2.5,2040,10033,4,8,1420,620,726000
3,1.75,1010,12000,4,7,1010,0,315000
3,2.5,2070,49658,4,8,1540,530,653450
4,2.5,2520,3980,3,8,2520,0,605000
3,1,960,6500,4,5,960,0,225000
3,1.75,1540,6930,3,7,1250,290,630000
3,1.5,1450,4694,3,7,1450,0,274000
2,1,1410,7000,3,7,1410,0,175000
5,3,2500,11779,4,8,1550,950,730000
3,2,1640,15258,3,8,1640,0,525000
4,2.5,3060,10043,4,8,1700,1360,475000
4,2.5,2150,8536,4,8,1400,750,871000
4,2.75,3160,8197,3,8,1580,1580,655000
3,2,1400,9177,3,7,1400,0,233000
3,2,1870,3378,3,7,1120,750,340000
3,3.25,2960,39370,3,10,2960,0,735000
4,1,2590,18224,4,7,2000,590,470000
4,2,1440,7641,4,5,1440,0,162000
4,2.5,2700,5100,4,8,1440,1260,550000
4,2.5,2090,5289,3,8,2090,0,349950
4,1.75,1490,8544,4,7,1490,0,242150
4,2.5,2860,5576,3,8,2860,0,650000
4,2.5,3390,7870,3,8,3390,0,495000
3,2.5,2260,8040,3,8,2260,0,335000
5,2.5,2250,7176,3,7,1310,940,349950
2,1,860,5040,3,7,860,0,370000
4,2,1764,15600,5,7,1764,0,349950
3,1.75,1820,78408,3,6,1220,600,309933
5,2.25,2830,7738,4,8,2830,0,779000
4,2.5,2750,13950,4,8,1380,1370,725000
4,2,2400,6000,3,6,2400,0,375000
3,2.25,1660,8307,4,8,1660,0,405000
3,2.25,2590,9263,5,8,1440,1150,520000
5,2.25,2800,8442,3,9,2800,0,1.85E+06
2,1,790,4000,3,7,790,0,169317
3,2.5,2000,3837,3,8,2000,0,515000
3,2,1190,10299,3,7,1190,0,240000
3,3.75,6400,76665,4,10,3810,2590,1.33E+06
2,1.5,1400,1650,3,7,1400,0,303000
4,2.75,4070,115434,3,9,4070,0,845000
3,2.5,1480,1386,3,8,1480,0,425000
3,2,2040,4841,4,7,1020,1020,667500
3,2.5,2490,4904,3,9,2490,0,634000
3,1,1420,8160,3,7,970,450,404000
2,2.25,2160,17861,4,9,2160,0,1.20E+06
4,2.5,2550,7349,3,9,2550,0,369000
3,1,1350,8700,3,6,1350,0,255500
2,1,900,1818,4,7,900,0,334000
3,1.75,1720,3825,3,7,1720,0,475000
2,0.75,1020,1076,3,7,1020,0,325000
5,1.75,1660,78408,3,6,1660,0,201000
4,2,1510,3500,5,7,1510,0,791500
4,1.75,1940,15909,3,8,970,970,375000
4,2,1170,4000,3,7,1170,0,330000
3,1.75,1170,4000,3,6,720,450,315000
4,2,2180,17180,4,7,2180,0,470000
3,2.25,1900,8125,3,7,1540,360,340000
3,1.75,1230,10005,4,7,1230,0,420000
3,1,1480,6978,4,8,1480,0,899000
2,2.5,2170,6361,3,8,2170,0,755000
4,1.75,1500,6820,5,7,1500,0,782000
5,3.75,2890,5000,3,7,1310,1580,390000
3,1.5,2060,44866,3,8,2060,0,450000
2,2.5,1100,1737,3,8,1100,0,190000
5,1.75,1920,6500,3,7,1260,660,715000
1,1,790,3000,3,6,790,0,395000
4,1.75,2360,4750,5,7,1660,700,805000
5,2.25,3210,61419,3,8,3210,0,696500
5,3,2200,103237,3,7,1160,1040,547000
3,2,1860,9100,3,8,1860,0,370000
3,1.5,1170,9848,3,7,1170,0,250000
3,1.75,1890,5000,3,7,1890,0,275000
3,2,2240,11250,3,8,2240,0,555000
4,2.5,2020,4350,5,9,1730,290,868000
3,2.5,1800,5761,4,7,1800,0,408200
4,2.5,2380,12573,4,9,2380,0,835100
5,3.25,2400,3118,4,7,1780,620,700000
3,1.75,1590,7535,5,6,1590,0,249000
3,1.75,1590,1322,3,8,1060,530,465000
5,4.5,4350,13405,3,11,4350,0,1.38E+06
4,3.5,3530,14406,3,10,2570,960,874150
3,2.75,2070,9697,4,7,1330,740,440000
3,2.25,1500,7410,4,7,1500,0,270000
4,2.5,2490,8124,3,7,2490,0,306000
3,2.25,2200,8000,3,8,2200,0,360000
5,4,4100,8120,3,9,4100,0,950000
3,1,1210,8505,3,7,1210,0,315000
4,2.5,3230,256132,3,9,3230,0,875000
4,3.5,3150,6175,3,9,3150,0,700000
2,2.25,1510,7280,3,7,1510,0,442500
4,3,2780,5000,5,7,1710,1070,675000
3,2.25,1890,7498,3,7,1190,700,423500
3,1.5,1380,4290,3,7,1080,300,525000
3,1.75,2070,9827,4,7,1420,650,503000
3,1.75,1010,6552,3,7,1010,0,147500
3,1,960,8855,4,7,960,0,349810
2,1.75,1960,6000,4,7,980,980,478000
4,3.25,3920,881654,3,11,3920,0,1.65E+06
3,2.5,1360,1489,3,8,1360,0,345000
4,2.25,2160,5600,5,7,1080,1080,756000
3,1.75,1540,9154,3,8,1540,0,450000
3,1,1000,9295,3,7,1000,0,225000
4,2.75,2600,2750,3,7,1620,980,840000
3,1,1500,6240,4,7,1500,0,431000
4,2.5,2960,37430,3,9,2960,0,539950
3,1,1160,10384,4,6,1160,0,215000
5,2.5,2350,14197,4,8,1220,1130,895000
2,1,1350,4494,3,7,920,430,345000
4,2.5,3030,47958,3,8,1660,1370,465000
3,1,1000,10800,3,7,1000,0,396480
4,4.25,4390,13833,3,10,3320,1070,1.05E+06
2,2.25,1260,1032,3,7,1170,90,329950
4,2.25,2860,26136,3,8,1640,1220,740000
3,2.75,2200,7000,4,7,1280,920,325000
4,3,2180,12196,4,7,2180,0,499900
4,2.75,2760,8160,4,8,1780,980,614000
3,1.5,1290,8175,4,7,820,470,781000
4,2.5,2665,5868,3,9,2665,0,340000
3,2.5,2810,5400,3,9,2810,0,739000
4,3.5,4740,8611,3,11,3640,1100,1.35E+06
3,2.25,1470,9140,3,7,1470,0,376000
4,2.5,2320,11717,3,8,2320,0,397000
3,1,1980,6450,4,6,1120,860,342000
5,3.5,3340,5000,3,8,2580,760,592000
3,1.75,1680,7250,3,7,930,750,315000
4,2.5,3950,10856,3,10,3950,0,914500
2,2,1590,9375,3,7,910,680,290000
1,1,520,5600,3,6,520,0,295000
2,1,1150,5695,4,6,1150,0,180000
5,3.75,4700,11237,3,10,2930,1770,1.14E+06
4,2.5,3100,7807,3,9,3100,0,800000
3,1.75,1720,6000,3,7,1000,720,304000
3,3,1730,1074,3,8,1730,0,525000
4,2.25,2810,12607,3,10,2810,0,535000
3,1.75,1490,6269,4,6,990,500,226000
5,3.5,3790,8200,3,8,2120,1670,471750
4,3.25,3200,7081,3,9,3200,0,707000
4,1.75,2170,4600,3,7,1270,900,709000
4,3.5,3150,6202,3,7,3150,0,330000
3,2.75,1820,7517,3,9,1820,0,795000
2,1,2230,11472,3,7,2230,0,426000
3,2.25,1552,3600,3,7,1552,0,282000
3,1,1090,7315,5,6,1090,0,289000
4,2.5,2540,32647,3,9,2540,0,628990
5,3,3690,10260,4,9,2070,1620,1.13E+06
4,2.75,3410,95396,4,10,3410,0,1.23E+06
4,3,2900,10400,5,8,1530,1370,930000
4,2.25,2070,13084,4,8,1700,370,795000
3,1.75,1560,9452,4,8,1560,0,425000
2,1,1530,4370,3,7,1130,400,458950
4,2.25,2190,9009,4,8,1840,350,730000
4,2.75,2500,4950,3,8,2500,0,680000
3,2.5,1690,1689,3,8,1150,540,419990
4,2,2200,3060,3,7,1100,1100,358000
1,0.75,520,12981,5,3,520,0,262000
3,1.5,2330,11740,3,8,1330,1000,450000
3,2,1650,6408,4,8,1650,0,440000
3,2,1390,7120,3,7,1390,0,259000
4,2.5,2790,5450,3,10,1930,860,1.16E+06
3,1.5,1420,7480,4,7,1420,0,255000
4,2.5,2440,5088,3,7,2440,0,425000
4,1.5,1830,6985,3,7,1080,750,424500
4,3.25,3800,19798,3,10,3800,0,2.40E+06
3,1,1490,7435,3,7,1120,370,258000
3,1,980,12812,3,7,980,0,218000
6,3,2290,6344,3,7,2290,0,420000
5,2,2120,2400,4,6,1080,1040,360000
3,1.5,1850,8124,4,7,1850,0,440250
5,3.5,4150,13232,3,11,4150,0,635000
3,2,2080,3880,5,7,1160,920,700000
3,1,940,5904,3,6,940,0,259250
5,2.5,2900,9525,3,9,2900,0,720000
2,1,870,11100,3,6,870,0,234000
4,2.5,3020,7465,3,9,3020,0,750000
3,2.5,3750,7821,3,9,3750,0,782500
3,2.25,2420,7200,3,8,1420,1000,1.10E+06
3,1.75,1720,7200,3,7,1140,580,525000
2,2.25,1190,1499,3,9,1100,90,550700
5,1.75,2190,8250,3,7,1190,1000,385000
3,2.5,1780,7848,3,7,1320,460,270500
4,2.5,2380,5737,3,7,2380,0,332000
5,2.25,2100,6936,3,8,1600,500,567000
3,1,1300,9600,4,6,1300,0,195000
2,1,980,3915,4,7,980,0,375000
3,2.5,1710,3469,3,8,1710,0,524250
3,2.25,2760,40946,5,10,2760,0,1.19E+06
4,2.75,3370,12447,3,10,3370,0,760000
4,2.5,3070,8250,5,8,2100,970,880000
3,2.25,1560,15340,3,7,1560,0,250000
3,2.5,2090,3821,3,7,2090,0,355900
3,2.25,1530,3056,3,7,1530,0,448000
1,1,710,6060,4,6,710,0,257500
2,1,950,4500,3,7,850,100,500000
4,2.5,3190,8195,3,10,3190,0,589950
2,3,1570,1281,3,8,1570,0,657000
4,1,1430,5909,3,6,1070,360,270000
3,2.25,2120,9297,4,8,2120,0,720000
2,1,1260,4080,5,7,1260,0,435000
4,2.5,2716,7850,3,9,2716,0,452000
2,1.5,1300,1229,3,8,1160,140,482000
3,1.75,1800,5700,4,8,1000,800,749950
3,1,1850,5000,3,7,1850,0,611000
1,1.5,1010,1157,3,8,950,60,200000
3,2.5,1980,17342,3,10,1580,400,380000
3,2.25,1400,2421,3,9,1400,0,639000
4,2.25,2620,33578,3,7,2620,0,535000
3,2,1490,1126,3,8,1490,0,429000
3,2.5,1850,4597,3,8,1850,0,254000
3,2,1320,8959,3,7,1320,0,265000
5,1.5,1700,7200,3,7,1700,0,548000
4,1.75,1780,2788,4,6,890,890,442900
4,2.5,2210,5077,4,8,1480,730,619500
5,2.5,2340,7200,3,7,1300,1040,475000
4,2.75,3130,13412,3,9,2140,990,835000
3,1.75,1670,9600,5,8,1670,0,785000
3,1,1210,4731,3,7,1210,0,285000
3,3,1720,954,3,8,1460,260,589000
4,2.5,2200,110642,5,7,1330,870,535000
3,2.25,1500,1312,3,8,1500,0,513000
3,1,1050,6002,3,7,840,210,414500
3,1.5,1660,5665,5,7,920,740,425000
4,2.25,2000,10374,4,7,2000,0,320000
3,3.25,3240,8338,3,9,3240,0,812000
3,2.5,1730,6368,3,7,1730,0,315000
2,2.25,1240,1172,3,8,1000,240,374950
2,1,1440,43560,4,7,1150,290,255500
4,2.5,2440,9727,3,9,2440,0,749500
5,2.5,1720,10202,3,7,1720,0,339000
3,2,1670,4441,3,7,1670,0,256703
3,1.75,1660,4800,3,7,1660,0,625000
3,2.75,3080,19635,4,7,1610,1470,299000
3,1,1510,6000,3,8,1170,340,310000
3,2.5,2110,1339,3,8,1410,700,747450
3,1,1670,4005,4,7,1170,500,460000
2,1,960,223898,3,6,960,0,365000
4,3.75,3450,4940,3,10,2570,880,990000
3,1.75,1400,5648,5,6,1400,0,249000
2,1,780,6000,5,6,780,0,220000
4,2,2500,36900,3,7,1540,960,368000
3,1.75,1650,7965,4,7,1650,0,434500
3,1.75,1620,8645,3,7,1190,430,467100
3,1.75,1920,9306,3,7,1000,920,245000
4,1,2000,4676,3,7,1250,750,450000
4,2.25,2250,41688,3,8,2250,0,569000
2,1.75,1300,22239,4,7,1300,0,492000
5,2.75,2990,6768,3,9,2990,0,802541
5,2.75,2770,7620,3,7,1700,1070,402000
4,2.75,2080,5000,5,8,1470,610,783000
4,3.5,2650,3474,3,8,2230,420,665000
3,1,880,7004,3,5,880,0,128750
3,1,2120,7735,4,7,1060,1060,300000
4,1.75,1660,11664,3,6,1010,650,220000
2,1.5,1200,6380,3,7,1200,0,365000
5,2.5,2340,13713,2,8,1670,670,235500
3,1.75,1040,5650,5,6,1040,0,258000
4,2.5,2440,28405,3,8,2440,0,576000
3,1,1570,9467,3,7,1570,0,360000
4,2.5,2670,5100,3,8,1940,730,925000
4,2.25,2800,10800,3,8,1680,1120,490000
4,2.25,2090,8941,3,7,2090,0,279000
4,2.25,2260,16188,3,10,2260,0,780000
4,2.5,3930,21894,3,11,3930,0,1.09E+06
5,1.75,2150,7171,4,7,1460,690,279950
3,1,1210,8000,3,6,1210,0,219950
3,2,2360,118483,3,8,2360,0,589000
3,2.25,2090,12112,3,8,2090,0,562100
3,2.5,1601,2491,3,7,1536,65,378000
4,2.5,2250,10696,3,8,2250,0,645000
4,2.25,2380,16236,3,7,1540,840,699900
3,2,1170,3868,4,7,1170,0,400000
4,1.75,2290,9215,5,8,1270,1020,500000
2,1,810,4800,3,7,810,0,253500
3,1,1410,9384,3,7,1410,0,450500
5,2.5,3400,8970,4,8,1700,1700,464000
4,2.5,2960,4750,3,9,2960,0,785000
4,2.5,2200,8065,3,7,2200,0,300000
2,1.5,1790,3760,4,8,1280,510,460000
3,2.5,3020,50800,5,8,1510,1510,735000
4,3,4280,18834,5,11,2180,2100,2.05E+06
4,2.5,3060,6000,3,9,3060,0,465000
2,1,1070,2754,3,7,830,240,579100
4,1,1590,24330,3,6,1140,450,291000
2,2.25,2910,6110,4,9,2910,0,620000
2,1.75,1210,4141,4,7,910,300,582000
3,1.75,1300,62290,3,7,1300,0,540000
2,1,970,5600,3,6,970,0,217000
4,2.25,2420,7725,4,8,1890,530,655000
4,3,2330,3497,3,9,1920,410,490000
4,2,1590,5400,3,7,990,600,783200
2,1,900,7500,4,6,900,0,252500
3,1,1690,13825,3,7,1210,480,257500
5,2,1430,5600,3,6,1430,0,133000
3,2,2040,4800,4,7,1020,1020,580000
3,2.25,1370,6600,4,7,1370,0,305000
3,1.75,1160,22470,4,7,1160,0,375000
3,1.5,1140,10300,4,6,1140,0,234000
2,1,1130,12500,4,7,1130,0,216000
3,1,1070,10563,3,7,1070,0,330000
4,1.5,2480,6383,3,7,1380,1100,650000
4,2.5,3490,7494,3,11,3490,0,975000
3,2.25,1810,9845,4,8,1810,0,713400
4,2.5,2990,5280,3,9,2210,780,760000
4,2.5,1790,4358,3,7,1790,0,260000
3,2.5,2660,206480,3,8,2660,0,589000
3,2,1830,10873,3,8,1830,0,305000
4,2.5,2480,9869,4,8,1240,1240,481000
3,3.25,3800,13995,3,9,3800,0,630000
3,1.5,1530,7200,3,8,1530,0,375500
3,1,1340,7260,3,6,1340,0,199950
3,1.5,1890,9450,3,7,1090,800,270000
5,2.5,3110,15783,3,8,1720,1390,580000
4,2.5,2430,6766,3,8,2430,0,585000
3,2.25,1790,11393,3,8,1790,0,493000
4,3,1930,3031,3,7,1200,730,330675
4,2,2450,5000,5,8,2200,250,969000
3,2.5,1740,2350,3,8,1120,620,525000
4,3,1890,35280,3,9,1510,380,597500
4,2.75,2160,8148,3,7,1410,750,435000
3,2.25,2550,9674,3,7,1850,700,355000
5,2,2280,19000,3,6,2280,0,365000
4,2.5,2400,8038,3,8,2400,0,440000
4,3.5,2170,3672,3,9,2170,0,1.33E+06
3,1,1180,5650,3,7,1180,0,221900
4,2.5,2280,7200,3,8,2280,0,322000
4,1.75,1480,7875,3,7,740,740,511200
3,1.5,3000,5750,5,9,2000,1000,1.12E+06
4,2.25,2810,23400,3,7,1710,1100,407000
3,1.75,1460,7203,3,7,1460,0,355000
5,2.75,2970,36817,4,8,2970,0,699000
2,1,1290,3140,3,7,1290,0,305000
4,2.5,2630,6283,3,9,2630,0,507950
2,1,1050,8382,3,7,1050,0,630000
2,1,920,4400,3,7,920,0,412133
3,2,1440,5600,4,6,720,720,230000
2,2.5,2350,2390,3,10,2000,350,1.05E+06
4,2.25,3440,14237,3,9,3440,0,725000
3,2.5,1820,2935,3,8,1820,0,456000
4,2.5,3470,10045,3,10,3470,0,920000
2,1,1150,6000,4,7,710,440,830000
3,1,960,3844,3,7,960,0,345000
3,1,1440,2618,4,7,1440,0,705000
3,2.25,2190,2416,3,8,2190,0,719950
3,2.5,1820,4200,3,8,1820,0,307635
3,2,2260,9568,3,8,1780,480,539000
5,1.75,2100,9599,3,7,1060,1040,395000
5,2.5,2180,8240,4,8,1220,960,289999
3,1,1070,10125,3,7,1070,0,357500
3,2.5,2150,4332,3,8,2150,0,410000
4,2.25,2240,5000,3,8,1770,470,905000
3,1,1120,32250,4,6,1120,0,230000
4,2.75,3220,9825,3,8,3220,0,579000
5,3.5,4170,9090,3,10,4170,0,1.45E+06
3,1.75,1240,7560,3,8,1070,170,222000
2,1,930,11450,3,6,930,0,190000
3,1,940,10875,3,7,940,0,230000
4,3.25,2670,5001,3,9,1640,1030,500000
3,2.25,1440,6443,3,7,1440,0,325000
4,1.5,1310,8250,3,7,1060,250,251200
3,1,850,6906,3,6,850,0,325000
3,1,1490,8995,4,7,1490,0,207000
5,1.75,2110,8500,3,7,1100,1010,300000
3,2.75,1430,1521,3,9,1130,300,580000
4,2.5,2540,38677,3,9,2540,0,652500
4,2.5,2130,4028,3,8,2130,0,392000
4,4.5,3870,35889,3,10,2530,1340,589900
3,3,2840,7201,3,9,2840,0,589410
2,1.75,1290,1493,3,8,1290,0,239800
2,1,770,3325,3,7,770,0,497000
3,2.5,2620,8950,3,9,2620,0,746000
3,3,3270,38088,3,10,3270,0,765000
3,1.75,2300,12000,3,8,1770,530,320000
4,2.5,3110,6479,3,9,3110,0,585000
3,3.5,2710,3326,3,8,1650,1060,615000
2,1,1000,6000,3,6,1000,0,264950
2,2.25,1130,2191,3,8,1130,0,415000
2,1,790,5024,4,7,790,0,425000
3,1.5,1060,5750,4,7,1060,0,354000
3,2.25,1580,7941,4,7,1580,0,247000
4,2.25,2730,5000,5,7,1460,1270,770000
4,1,2300,9583,3,6,1220,1080,303000
2,2,1030,600,3,8,680,350,367500
4,2.25,2660,7957,4,8,1750,910,525000
3,1.75,1820,7194,4,7,1820,0,227490
3,1,1440,3060,4,7,1440,0,567500
2,1,600,1500,4,4,600,0,130000
1,1,610,4400,3,5,610,0,126000
4,2,3140,10875,3,7,1940,1200,775000
2,1,1420,4305,4,7,920,500,490000
4,4,6050,84942,3,9,4150,1900,930000
2,1,1110,3200,3,7,1110,0,665000
3,2.5,2260,8120,3,8,2260,0,325000
3,2.25,1320,963,3,7,1040,280,255000
2,2,1070,4500,4,6,910,160,245000
3,2.5,1470,3976,3,7,1470,0,337000
2,1,1030,4365,3,7,1030,0,450000
3,2,2120,4080,3,7,2120,0,535000
2,1,1020,5000,4,6,1020,0,450000
4,1,1530,4875,3,7,1530,0,164000
3,2,1280,960,3,9,1040,240,549900
4,2.5,2320,14240,4,9,1620,700,824000
2,1.5,1630,3780,4,7,890,740,448000
4,1.75,2340,7200,3,8,1590,750,290000
3,2.25,2290,14585,3,8,2290,0,545000
2,1,1160,5000,4,8,1160,0,490000
3,2.5,1980,9725,3,8,1980,0,470000
3,2.25,1570,8767,3,7,1180,390,274950
3,2.5,5403,24069,4,12,5403,0,2.13E+06
4,2.5,2500,11983,3,7,1320,1180,312500
4,3,3720,5000,5,9,2720,1000,1.44E+06
3,1,1250,53143,5,6,1250,0,110000
5,3.5,5000,26540,3,10,3410,1590,1.73E+06
3,2.5,1650,3031,3,7,1650,0,438000
4,2.5,3420,7462,3,9,3420,0,839900
3,2.25,2220,10530,4,8,1700,520,739000
4,3.25,5010,49222,5,9,3710,1300,965000
2,2,1490,1627,3,8,1190,300,327000
6,4.5,3300,7200,3,8,3300,0,510000
3,2.25,2610,9409,4,8,2610,0,1.52E+06
3,3.5,3680,11491,3,11,3680,0,1.23E+06
3,1,1020,8400,4,7,1020,0,280000
2,1,850,5000,3,6,850,0,180500
3,1.75,1600,8400,5,8,1600,0,480000
3,1.5,1640,5650,3,8,1640,0,303100
4,2,2220,8229,4,7,2220,0,275000
3,2,1920,5688,3,9,1920,0,340000
3,1.75,2080,7700,5,7,1600,480,426700
2,1,1170,10621,3,7,1170,0,295000
2,2,840,14564,5,6,840,0,308500
4,1,1010,6000,3,6,750,260,350000
3,3.25,4610,81935,4,9,4610,0,750000
3,1.75,1520,15090,4,7,1520,0,290000
3,2,1410,8088,3,7,1410,0,410000
4,1.75,2080,13629,4,7,1040,1040,285000
4,2.5,2640,47480,4,8,1590,1050,462000
3,1.75,1540,61419,3,7,1540,0,450000
4,1.5,1920,10000,4,7,1070,850,430000
4,2.5,3630,7482,3,10,3630,0,500000
3,1.75,1470,8645,3,6,1470,0,350000
5,4,3210,7200,3,8,2410,800,465000
3,1,1040,7541,3,6,1040,0,325000
4,3,1980,5352,3,8,1980,0,744000
3,2.25,1820,8008,3,8,1240,580,475000
3,2.25,1620,6415,4,7,1620,0,275000
3,1.75,1650,7807,3,7,1650,0,267500
2,1.75,1370,5125,5,6,1370,0,409950
5,1.5,1900,10226,3,7,1130,770,415000
4,2.5,3270,35445,3,11,3270,0,1.07E+06
4,2.5,1670,3315,3,7,1670,0,451000
3,1.75,1780,8085,3,7,1210,570,477000
4,2.5,1940,10200,4,8,1140,800,315000
4,1,3390,4500,3,8,2190,1200,780000
5,3.75,3530,13260,3,10,3530,0,1.61E+06
3,2.5,2310,53578,4,8,1340,970,510000
5,3,2980,10064,3,7,1680,1300,595000
3,2.25,2430,5500,3,8,1810,620,791000
3,2.5,2040,9622,3,8,2040,0,490000
4,2.5,5300,26211,2,10,4570,730,2.56E+06
5,2.25,2500,8621,4,7,2500,0,525000
2,1.5,1820,8867,3,7,1820,0,206000
3,1.75,2190,3800,4,8,2190,0,988000
4,2.75,3990,6637,3,9,3990,0,825000
3,1.75,1450,7620,4,7,1050,400,300000
3,2,1290,5700,5,7,1290,0,521450
5,4.5,4300,12250,3,10,4300,0,975000
3,1,1000,223462,4,6,1000,0,220000
4,3.5,3090,10510,3,8,2190,900,549950
3,2,1990,7405,5,7,1990,0,510000
3,2,1390,5127,3,8,1390,0,297950
3,1.75,1590,9417,4,7,1590,0,330000
3,2.5,2720,7250,3,9,2720,0,910000
1,1,480,4560,3,5,480,0,170000
3,1,1420,11040,4,7,1420,0,490000
3,2.5,1480,14250,3,7,1480,0,466800
3,1.75,2240,10578,5,8,1550,690,750000
4,2.5,2380,13550,3,7,2380,0,330000
4,2.5,2460,4200,3,8,2460,0,568500
3,2.5,2430,5867,3,7,2430,0,485000
3,2.25,2230,10026,3,8,1430,800,585188
5,3.75,3500,101494,3,8,3500,0,750000
4,2,2190,8402,4,6,2190,0,540000
2,1.5,960,7200,3,7,960,0,525000
4,1.75,2470,131790,3,8,2470,0,585000
2,1,1140,1730,3,8,1010,130,235000
3,1,1150,4681,3,7,1150,0,358000
2,2,1540,54450,3,7,1540,0,475000
3,2.5,1360,5754,3,7,1360,0,239000
3,2.5,1700,7496,3,8,1700,0,349950
4,2,1680,2600,5,7,840,840,555000
7,4.5,6210,8856,5,11,4760,1450,3.20E+06
3,2.25,2040,18360,4,8,2040,0,721000
2,1,980,4800,4,7,980,0,550000
3,2.5,2810,4932,3,8,2810,0,528000
3,2,1630,7599,3,10,1630,0,767450
4,3.75,4150,17424,3,9,3130,1020,1.95E+06
3,1,1070,6164,3,7,1070,0,175000
3,1.75,1470,27000,3,7,1470,0,299900
2,1.75,1210,1189,3,8,1210,0,351358
2,2,1930,5520,3,8,1930,0,559000
2,1.75,910,2550,3,6,910,0,193000
3,1,1500,4500,3,7,1120,380,578000
3,1.75,1440,10920,4,8,1440,0,267000
3,2,1400,6380,4,7,700,700,432000
3,2.75,3900,111514,3,6,3460,440,415000
3,3.5,1280,1257,3,8,1040,240,470000
6,3.75,3010,4360,3,9,2000,1010,1.13E+06
4,2.5,2568,5000,3,9,2568,0,425996
2,1.75,1520,4220,4,7,840,680,470000
2,2.25,1800,2748,4,9,1800,0,472000
3,1,1830,4400,4,8,1720,110,638000
4,2.5,2260,7753,3,9,2260,0,604000
3,2,1760,9055,4,7,1760,0,460000
3,1,1160,11799,3,7,1160,0,325000
5,4.5,5840,17168,3,12,4570,1270,2.20E+06
3,1.75,1420,8250,4,7,1420,0,460000
4,2.5,2220,4652,3,7,2220,0,405000
4,1.75,1390,10660,4,7,1030,360,272000
3,1.75,1320,7725,3,8,1320,0,390000
5,2.25,3320,60984,3,9,3320,0,665000
3,1.5,1210,5200,5,6,1210,0,219950
2,1.5,1920,6250,3,7,1060,860,495000
2,2,1615,4590,5,8,1615,0,665000
3,2,1210,14499,3,7,1210,0,353000
4,2.5,3190,49658,3,10,3190,0,864000
2,1,910,4662,5,6,910,0,280000
4,2.5,2810,9800,4,8,1710,1100,825000
4,2.5,3110,24466,3,9,3110,0,655000
4,2.5,2280,14810,5,8,1500,780,515000
3,2.75,1720,6720,4,7,1270,450,493000
4,1.75,2320,4322,3,7,1140,1180,480000
3,1,1120,8200,4,7,1120,0,442500
4,2.75,2520,14021,3,9,2520,0,518000
2,1,1260,5000,3,7,1040,220,436500
4,1,1570,4000,3,7,1570,0,525000
3,1.5,1830,9848,5,7,1830,0,468000
4,1,1540,2452,4,7,1540,0,565000
4,2.5,2669,5385,3,9,2669,0,402395
3,1.5,2230,9120,3,7,1390,840,333500
4,2.5,2150,3600,3,7,2150,0,355000
4,2.75,1910,16532,4,7,1420,490,650000
6,2.75,3610,10003,4,8,3610,0,650000
3,1.75,2570,14033,4,8,2570,0,567500
3,1,1500,10730,3,7,1000,500,403000
4,4.25,4720,21000,5,11,4720,0,1.53E+06
4,2.5,1640,6000,3,7,1640,0,464950
3,2,1310,6265,3,7,1310,0,290000
5,2,1900,6000,4,6,1900,0,470000
3,2.5,2310,4729,3,8,2310,0,494000
3,2.5,1910,4363,3,9,1910,0,650000
3,2.5,2480,6600,3,8,2480,0,583800
4,2.5,1920,7277,4,8,1920,0,320000
2,1,910,295772,3,5,910,0,533050
2,1,1340,7250,4,7,1340,0,450000
4,5,4550,18641,3,10,2600,1950,3.08E+06
3,1.5,2320,7500,3,7,2320,0,307000
3,2.5,2390,6263,3,9,2390,0,535000
5,2.5,2410,8960,5,7,1600,810,560000
3,1.5,1760,4000,3,8,1760,0,690000
3,2.75,1830,1850,3,10,1690,140,593000
3,1.75,2090,7461,3,6,1200,890,258000
4,2.75,2420,8438,3,8,2420,0,329990
2,0.75,1060,48292,5,6,560,500,340000
3,2.25,1670,4800,3,8,1670,0,1.02E+06
2,1,1620,9205,5,6,850,770,350000
3,1,1250,7920,4,7,1250,0,250000
3,2,1780,9732,3,8,1780,0,710000
3,2,1150,6249,3,7,1150,0,382500
3,1,1010,14510,5,7,1010,0,270000
4,2.5,1870,8190,3,7,1100,770,285000
3,1,1190,27215,5,7,1190,0,275000
3,1.75,1430,10574,3,7,1430,0,375000
4,2,2120,8701,4,7,2120,0,250000
5,2.75,2730,22572,3,7,2080,650,599000
4,2.25,2050,9720,3,8,2050,0,545000
2,1,962,1992,3,7,962,0,390000
4,2.5,2800,246114,3,9,2800,0,739000
3,3,3910,19023,3,11,3910,0,805000
4,1.5,1790,17925,4,6,1790,0,338000
3,2.25,1520,14080,3,7,1520,0,447000
4,2.5,2910,7631,3,9,2910,0,525000
3,1.5,1310,9273,4,7,1310,0,222000
3,2.5,2820,8159,3,9,2820,0,735000
2,1,1030,5750,5,8,1030,0,650000
4,2.5,2310,7384,3,8,2310,0,310000
3,1,1700,4165,3,7,1700,0,467500
2,1.75,1480,5120,4,6,840,640,483945
5,3,3270,9146,3,7,3270,0,357500
5,2.5,3320,9024,3,9,3320,0,800000
3,2.5,1520,4170,3,7,1520,0,296475
3,1,1250,7654,3,7,1000,250,275000
3,2.25,1890,12236,3,8,1890,0,473000
4,2,2560,9390,5,8,1280,1280,552625
4,2.25,2250,3600,4,9,2010,240,975000
3,2.5,2283,3996,3,8,2283,0,389950
2,1,680,8640,4,5,680,0,193000
3,2.75,2440,45738,3,8,1840,600,530000
5,2.5,2500,9248,3,8,1300,1200,470500
3,1,1410,8925,3,7,1410,0,440000
2,1,920,4000,4,7,920,0,514000
2,1.75,1170,8200,4,6,780,390,302000
3,1,1060,9241,4,7,1060,0,301000
3,2,1730,12821,3,8,1730,0,313100
3,1,1580,7560,4,7,1000,580,254999
3,2.5,2280,12746,4,8,1490,790,760000
3,1.5,1310,8100,3,7,1310,0,290000
2,1,1290,1289,3,7,1030,260,441000
0,0.75,384,213444,3,4,384,0,265000
4,2.5,2210,7214,3,8,2210,0,335000
4,1.75,2560,15000,3,7,1880,680,518000
3,1,1190,8450,5,6,1190,0,319500
4,2.5,3440,14554,3,8,2170,1270,1.95E+06
4,1.75,2120,7620,3,8,2120,0,397950
4,4,2850,2970,3,8,2120,730,620000
3,1,1020,18050,3,7,1020,0,399950
4,1,1510,1501,3,7,1510,0,420000
2,1,890,7200,3,7,740,150,305000
4,3.5,4570,16219,3,11,4570,0,1.10E+06
4,2.5,2720,7043,3,9,2720,0,408500
6,2.5,3190,12196,4,8,3190,0,664000
3,1,1210,10185,3,6,1210,0,205000
3,2.5,2770,10773,3,9,2770,0,749950
3,3.25,1530,1602,3,8,1140,390,320000
3,1,920,4770,4,6,920,0,215150
3,2.5,2330,8627,4,7,1480,850,325000
4,3.25,3960,12895,3,11,3960,0,1.19E+06
3,1,1360,9948,3,6,1360,0,234950
2,1,1400,9600,4,6,1400,0,200000
3,1,1220,7771,3,7,1220,0,405000
4,1.75,2240,9886,4,7,2240,0,500000
5,3,2900,6730,5,8,1830,1070,865000
4,3,2410,8284,5,7,1210,1200,475000
3,2.25,1540,1270,3,7,1540,0,449950
2,2,1980,6000,5,7,1220,760,549000
4,3.25,5370,20388,4,11,5370,0,1.35E+06
4,3.5,3990,5267,3,10,3990,0,1.08E+06
3,2.5,1990,4936,3,8,1990,0,544900
4,2.5,2050,2772,3,8,2050,0,639888
2,1,770,8150,3,6,770,0,163250
4,1.75,1500,11600,4,7,1000,500,379900
3,1,920,9812,4,7,920,0,199500
2,1.5,1160,1438,3,7,1160,0,340000
4,2.5,2420,10603,5,7,1210,1210,485000
3,3,2440,3202,4,8,1640,800,515000
4,2.5,1750,6397,3,7,1750,0,270000
4,2.75,2810,8570,3,10,2810,0,1.57E+06
3,3,2031,7702,3,9,2031,0,335000
4,2.5,2680,9928,4,8,1340,1340,463000
4,2.25,1610,3560,3,7,1610,0,288000
5,1.75,1910,5428,3,8,1390,520,607000
3,2.5,1790,3962,3,8,1790,0,584000
4,3.25,2950,4161,3,10,2210,740,839704
4,1.75,3620,10400,4,8,1820,1800,768500
3,2.75,2520,5401,4,7,1360,1160,750000
3,1.5,1890,5000,3,9,1890,0,826000
3,3.5,1370,1764,3,8,1180,190,525000
4,2.5,3090,5600,3,9,3090,0,708000
3,2.5,2280,4557,3,8,2280,0,450000
4,1.75,1710,7140,5,7,1010,700,250000
2,1,1210,9375,4,7,1210,0,239000
4,2.5,2120,5293,3,7,2120,0,319990
3,1.5,1040,10323,4,7,1040,0,411100
4,2.75,3720,9450,5,10,1960,1760,1.37E+06
4,1.75,1420,5382,5,5,1040,380,240000
3,3,2430,10500,4,8,2150,280,272000
2,1,2100,4480,5,7,1400,700,420000
2,1,900,5220,4,6,900,0,329950
3,1,1520,8870,4,7,1520,0,320000
4,2.5,2910,6479,3,7,2910,0,499000
2,2,1340,4122,3,8,1340,0,389000
3,2.5,2620,14096,4,9,2620,0,450000
3,1.75,1570,7500,3,7,1300,270,335000
3,1.5,1560,6774,4,6,1060,500,370000
4,1.5,2060,16110,4,8,2060,0,815000
4,3,2170,5764,3,8,2170,0,560000
4,3.5,3510,10010,3,10,3510,0,729950
3,1.75,1620,8085,3,7,1210,410,395000
3,1.75,1720,4080,4,7,960,760,615000
3,2.5,1740,1280,3,8,1740,0,580000
2,1.75,1560,4500,3,8,1560,0,579000
3,2,2350,15021,4,8,1770,580,1.30E+06
3,1.75,1650,7145,5,8,1300,350,422250
3,1.75,1620,7540,3,7,1310,310,258000
4,1.5,2550,4000,4,7,1760,790,645000
3,1.75,1530,8000,3,7,1530,0,474000
2,1.5,1090,6750,3,7,950,140,455000
4,5,4630,24054,3,11,4630,0,1.43E+06
3,2.5,2495,4400,3,8,2495,0,276000
2,1,1140,5100,3,7,1140,0,400000
3,1,1250,8200,4,7,1250,0,282950
4,2.5,1850,6037,3,7,1850,0,278000
3,1,1970,22144,4,7,1970,0,454000
3,2.5,1070,1219,3,7,720,350,370000
3,2.75,1420,955,3,8,1160,260,362000
3,2.5,1656,108900,4,7,1656,0,462500
3,2.25,1630,3070,3,7,1630,0,476000
3,1.75,1210,9635,4,7,1210,0,340000
5,3,3330,19126,4,11,2610,720,1.19E+06
3,2.5,3230,129578,4,8,2100,1130,499950
4,2.5,2550,10623,3,9,2550,0,612500
2,1,1350,8220,3,7,1060,290,330000
3,1.75,1230,1441,3,8,1010,220,393500
5,3.5,3630,4911,3,9,2790,840,834950
3,2,2270,28025,4,7,1920,350,340500
4,2.25,1660,3200,3,7,1660,0,300000
4,2.5,2390,6775,3,7,2390,0,355000
2,1.75,3050,50965,3,10,3050,0,890000
4,2.75,2890,16397,3,10,2890,0,795000
7,5.5,6630,13782,3,10,4930,1700,1.24E+06
3,2.5,2010,2287,3,8,1390,620,453246
3,1,1210,7636,4,7,1210,0,457500
3,1.75,1300,5120,4,6,1300,0,515000
4,2.25,1930,7207,4,7,1360,570,280000
4,3.25,4140,11007,3,10,4140,0,1.84E+06
4,2.5,2550,4500,3,7,2550,0,415000
3,1.75,2270,9000,4,8,1330,940,258000
2,2,1450,2272,4,6,750,700,524000
3,2.25,1840,7326,5,7,1370,470,319990
2,2.75,1100,1088,3,7,750,350,440000
3,1.5,2540,2700,4,8,1630,910,1.19E+06
4,1,1740,11075,3,7,1740,0,310000
1,0,670,43377,3,3,670,0,75000
3,1,910,4500,3,7,910,0,465000
4,3.5,2100,7560,5,8,2100,0,759950
3,1.75,1550,4054,4,7,1550,0,475000
4,2.75,3430,8000,4,8,3430,0,367999
3,1.75,1570,7416,4,7,1570,0,253000
3,2.5,2200,3360,3,8,2200,0,433500
4,1,1800,12485,5,7,950,850,425000
4,2.5,2740,12899,4,10,2740,0,725000
3,1,1060,10042,4,7,1060,0,219950
3,2.5,1950,7421,3,8,1950,0,292000
4,3,3700,20570,4,10,1850,1850,1.73E+06
4,3,3580,9316,3,10,2370,1210,711600
2,1,1000,3700,3,6,800,200,257000
4,2.5,1580,3632,3,7,1580,0,299900
5,3,4080,7500,4,8,2720,1360,825000
4,2.5,3040,12522,3,7,3040,0,454000
5,2.25,2910,9525,4,9,2910,0,870000
3,1.75,1890,9535,3,7,1210,680,344500
6,2,3080,5500,1,7,3080,0,432500
4,2.25,1770,8505,3,8,1770,0,596500
4,2.5,2830,20345,3,10,1980,850,782000
5,2.5,2500,7200,4,7,1490,1010,661500
4,1.75,2020,6200,4,6,1010,1010,575000
4,1.75,2200,7600,3,8,2200,0,300000
4,1,1430,6240,5,7,1430,0,398000
4,3,2670,5000,3,7,2670,0,550000
3,2.5,1720,99916,4,7,1720,0,365000
2,1,1240,8100,3,7,1240,0,436000
3,1.75,1460,7980,3,7,1460,0,290000
3,1,1500,6250,3,6,890,610,273000
3,2.5,1830,12750,3,7,1830,0,300000
5,2.5,2570,17234,3,7,1300,1270,275000
3,1,2400,17239,4,7,1890,510,455000
3,3,1384,1287,3,8,1144,240,575000
2,2.25,1460,1623,3,8,1260,200,495000
2,2,1180,2553,3,6,1180,0,195000
2,2,1600,5969,4,7,800,800,523500
3,2.5,3400,16603,3,10,3400,0,900000
4,2.5,2240,7245,4,7,1140,1100,475000
2,1,970,3300,4,7,970,0,515000
3,1.75,1540,3000,3,7,770,770,512031
5,2.75,2580,7865,4,8,1480,1100,650000
3,1.75,2160,98445,3,8,2160,0,390000
2,2.5,1370,1140,3,8,1080,290,355000
3,1,1310,22652,3,7,1310,0,280000
3,2.5,1960,12476,4,8,1960,0,560000
3,1.75,1460,10584,3,7,990,470,240500
3,2,1430,7280,3,7,990,440,250000
4,1,1500,6388,4,7,1500,0,399000
3,1,860,9403,4,6,860,0,399000
3,2,1690,9583,4,7,1690,0,270000
3,1.75,2500,6840,3,8,1300,1200,425000
4,2.5,2310,8030,3,7,2310,0,364950
2,2,1280,4095,4,8,1280,0,425000
5,2.75,1970,5400,3,7,1320,650,399950
3,1.75,1000,8268,3,6,1000,0,350000
3,1.75,1300,4800,4,7,1300,0,448500
5,3.25,3910,7077,3,9,2710,1200,470000
1,1,900,7500,3,5,900,0,305000
3,2.25,2090,45535,5,8,1280,810,693000
4,2,2300,8400,4,6,1150,1150,258750
3,2,1660,5070,3,8,1660,0,491000
4,2.5,2380,6124,3,8,2380,0,350000
4,2,1820,5001,3,7,1820,0,705000
3,2,2130,5000,5,7,1330,800,652000
3,1.75,1730,18250,3,8,1730,0,521000
3,1.75,1170,9085,3,7,1170,0,185000
3,1.75,1320,7200,4,7,1320,0,333500
4,2,2260,6000,3,8,1430,830,628000
4,2.25,4760,8036,5,9,3390,1370,2.25E+06
3,2.25,2190,45738,3,8,2190,0,620000
3,1.75,1350,217852,3,8,1100,250,314000
4,2.25,1790,7203,4,7,1110,680,430000
4,3.5,4170,4322,3,9,2940,1230,810000
4,1.75,1860,7350,4,7,1090,770,250000
2,1,680,4190,2,5,680,0,275000
4,2,1900,76877,3,8,1900,0,390000
3,2.25,1780,7332,3,7,1780,0,272450
3,2.25,2530,12042,3,8,2530,0,380000
3,2.75,1540,6760,5,7,1210,330,503000
5,3.75,3490,15246,4,10,1940,1550,1.30E+06
3,1,1090,8640,4,6,1090,0,285000
4,2.25,2070,1230,3,9,1500,570,575000
3,1,1010,6300,3,7,1010,0,300000
4,3,3000,10297,3,8,3000,0,398950
2,1,1040,6900,4,7,1040,0,418000
5,2.5,2620,12763,3,7,1400,1220,330000
2,2,1200,1867,3,7,600,600,478000
3,1,1160,18055,2,5,1160,0,182000
3,1.75,1650,9600,4,7,1650,0,476000
3,3,1845,5100,5,8,1845,0,510000
3,1,1990,7173,3,7,1990,0,310000
3,2.5,2150,9266,3,8,2150,0,428040
3,2.5,1350,3068,3,7,1350,0,613000
2,1.75,1780,224769,4,8,1780,0,535000
2,1,900,6656,3,7,900,0,355000
4,2.5,2460,4774,3,8,2460,0,495000
5,2.75,2980,13482,4,8,1730,1250,350000
2,1.5,1159,4800,3,7,1159,0,582500
3,2.75,1980,3128,4,9,1980,0,490000
6,1.75,2750,9563,4,8,2750,0,750000
4,2.25,2390,12292,5,9,2390,0,984000
4,2.75,3410,7750,5,8,1710,1700,1.10E+06
2,2.5,1370,3438,3,7,1370,0,190000
4,1,1600,5500,4,7,1600,0,625000
3,2.25,1630,7573,3,7,1230,400,490000
2,0.75,840,40642,4,6,840,0,528000
3,1.75,1410,1988,3,8,1410,0,274800
3,2.5,2920,9096,3,9,2920,0,675900
5,2.5,2070,4698,3,7,2070,0,337500
4,2.5,3500,10891,3,10,3500,0,917000
3,1.75,2460,4800,4,7,1230,1230,960000
2,1.75,1000,5100,3,6,940,60,335000
5,2.75,3230,6500,3,9,3230,0,834950
4,2.5,2230,12753,4,7,1180,1050,600000
4,3,2820,2850,5,7,1860,960,697000
3,1.5,1640,8922,4,7,1640,0,242000
3,1.5,1370,7439,4,6,1370,0,238000
3,1.75,1630,9403,3,7,1630,0,357500
3,1.75,1330,9417,5,6,710,620,375000
6,3.25,4920,20590,4,9,2730,2190,850000
3,2.25,1740,9370,3,7,1390,350,289950
3,1.5,1120,8250,4,7,1120,0,266000
4,3.5,2720,9000,3,8,2670,50,709050
3,1.75,1960,4788,4,7,1090,870,599000
2,2.25,2130,5920,3,8,1830,300,779000
4,1.75,2320,7500,3,7,1220,1100,410000
3,1.75,2320,6400,4,8,1420,900,779000
5,3.25,2980,7095,3,9,2980,0,932800
3,2.5,1520,8720,3,7,1080,440,269950
3,2.5,1800,5372,3,8,1800,0,416000
3,2.5,2340,3630,3,9,2340,0,618000
4,1.75,2120,7725,3,8,1220,900,525000
3,1,1500,3399,5,7,1300,200,415000
3,1.75,1520,6380,3,7,790,730,438000
3,2.25,1420,7297,3,7,1130,290,269000
5,1.75,2290,7900,4,7,1190,1100,390000
3,2.5,2670,13218,4,10,2670,0,425000
4,2.5,2050,5276,3,7,2050,0,385000
2,1,1360,6120,3,7,1060,300,525000
4,2,1660,12377,3,8,1660,0,550000
3,1,1100,5400,3,7,1100,0,505000
5,2.5,2600,4284,3,9,2600,0,775000
4,3,2020,6000,3,8,1220,800,830000
5,4.5,4600,7810,3,9,3200,1400,805000
4,3.5,3660,4760,3,9,2840,820,1.11E+06
3,1,1170,11100,4,6,1170,0,235000
5,3.25,3370,7947,3,10,3370,0,1.07E+06
3,2,1660,8174,3,7,830,830,405000
2,1.5,1370,1221,3,8,1080,290,446000
2,1.75,1650,7500,4,7,1000,650,670000
3,1.75,1220,9732,3,7,1220,0,333500
3,2.5,1810,7210,5,7,1210,600,420000
5,2.5,2200,6250,3,7,2200,0,259875
3,1.75,1740,8528,4,7,1290,450,480000
3,1,1110,7000,4,7,1110,0,302000
4,2.25,2050,7201,3,8,2050,0,500000
3,1.75,2010,8072,4,8,2010,0,639500
4,2.5,1780,5822,3,7,1780,0,311000
2,1,760,5240,3,6,760,0,129000
4,3,3110,18843,3,9,3110,0,485000
4,1.75,1770,12462,4,8,1770,0,638500
4,2,2340,6000,5,8,1270,1070,685000
3,1.75,1650,1180,3,8,1650,0,599000
2,1,750,6089,3,6,750,0,213000
4,3.5,2910,5260,3,9,2910,0,610000
3,3.25,3440,4080,3,9,2560,880,1.32E+06
3,1.75,1310,6960,4,7,1310,0,229999
2,2,2090,6000,3,7,2090,0,477500
4,2.5,1820,8217,3,7,1120,700,234000
3,2.25,1980,10115,3,8,1980,0,640000
5,2.75,3050,7520,3,8,3050,0,740000
3,1,1570,9650,5,5,1570,0,212644
3,1.5,1400,7550,4,7,1400,0,415250
2,2,1270,1372,3,8,1270,0,438000
3,1.75,1620,5500,3,7,1110,510,680000
2,2.5,1150,1027,3,8,1150,0,425000
4,1.75,2120,6250,5,7,1060,1060,560000
3,2.5,1850,17808,4,8,1210,640,374000
4,3.25,2730,54014,3,9,1560,1170,625000
3,1.5,1250,4000,3,7,1250,0,452000
4,2.25,2060,5649,5,8,1360,700,715000
5,2,1700,7314,3,7,1000,700,337500
3,1.75,1220,7004,5,7,1220,0,289900
3,2,1290,7952,3,7,1290,0,237000
4,1,1440,8320,3,7,1440,0,395000
3,3.5,2490,3582,3,8,1720,770,550000
2,1,930,5000,3,7,930,0,700000
5,3.75,3330,5042,3,9,2470,860,1.38E+06
2,1,830,26329,4,6,830,0,385000
3,1,1710,5000,5,7,1140,570,502000
4,2.5,2570,5250,3,8,2570,0,561000
5,2.5,3160,5635,3,9,3160,0,685000
3,2.5,2050,40003,4,8,1570,480,439500
5,3,3350,9450,5,8,2180,1170,1.00E+06
4,1.75,4060,5500,5,9,2660,1400,1.30E+06
1,1,1310,8667,1,6,1310,0,575000
3,2,2360,5737,3,8,2360,0,390000
3,2.5,1740,3690,3,8,1740,0,399000
3,1.75,1900,5520,3,7,1280,620,385000
3,3,1550,1608,3,8,1280,270,390000
3,1.75,2000,6130,4,8,1120,880,549000
5,2.75,2000,5885,3,7,1260,740,229950
3,1,1250,9472,4,6,1250,0,255000
4,2.25,2240,8322,3,8,2240,0,482000
4,2.5,1560,12220,4,7,1560,0,511100
5,2.5,2240,7543,3,7,1140,1100,469000
4,3.75,3860,5474,3,10,3860,0,1.05E+06
4,2.5,1830,5612,3,7,1830,0,338900
4,2.25,1960,8680,4,8,1290,670,723000
3,2.5,2250,9608,3,8,2250,0,445000
4,2.5,2710,35868,3,9,2710,0,482000
3,1.75,3400,8965,5,9,1820,1580,1.69E+06
3,2.5,1990,15985,3,8,1540,450,542000
3,2,2800,10501,3,7,1400,1400,650000
4,2.5,2920,4000,5,8,1910,1010,1.40E+06
4,2,1630,7618,3,7,1630,0,290000
3,2.5,2720,6439,3,9,2720,0,619000
3,2.75,2660,10350,4,8,1330,1330,851000
3,2,1430,8919,3,7,1430,0,246500
3,1,840,12091,3,6,840,0,96500
4,2.5,2200,9397,3,8,2200,0,285000
6,2.75,3500,5150,5,8,2430,1070,865000
5,3,2710,8227,3,8,1910,800,951250
3,2,2300,5000,4,8,1150,1150,650000
4,2.5,3130,60467,3,9,3130,0,685530
3,1,1270,8508,4,6,650,620,134000
2,2.5,1150,2064,3,7,1150,0,214100
3,2.25,1700,7210,4,7,1250,450,280000
4,3.5,3460,7702,3,10,3460,0,855000
3,1,1110,7128,3,7,1110,0,379500
3,2.5,1620,7686,3,7,1620,0,246500
3,1.5,1270,1483,3,8,1270,0,415000
3,2,2070,9195,3,8,1220,850,310000
3,1,880,5375,4,5,880,0,256000
3,1.75,1830,4160,3,7,1230,600,642450
3,2.25,1470,8682,3,7,1160,310,269000
3,1.5,1010,8108,5,7,1010,0,405500
4,2.75,2810,10300,4,9,1810,1000,812500
2,2.5,1900,4871,3,8,1900,0,504975
2,1,1500,8015,3,6,1500,0,235000
3,1.5,1790,229125,3,7,1790,0,475000
4,2.5,2840,18001,3,9,2840,0,500000
4,2.75,2430,20720,3,7,2430,0,465425
4,2.75,3630,11775,3,10,3630,0,962800
3,2,1400,7384,3,7,1150,250,225000
4,1,1260,7800,3,7,1260,0,295000
4,2.5,3470,20445,4,10,3470,0,994000
2,2,1440,6677,3,7,870,570,425000
6,2.5,2590,11250,4,8,1390,1200,300000
4,2.5,2270,11500,3,8,1540,730,380000
2,1,1095,5120,3,7,1095,0,302282
3,1,1400,3538,3,7,800,600,349500
4,3,2620,18362,4,8,1870,750,659500
4,3.5,4270,5800,5,10,3170,1100,1.36E+06
3,2.75,1250,892,3,8,1040,210,450000
3,1.5,1520,7903,4,7,1000,520,450000
3,2.25,2150,21235,4,8,1590,560,650000
3,2.5,1490,1410,3,10,1300,190,615000
4,2.5,4940,10037,3,9,3450,1490,800000
3,2,2540,4750,5,9,1840,700,845000
4,3,2880,5500,4,9,1920,960,1.10E+06
3,1,1290,12231,3,7,1290,0,323000
3,1,1530,19007,4,8,1290,240,439000
3,2.5,2600,5100,3,8,2600,0,583000
2,2,1400,1512,3,8,940,460,553000
2,1,1010,5000,4,6,1010,0,550700
3,2.25,1690,7245,3,7,1160,530,230500
4,2.25,2810,8560,3,8,1610,1200,386000
3,1.5,980,7790,5,7,980,0,350000
3,1.5,1240,5200,5,6,1240,0,214000
4,2.5,3000,10920,4,8,1550,1450,1.08E+06
3,2.25,2650,12845,3,9,1770,880,898000
3,2.25,1780,9598,4,7,1780,0,245000
3,1,1030,15264,4,7,1030,0,240000
3,1.75,1800,10200,3,8,1800,0,442500
3,2.5,1650,3711,3,8,1650,0,472500
1,1,700,3876,3,6,700,0,315000
3,2.5,2430,5715,3,7,2430,0,342000
4,3,4270,85643,3,11,4270,0,949000
4,2.5,2700,17853,4,9,2700,0,1.56E+06
3,1.75,2010,3090,5,7,1510,500,825000
2,1,1290,2828,3,7,1290,0,265000
3,2.25,1280,1517,3,8,1080,200,495000
3,2.5,1590,8449,3,7,1590,0,225000
4,2.5,2480,4602,3,9,2480,0,840000
2,2.25,1290,1137,3,8,1290,0,481000
5,3.5,4790,12957,3,9,3110,1680,818500
3,3.25,2970,234788,3,9,2040,930,721500
5,3.25,2740,9629,5,7,1390,1350,515000
4,4.25,4500,215186,3,11,2630,1870,1.83E+06
3,1,1500,4000,3,6,900,600,395000
2,1.75,1220,5000,5,7,860,360,253000
3,2.5,1940,8547,3,7,1460,480,266000
3,1.75,1890,16001,4,7,1890,0,398000
3,3,1530,9999,4,7,1150,380,546000
2,1,670,6300,4,6,670,0,272000
4,2.5,2990,5342,3,8,2990,0,644500
2,1.5,1320,1194,3,7,1320,0,430000
4,3.25,3680,5759,3,9,2840,840,788000
4,3.25,4420,7850,3,11,3150,1270,2.70E+06
2,1,710,1136,4,7,710,0,403950
5,2.75,2740,8426,4,8,1370,1370,541125
3,2.25,1880,7989,3,7,1280,600,440000
3,2,1530,8925,3,7,1530,0,371025
3,2,1550,8300,4,8,1550,0,300000
5,2.75,3090,12031,5,9,1600,1490,1.17E+06
4,2,1470,7412,3,7,1470,0,250000
2,2.5,1480,1369,3,7,1480,0,420000
2,1.5,1130,912,3,8,1000,130,375000
4,1.75,1740,4816,5,7,870,870,554950
4,2.5,2090,6926,3,8,2090,0,550000
4,2.75,1770,10184,3,8,1250,520,235000
3,2,3080,17700,4,8,1740,1340,530000
3,2.5,3490,28213,3,9,2242,1248,692000
3,1,1200,4592,3,6,800,400,260000
3,1.75,1620,1325,3,9,1430,190,600000
3,1.75,1240,10956,3,6,1240,0,240000
4,2.5,3260,5608,3,9,3260,0,810000
4,2.5,2000,5684,3,8,2000,0,513000
3,2.5,3160,12824,4,9,1820,1340,1.60E+06
6,2.5,3560,6480,4,11,3560,0,1.50E+06
4,2.5,2600,11280,3,7,1570,1030,252500
3,2.5,1212,1174,3,7,1212,0,340000
2,1,930,8665,4,6,930,0,200000
3,1,950,4000,3,7,780,170,256000
3,1.5,1280,16738,4,5,1280,0,279000
3,2.5,1870,4046,3,7,1870,0,248000
3,1.75,1250,13775,3,7,1250,0,350000
4,1,1820,5400,3,8,1820,0,1.01E+06
4,1.75,1770,12875,3,8,1770,0,400000
4,2.25,1834,7460,3,8,1834,0,280000
3,2,1010,2820,3,7,1010,0,450000
4,2.5,2360,7350,4,7,1440,920,285000
4,1.75,2180,7876,4,7,1290,890,379000
3,1.75,1430,8412,4,7,1070,360,375000
4,3.5,4410,12426,3,12,3420,990,1.50E+06
3,1.75,1710,7350,3,8,1280,430,525000
4,1.75,2800,90169,3,7,2800,0,529000
3,2.75,2150,31238,3,9,2150,0,595000
3,1.75,2120,9146,3,8,1260,860,525000
3,2,1430,9583,4,7,1430,0,453000
3,1,940,10890,4,5,940,0,185900
4,1.75,2330,8800,4,7,1260,1070,575000
4,3.5,3380,8330,3,8,3380,0,655500
3,2.75,1710,9448,3,7,1010,700,515000
4,2.5,2190,11500,4,8,1430,760,699900
3,1.75,1270,7875,4,7,1270,0,190000
2,1,730,2400,3,4,730,0,217000
3,1.5,1740,6988,3,7,1600,140,435000
4,2.5,3040,24123,3,8,3040,0,420000
4,3,1920,12040,3,7,1920,0,330000
4,2.5,2430,5959,3,8,2430,0,305000
4,2.5,2641,8615,3,7,2641,0,324950
3,2.5,1440,1102,3,8,1440,0,375000
3,2.25,1690,14615,4,7,1690,0,345000
3,1.5,1760,4880,3,8,1290,470,688000
2,1,1140,8340,3,7,1140,0,358000
3,2.5,1750,7208,3,8,1750,0,324000
3,1.5,1360,1488,3,7,1120,240,396500
4,2.5,2550,17209,3,9,2550,0,512000
3,2.5,2440,4153,3,9,2440,0,710000
3,1,1630,10304,5,7,1630,0,400000
5,3,2220,5185,3,7,2220,0,370000
3,1.75,2180,14734,3,9,2180,0,488000
3,2,2140,26600,4,7,2140,0,365000
3,1.75,1970,7972,5,8,1370,600,501000
4,2.5,2070,4270,3,8,2070,0,493000
4,1.75,1950,7139,3,7,1150,800,700000
3,1.5,1330,7125,3,7,1330,0,245000
3,1.5,2210,6500,4,7,1030,1180,500000
4,2.75,3430,13907,3,11,3430,0,750000
4,2.5,2440,11700,5,8,1480,960,689000
4,2.75,2950,15540,4,8,2120,830,402000
4,2.25,2100,7350,3,8,2100,0,465000
3,1.75,2000,9900,4,8,1480,520,440000
4,3.5,3845,8400,3,10,3845,0,1.75E+06
5,2.75,2620,5500,3,7,1710,910,635000
4,2.5,2340,41600,3,8,1640,700,522250
3,1.75,1800,5102,3,7,1170,630,655000
3,2.5,2130,5205,3,8,2130,0,456000
4,1.75,2020,36400,4,8,1550,470,521000
3,2.5,1600,7295,2,7,1600,0,205000
4,3.25,3470,11843,3,11,2270,1200,1.32E+06
3,2,1010,7896,3,7,1010,0,259950
3,1.75,1820,5555,4,7,1030,790,365000
5,2.75,2400,4900,3,8,2400,0,405000
5,2.5,2340,1989,3,8,2340,0,949950
2,1,720,11400,5,6,720,0,275500
4,2.5,2680,4499,3,9,2680,0,807100
4,3.5,5440,38900,3,12,5440,0,1.77E+06
4,2.25,2350,12540,3,8,2350,0,505000
4,2.25,2150,9520,4,8,2150,0,573000
5,3,2795,15101,3,8,2795,0,562000
3,2.25,1584,2800,3,7,1584,0,261000
3,1.75,1340,16480,4,7,1340,0,239000
4,2.25,2530,10611,5,8,1320,1210,590000
4,2.5,2180,11200,4,8,2180,0,480500
2,2.5,2720,26761,3,7,2720,0,985000
3,2,1100,5200,3,6,1100,0,225000
5,2.5,2340,6000,4,10,2340,0,1.09E+06
2,1,1140,8147,3,7,1140,0,390000
3,2.5,2930,5641,3,8,2930,0,754842
3,2.5,1900,6224,3,7,1900,0,536000
3,1.5,1250,9484,4,7,1250,0,210000
2,1,670,5600,3,6,670,0,235000
2,2.5,980,1010,3,8,980,0,352500
2,1.5,1650,7311,3,7,860,790,364000
3,1,1080,6250,2,5,1080,0,124000
4,2.5,3030,30000,4,9,3030,0,682000
3,1.5,1500,10018,4,7,1500,0,284000
3,2.5,1970,106722,3,9,1970,0,599950
3,2,1300,3731,3,7,900,400,315000
4,2,1690,7728,4,7,1690,0,207000
2,1,720,4000,3,6,720,0,276000
2,1,1500,4120,3,5,880,620,262000
4,1,1220,11730,4,7,1220,0,199000
3,2.5,1640,5707,3,7,1640,0,300000
4,2,1490,4054,5,7,1490,0,607000
3,1.5,1240,983,3,8,1240,0,318000
5,3.25,3400,7452,3,10,3400,0,950000
4,2.5,2770,9798,4,9,2770,0,910000
4,2.5,1940,3784,3,8,1940,0,330000
4,1,2000,4800,4,7,2000,0,715000
4,2.5,2950,10003,3,9,2950,0,551500
4,3.5,4640,9827,3,10,3210,1430,1.35E+06
4,3.25,3569,8327,3,10,3569,0,580000
3,2.5,1740,5782,4,8,1740,0,496700
3,2,1540,7947,3,7,1120,420,385500
3,2.5,2170,3200,5,7,1280,890,539000
3,2.5,2180,4533,3,7,2180,0,496000
4,3,4180,35169,3,11,4180,0,550000
2,1,770,6542,3,6,770,0,259950
3,2.5,2480,8342,3,8,2480,0,415000
4,2.75,4600,322188,3,10,2400,2200,800000
4,2,1630,9010,4,7,1050,580,234000
2,1,1170,2800,4,5,1170,0,562500
3,1.75,1260,12330,3,7,1260,0,354000
3,2.25,2120,18500,4,8,2120,0,375000
3,1,1640,8100,3,6,1040,600,190000
3,2.75,2370,4632,3,7,2370,0,350000
3,2.75,3280,10558,4,9,2040,1240,925000
3,2.5,1970,9607,3,7,1090,880,289000
2,2.5,2000,2500,3,8,1810,190,593000
3,2.5,2100,4097,3,9,2100,0,999999
4,2.5,4080,18362,4,11,4080,0,2.29E+06
4,2.25,2170,7737,3,8,2170,0,566000
4,2.5,3190,8684,5,9,1680,1510,1.22E+06
4,2,1650,4745,3,7,1130,520,435000
3,2.5,2240,6000,3,8,2240,0,340000
3,2.5,1690,4988,3,7,1690,0,297000
6,3,3470,117612,3,7,3470,0,475000
4,2.5,2710,6474,3,8,2710,0,600000
3,1,810,4600,3,6,810,0,385000
6,3.75,3810,6150,4,8,3810,0,760000
4,2.5,3250,8970,3,10,3250,0,791500
3,1,1010,15701,4,7,1010,0,225000
3,2.25,1850,7800,3,9,1850,0,295000
3,1,1510,8760,4,6,1510,0,190000
4,2.5,1980,5909,3,8,1980,0,307550
3,1.5,1140,15890,3,7,840,300,335000
3,1.75,1490,10757,3,7,1060,430,465000
3,2,1450,7300,5,7,1450,0,375000
3,2.5,1940,4000,4,9,1940,0,807000
4,2.75,3640,231739,3,10,3640,0,780000
4,4.25,5040,16048,3,10,3420,1620,2.53E+06
3,2,2660,192099,4,9,2660,0,495000
2,1.75,2210,9374,4,8,1560,650,767500
4,2.75,2270,24237,4,7,1360,910,352750
3,1,1340,4284,3,7,1080,260,530000
4,1.75,2030,7210,3,7,1450,580,359500
4,2.75,3010,10830,4,9,3010,0,1.09E+06
3,2,3120,42247,4,7,2150,970,375000
3,1.75,1580,9750,5,7,1580,0,289000
3,2.75,1100,750,3,7,780,320,286000
4,3.5,3350,9681,3,7,2140,1210,400000
3,2.5,1560,4800,4,7,1560,0,239950
2,1.75,1500,8645,4,7,1500,0,249500
4,2,1500,7854,3,7,1500,0,249900
4,3.5,3510,9364,3,10,3510,0,695000
2,1.75,1680,8367,3,6,840,840,334000
3,1.75,3440,10428,5,8,3440,0,430000
3,2.75,1700,3264,3,7,1060,640,520000
3,1,840,4495,3,6,840,0,251000
4,1.75,1670,8856,3,7,1070,600,349170
2,1,860,6600,5,6,860,0,200000
5,2.75,1800,3780,3,7,1400,400,533000
3,2,1920,7598,4,8,1920,0,443500
4,1.75,1550,7350,4,8,1550,0,645000
2,1,800,4046,3,7,800,0,422500
1,0.75,470,15000,3,4,470,0,156000
3,1.75,1600,6120,3,7,1600,0,525000
2,1,1330,3698,3,7,1330,0,450500
3,2.5,2130,7199,3,8,2130,0,546500
3,1.75,1660,9900,3,8,1660,0,460000
3,2.75,1850,8820,4,8,1850,0,303000
3,1.5,1680,8000,3,7,1680,0,425000
4,2.75,3300,4987,3,9,3300,0,849990
4,3.75,3460,6738,3,11,3460,0,971971
4,2.25,1830,9485,4,7,1200,630,236000
3,1,1190,5100,4,7,1030,160,442000
4,2.5,2440,7093,3,7,2440,0,310000
3,1.5,1570,10824,3,7,1570,0,227064
4,1.75,2120,9786,3,8,1640,480,492650
3,3,2390,19454,3,8,2390,0,519500
5,4.25,4860,9453,5,10,3100,1760,2.25E+06
3,2.5,2800,10603,3,9,2800,0,550000
4,2.25,2290,40946,4,8,1550,740,899000
6,1.75,1840,2774,3,7,1060,780,660000
3,2.5,1580,2765,3,8,1580,0,349900
2,1.75,1460,426450,5,7,960,500,390500
2,2.5,1620,14467,3,7,1620,0,475000
5,2.5,3840,16905,3,11,3840,0,556000
3,1.75,1390,7904,3,7,1390,0,406000
4,2.25,2230,7200,4,7,1300,930,400000
4,2.5,2700,10814,4,8,1560,1140,300000
3,2,2300,13418,3,8,1430,870,610000
3,1.5,1570,6700,4,7,1570,0,419000
4,2.5,1610,4568,3,7,1610,0,292500
5,3,3480,15185,4,8,3480,0,970000
3,1.75,1530,9800,5,8,1530,0,425000
3,1,940,7913,3,6,940,0,280000
3,2,1330,6000,4,7,630,700,240000
4,2.75,3260,5000,3,9,3260,0,800000
2,1,760,4000,4,6,760,0,265000
3,1.5,1520,7123,4,7,1520,0,292600
2,1,680,8064,3,6,680,0,110700
2,1,1290,6272,4,6,890,400,492000
3,1,1010,7500,4,7,1010,0,315000
2,1,910,6490,3,7,910,0,405000
3,2.5,1910,5562,3,8,1910,0,496600
3,1.75,1100,9750,4,6,1100,0,212000
4,2.5,2630,28298,3,8,2630,0,650000
6,4,2280,5275,3,7,1270,1010,449500
2,1,930,2600,3,7,930,0,281000
2,1,1131,1304,3,7,1131,0,394950
3,2,3650,843309,4,7,3650,0,550000
3,1.75,1410,15134,3,7,1410,0,315000
2,1,840,12750,3,6,840,0,175000
3,1.75,2430,5000,4,7,1760,670,626000
3,1.5,1950,1963,3,8,1950,0,530000
4,2.25,1960,9021,4,8,1960,0,610000
4,4,3530,8400,5,8,2630,900,1.10E+06
4,1.5,1790,4080,5,7,1790,0,704300
4,3.5,4560,16643,3,12,2230,2330,1.21E+06
3,2,1690,9516,3,7,1690,0,265000
3,2.5,2740,9168,3,9,2740,0,409000
2,1,1030,4841,3,7,920,110,535000
3,2.5,1610,6176,3,7,1610,0,255000
4,1.75,1670,10200,3,7,1390,280,476500
4,3,2130,6325,5,7,1440,690,620000
4,2.75,3210,8520,4,7,1810,1400,750000
3,1.75,1410,1899,3,8,1410,0,267800
4,2.5,2970,5050,3,8,2970,0,855169
5,3,2980,10064,3,7,1680,1300,367500
4,4.25,3650,5328,3,9,2330,1320,1.52E+06
3,2.5,2250,10171,3,9,2250,0,615000
4,2.25,2110,7560,4,8,2110,0,475000
3,2.25,1800,9010,3,7,1300,500,365000
3,2,1970,9600,4,7,1300,670,294700
3,1.5,2240,87625,2,7,1480,760,335000
4,1,1540,4500,2,7,1540,0,462500
3,3,2300,7701,3,7,2300,0,250000
5,2.5,2090,4698,3,7,2090,0,315000
2,1,740,8853,3,6,740,0,230500
3,1,1420,9600,4,6,1420,0,147200
4,2.5,2250,7526,3,8,2250,0,440000
4,2,1560,3840,4,6,960,600,459000
5,3.5,5170,7197,3,11,3520,1650,1.68E+06
2,1,960,4920,3,6,960,0,280000
2,1,1320,4750,4,7,1320,0,575000
2,1.75,1100,7600,3,6,1100,0,189650
3,1.75,1340,3850,4,7,1340,0,385000
3,1,1050,7560,3,7,1050,0,333000
4,2.5,2154,6050,3,8,2154,0,335000
2,1,1290,4636,3,7,1290,0,600000
3,2.25,1830,7897,4,8,1290,540,572000
4,2.5,2250,6840,3,9,2250,0,395000
4,2.5,2478,6079,3,8,2478,0,386000
3,1,1740,9163,3,7,1740,0,575000
3,2.5,2095,3438,3,7,2095,0,292500
5,3,2500,5750,3,8,1430,1070,430000
3,3,3620,28064,5,10,2370,1250,2.23E+06
3,1.5,1280,5525,3,7,1280,0,342450
4,2.25,2270,7800,3,7,1290,980,446000
3,2,1800,10950,4,8,1800,0,440000
3,2.25,1820,8814,3,7,1280,540,425000
4,1.75,1870,12500,5,6,1030,840,375000
3,2.5,2190,8528,3,8,1760,430,702000
4,1.75,2430,5481,3,8,1430,1000,402000
3,2.25,1630,10500,3,7,1100,530,425000
4,1.75,1950,10219,3,7,1950,0,395000
4,2.5,2770,10051,3,10,2770,0,685000
3,2.5,2150,7484,3,8,2150,0,368250
2,1.5,830,1333,3,7,830,0,301500
6,1,1530,4305,4,7,1530,0,642000
3,1.5,1940,8951,3,7,1300,640,299950
4,2.5,4150,8436,3,10,4150,0,969990
4,3.75,3810,9916,3,11,3810,0,1.58E+06
5,2.5,3160,11470,4,9,1780,1380,980000
2,1,1040,4172,3,7,1040,0,370000
3,2.5,1830,13042,3,8,1830,0,375000
2,1,860,6800,3,6,860,0,227000
5,3.5,2990,212137,3,8,2450,540,750000
5,3.5,3090,3600,3,9,2060,1030,1.11E+06
3,1.75,2140,3584,3,7,1070,1070,680000
3,2.25,1990,6350,3,7,1990,0,309950
4,3.75,3880,9979,3,10,3880,0,1.06E+06
5,2.75,2130,5000,5,7,1100,1030,353000
3,2.25,3040,52302,3,9,3040,0,1.00E+06
4,2.75,2730,6856,3,8,2730,0,565000
3,2.5,2080,4556,3,8,2080,0,567500
4,2.75,3340,5700,3,11,3340,0,962000
3,1.75,1560,104108,3,7,1250,310,380000
3,1.75,1200,5478,5,6,1200,0,250000
3,1,1580,8308,3,7,1580,0,340000
3,1.5,1170,11530,3,7,1170,0,246500
3,2.5,2220,6380,4,8,1660,560,650000
3,2.5,1980,2975,3,8,1980,0,736000
3,2.5,2490,18525,3,8,2490,0,370000
2,1,1570,5000,4,8,1570,0,800000
3,1.75,1630,9000,3,7,960,670,725000
5,3.25,4610,10576,3,11,3310,1300,1.20E+06
4,1.75,3100,21303,4,9,3100,0,950000
4,2.75,2790,6685,3,8,2790,0,533380
5,2,2610,5009,3,7,1710,900,439000
3,1,1340,6120,4,7,1340,0,255000
2,2.75,1430,1425,3,7,995,435,465000
3,1.5,2010,10100,4,7,1110,900,319000
3,2.25,2330,11424,4,8,2330,0,700000
4,2.25,2010,9603,3,8,1440,570,660500
4,1.75,1900,9861,4,7,1900,0,190000
3,2,1840,4750,5,7,1010,830,730001
2,1,1330,5510,3,6,850,480,417500
5,2.75,3078,6371,3,9,3078,0,459950
3,2.5,2090,4700,3,8,2090,0,289000
3,2.25,1640,4635,3,8,1540,100,517000
3,1.75,1630,1526,3,8,1630,0,609000
5,2.25,2710,19800,5,9,1910,800,830000
3,2,1370,78408,5,7,1370,0,354800
3,1.5,1970,10080,3,7,1970,0,406500
4,2.5,3980,16304,3,10,2480,1500,1.58E+06
5,3.5,3420,6403,3,8,2700,720,641000
3,2.5,2210,7000,4,8,2210,0,412000
4,2.25,2200,11250,5,7,1300,900,698000
4,2.25,3190,52953,4,10,3190,0,832000
4,2.5,1660,8063,4,7,1660,0,270000
3,3,3450,16200,3,10,3450,0,688000
3,2.5,2810,4607,3,8,2810,0,533000
3,2.5,2530,9932,3,8,2530,0,717500
3,2.25,1800,10500,3,7,1800,0,332500
4,2.5,2720,8666,3,9,2720,0,370000
4,2.75,2170,5024,3,8,2170,0,467000
4,1.75,1480,9523,3,7,1120,360,239900
3,2.5,2740,11872,3,9,2740,0,363000
4,2.5,2100,7208,3,8,2100,0,333000
4,1.75,2700,6000,4,8,1450,1250,725000
4,2.5,2430,5499,3,8,2430,0,310000
2,1,770,10000,3,6,770,0,180000
5,2.5,3020,21441,4,8,1510,1510,320000
3,1.75,2600,7668,4,8,1300,1300,700000
2,1.5,1220,1036,3,7,1220,0,286308
2,2,1140,8282,3,6,1140,0,498000
2,1.5,1170,1274,3,8,1170,0,405000
4,1.5,2030,3300,4,8,1530,500,750000
4,2.25,2040,7031,3,8,2040,0,670000
3,1.5,1220,962,3,8,1220,0,500000
5,2.5,3000,10560,3,8,1500,1500,800000
3,2,1460,10311,4,7,1460,0,455500
4,1,1120,8763,3,6,1120,0,227000
3,2.75,1300,14197,3,7,860,440,245000
2,1.75,1780,4520,5,7,890,890,639950
3,2.25,2570,47480,3,9,2570,0,625000
3,2.25,2800,17300,4,8,1420,1380,653000
3,3,2560,3600,3,10,2110,450,925000
3,1.5,1280,1920,3,7,1280,0,458500
3,3,1390,1080,3,7,1140,250,275000
3,1.75,2130,5489,3,8,1370,760,338500
2,1,920,10000,4,7,920,0,555500
3,1,1080,7486,3,6,990,90,228500
3,2,1440,10111,3,7,1440,0,210000
4,2.5,1560,4350,3,7,1560,0,280000
5,2.25,2230,9600,3,8,1320,910,482000
5,1.75,2320,7700,5,7,1290,1030,250000
4,3.5,3270,15704,3,9,2110,1160,650000
3,2.5,1590,3359,3,7,1590,0,310000
2,1,890,8180,3,7,890,0,275400
5,2.25,1950,8025,3,7,1150,800,525126
4,2,1790,61419,2,7,1790,0,375000
4,2.5,3060,7920,3,8,1810,1250,446500
3,2.5,1550,12920,5,7,1550,0,537000
4,1,1670,4600,5,8,1670,0,875000
3,2.5,2070,4463,5,8,1780,290,781000
3,2.25,1850,4050,4,7,1850,0,445000
2,1,810,6150,3,7,810,0,299900
3,2.75,2480,3240,3,9,1890,590,690000
4,3.5,3350,6350,3,8,2610,740,844000
3,1.5,1740,9840,4,8,1740,0,616000
3,2,1230,8235,3,6,1230,0,195000
3,2.5,3420,16622,3,10,2410,1010,1.20E+06
4,2.5,2160,9682,3,8,2160,0,345500
3,1,1010,7200,5,6,1010,0,318000
3,1.75,1150,6600,4,6,1150,0,370000
3,1.75,2170,153767,3,7,2170,0,585000
4,1.75,2160,28750,4,8,2160,0,324888
5,2.5,3070,34991,3,9,3070,0,620000
3,2.5,2540,7680,4,9,2540,0,675000
3,1.5,1140,4875,5,6,1140,0,218000
5,4.5,3540,21217,4,8,2940,600,707000
4,2.75,2970,12750,4,7,2130,840,1.57E+06
4,3.25,4030,57499,3,9,4030,0,929000
2,1.75,1560,7575,3,8,1560,0,290000
3,1,970,12300,3,7,970,0,300000
3,1,1400,7360,4,7,1400,0,148226
3,2.5,2060,10650,5,8,1050,1010,700000
2,1,830,6000,3,6,830,0,210000
5,2.5,2950,5500,5,7,1720,1230,660500
3,2.5,1280,5040,4,7,1280,0,415000
4,1.75,2180,4066,3,6,1270,910,334900
3,1.75,1220,7370,4,7,1220,0,500000
3,2.5,3670,18505,3,10,2530,1140,1.25E+06
2,1,800,10625,3,6,800,0,109500
3,3.5,2460,14155,3,8,1900,560,665000
5,3.25,3130,12087,3,8,2180,950,500000
3,2.5,1480,1663,3,9,1180,300,341000
3,2.25,1770,8000,4,7,1350,420,436000
3,1.75,1250,5963,4,7,1250,0,450000
3,1.5,1240,9405,4,7,1240,0,215000
6,3.5,3830,68825,3,9,3830,0,710000
3,1,1140,8180,3,7,1140,0,550000
4,2.5,2650,4316,3,8,1520,1130,705000
3,3,2330,1944,3,8,1950,380,669950
3,1,1300,6098,3,7,1300,0,155000
3,1,1910,8710,3,7,1080,830,260000
3,2.25,1420,3433,4,7,1420,0,336500
3,2.5,1880,3054,3,8,1880,0,541900
4,1.75,2360,11300,4,9,2360,0,732000
4,1.5,1580,10260,4,7,1030,550,475000
3,1,1110,12150,4,7,1110,0,416000
2,2.25,1390,1222,3,7,1340,50,465000
4,2.5,2550,5835,3,8,2550,0,543500
3,1.75,1730,6130,3,7,1480,250,575700
3,2.5,2560,35265,3,9,2560,0,700500
3,2.5,1660,5250,4,8,1660,0,265000
3,2.25,2220,9800,3,8,2220,0,470000
3,2.25,1300,907,3,8,1000,300,562500
6,2.75,5700,20000,4,10,2850,2850,1.39E+06
6,5,3440,4500,3,8,3280,160,495000
5,2.75,3110,6621,3,9,3110,0,635000
3,1,1290,9526,3,7,1290,0,321000
4,1.75,1940,6909,4,7,970,970,423000
4,2.75,3020,8622,3,9,3020,0,1.19E+06
3,2.5,1660,10763,3,7,1660,0,315000
2,2,2010,3797,3,7,1450,560,400000
2,2.25,2210,5500,4,8,1410,800,614306
3,2.25,2010,7447,3,8,2010,0,500000
4,2.75,2380,15800,3,8,1680,700,655500
4,2.5,4073,17334,3,8,4073,0,510000
3,1.5,1970,13709,4,7,1680,290,425000
4,2.25,2500,10890,5,7,1800,700,488000
4,2,1580,9581,3,7,1580,0,410000
3,1.75,2930,19876,3,9,2030,900,600000
4,2.5,3670,9958,3,10,3670,0,525000
3,1,920,6460,5,6,920,0,189950
3,2.5,1910,5125,3,9,1910,0,663000
2,1,840,5400,4,7,840,0,389100
3,1.75,2170,4000,4,7,1110,1060,913000
2,1.5,1450,2550,3,7,820,630,450000
4,3.5,3930,6120,3,10,3310,620,1.49E+06
3,2.5,2160,59241,3,7,2160,0,389900
3,1.75,1140,8263,5,7,1140,0,310000
3,1.5,1100,32700,3,7,1100,0,194820
3,1.75,1400,12155,4,7,1400,0,460000
3,2.75,1930,2960,5,7,1490,440,665000
3,2,2870,6360,4,8,1790,1080,810000
3,1.75,1720,37363,4,8,1350,370,521000
2,1,990,10556,3,7,990,0,250000
4,3.5,3500,4080,3,9,2590,910,1.01E+06
3,1.75,2350,7641,3,7,1510,840,440000
3,1,1050,8498,4,7,1050,0,249000
5,3.5,3740,5610,3,9,2860,880,1.08E+06
3,1,970,8378,4,6,970,0,172380
3,2.5,2600,7210,3,8,2600,0,475000
4,2.5,2520,35636,3,8,2520,0,575000
2,1.5,1800,26615,5,7,1240,560,345000
3,2,2350,12480,3,7,1600,750,430000
3,1.5,1200,8040,4,7,1200,0,279500
3,1,1000,6947,4,7,1000,0,375000
3,3.25,3050,18892,4,8,1650,1400,950000
4,2.5,2040,8400,3,8,1420,620,500000
3,2.5,1690,1200,3,8,1410,280,409900
3,1.75,2180,7700,3,8,1480,700,506000
2,1,1260,5800,4,7,1260,0,661000
2,1,700,2334,3,7,700,0,367000
2,1,1120,88327,4,6,1120,0,435000
4,2.75,2940,5400,5,8,1940,1000,1.01E+06
4,3.5,1880,1341,3,8,1650,230,545000
3,2,1600,13200,3,7,1600,0,308550
2,2.5,1240,1546,3,7,1240,0,330000
4,2.25,1763,3717,3,8,1763,0,305000
2,2.5,1170,1638,3,8,1170,0,325000
3,1.75,1980,9220,3,8,1980,0,297300
3,2.5,2270,7887,3,8,2270,0,485000
3,3.5,3690,8837,3,10,3690,0,725000
2,1,890,6000,3,6,890,0,334000
3,1,1200,7800,4,7,1200,0,275000
3,1.5,2120,6290,4,8,1220,900,440000
4,1.5,1730,8505,4,7,1730,0,270000
2,1,1400,8220,3,7,1400,0,401000
3,2.5,2100,3574,3,7,1690,410,350000
3,3.25,2030,11070,4,8,2030,0,685000
3,1,1220,7695,3,7,1220,0,222000
3,3.25,1510,2064,3,8,1220,290,675000
4,3.5,4065,18713,4,10,4065,0,1.95E+06
3,1,1180,9832,3,7,1180,0,169950
3,2.25,1880,7488,3,8,1880,0,290000
5,4.25,6070,171626,3,12,6070,0,1.55E+06
2,1,720,18000,3,6,720,0,195000
3,2.25,1333,1470,3,7,1333,0,338500
4,2.5,2630,6185,3,9,2630,0,585000
3,1,1010,8184,4,6,1010,0,349000
2,1,590,10945,3,5,590,0,398000
4,2.5,2080,4080,5,7,1040,1040,360000
3,1.75,1300,11230,5,7,1300,0,232000
3,2.5,2900,23550,3,10,1490,1410,770000
4,2.5,1680,3000,3,7,1680,0,290500
3,2.25,1800,9800,4,7,1300,500,420000
3,1,1090,8280,3,6,1090,0,289950
3,2.5,1400,4800,3,7,1200,200,537000
3,1,1440,27505,3,8,1440,0,530000
5,1.75,2140,12058,4,8,2140,0,250750
3,2.5,1710,2300,3,8,1570,140,539000
4,1,1730,8706,4,7,1010,720,312000
2,1,800,6500,4,6,800,0,295000
3,2.5,1330,1200,3,7,1330,0,300000
4,2.25,3360,10810,4,9,3360,0,465000
2,1,1170,7142,3,7,1170,0,225000
2,0.75,1330,2856,4,7,930,400,399950
3,2.5,1690,10592,3,8,1690,0,875000
4,2,1970,10500,3,8,1820,150,410000
3,0.75,1240,7200,3,7,1240,0,352000
2,1,880,6171,4,7,880,0,378500
2,2,1660,4500,3,8,1660,0,559000
3,2.5,1460,7936,3,7,1460,0,295000
3,2.5,1930,7266,3,8,1930,0,490000
3,1.75,1370,14030,4,8,1370,0,235000
4,3,3160,10948,3,8,1930,1230,545000
6,2,2320,210830,4,8,2320,0,400000
3,3.25,3080,12100,3,8,2080,1000,695000
3,2.5,1600,3573,3,7,1600,0,305450
3,1.75,1800,16026,3,8,1390,410,493500
4,2.75,2420,6495,3,8,2420,0,369000
5,1,1410,6750,3,6,1410,0,435000
3,2,1580,4010,4,7,790,790,489950
2,1,810,3880,3,7,810,0,357950
3,1.75,1640,10464,4,8,1640,0,1.16E+06
3,1.75,1510,8400,2,7,980,530,195000
3,2,1860,7232,3,7,1320,540,460000
3,2.5,2310,7485,3,8,2310,0,362000
3,1.75,1500,10269,3,7,1030,470,352500
3,2,1440,7187,4,7,970,470,222000
3,2.5,1820,7242,3,7,1220,600,239975
4,2.5,2330,7936,3,9,2330,0,565000
3,2.5,1920,3624,3,9,1920,0,674000
3,2.25,2300,12430,4,8,1580,720,590000
3,2.5,2260,10153,3,10,2260,0,600000
3,1,1430,10005,4,7,1430,0,400000
3,2.75,2460,6413,3,9,2460,0,646000
3,2.25,1460,1353,3,8,1050,410,497000
4,1.5,1800,10150,4,7,1800,0,449950
3,2.5,2660,4975,3,8,2660,0,599950
3,1.5,1240,5506,4,7,1240,0,225000
3,1,1450,6000,4,7,1450,0,287000
3,2.5,1840,9900,3,9,1840,0,552000
3,2.5,2730,5832,3,9,2730,0,1.00E+06
3,1.75,2000,7560,4,7,1300,700,295000
2,1,1100,4750,3,7,1100,0,502501
2,1,990,6448,3,7,990,0,219950
5,2,2050,10200,3,6,1430,620,210000
5,5.5,6640,40014,3,12,6350,290,4.50E+06
3,2.25,1750,8900,4,8,1750,0,341000
5,2.75,3430,15119,3,10,3430,0,850000
4,1.75,2160,4333,4,8,1260,900,450000
4,1,1350,4000,3,8,1350,0,571000
5,3.5,5930,13288,3,11,3920,2010,1.52E+06
3,1.5,2110,5195,3,7,1210,900,369000
2,1,980,5000,4,7,980,0,455000
3,1,1030,4958,5,7,1030,0,718000
3,1.75,1650,14633,4,7,1650,0,292000
2,1,1270,6000,3,7,1270,0,425000
3,2.5,2320,5000,3,8,1620,700,900000
3,1.75,1540,9000,3,8,1540,0,490000
3,2,2200,21890,3,8,1200,1000,472000
3,2.5,2620,51354,3,9,2620,0,695000
2,1.5,1780,4750,4,7,1080,700,555000
4,2.75,2990,11210,4,8,1880,1110,350000
4,2.5,1950,5451,3,7,1950,0,360000
3,2.5,1530,8500,5,7,1030,500,245000
3,2.5,2030,217805,3,9,2030,0,565000
3,2,1820,6324,5,7,910,910,725000
5,2,2730,7344,5,7,1510,1220,310000
4,2,1190,7877,5,7,1190,0,329000
2,1,1050,2699,3,7,1050,0,310000
3,2.5,2620,241200,4,9,2620,0,775000
4,2.5,2470,385506,3,7,2470,0,438950
3,1,1180,7068,3,6,1180,0,289900
3,2.5,1800,2790,3,8,1800,0,364000
4,3.25,2400,29252,4,8,2400,0,585000
4,1.75,1820,6137,4,7,1690,130,790000
3,2,1580,6655,3,6,790,790,221347
3,2.5,2280,12498,4,9,2280,0,560000
2,1,1140,3990,3,7,1140,0,695000
2,1.75,1500,4158,4,7,1220,280,340000
5,3,3480,57499,4,8,2340,1140,532000
3,2.5,2420,4750,3,8,2420,0,301000
4,2,1870,3497,3,7,1200,670,355000
4,2.5,2440,4850,3,8,2440,0,745641
3,1,1210,7425,4,6,1210,0,375000
4,2.5,1920,9000,2,7,1920,0,425000
4,2.5,3010,9323,3,10,3010,0,754999
3,2.5,1720,1715,3,7,1240,480,398000
3,2.5,2510,12779,3,10,2510,0,1.95E+06
3,1.75,1180,21275,4,6,1180,0,207000
4,4.5,4300,19844,3,11,4300,0,2.50E+06
1,1.5,1010,5750,3,7,1010,0,410000
4,2,1960,2166,4,7,1260,700,509000
4,1.75,1820,13600,3,7,1120,700,268500
2,2.25,1100,1695,3,9,1100,0,374000
5,3,3610,7555,3,8,3610,0,549900
3,1,860,10426,3,6,860,0,219900
3,2.5,2110,8164,3,9,2110,0,535000
5,2.5,3440,12900,4,8,1720,1720,554000
4,2.75,2990,4521,3,7,2990,0,564950
4,3,2030,12675,3,7,2030,0,499000
2,1.5,1310,1264,3,8,1120,190,450000
4,2.5,2150,3721,3,8,2150,0,260000
2,1,770,6731,4,6,770,0,315000
2,1,1200,24792,2,7,1200,0,170000
4,2,2470,1831,3,7,1970,500,305000
4,1.75,1480,11200,4,7,1480,0,310000
4,2.5,2660,11200,3,9,2660,0,1.13E+06
3,2.25,1640,6044,3,7,1640,0,275000
3,2,1010,21340,3,8,1010,0,354000
3,2.5,1720,6194,3,8,1720,0,255000
3,1.75,2090,7667,3,7,1200,890,489000
3,2.5,2210,70567,3,9,2210,0,509950
2,1.5,830,1241,3,7,830,0,425000
3,1,1110,9827,3,7,1110,0,217000
2,2.5,1340,5995,3,7,1340,0,275000
4,2.5,2690,9551,3,9,2690,0,439000
4,2.25,1790,9920,4,7,1170,620,330000
3,3.25,1430,1348,3,8,1160,270,478000
2,1.75,1315,2162,4,8,1315,0,347000
3,0.75,1080,5025,3,5,1080,0,205000
3,2.5,1420,14850,4,7,1020,400,260000
3,1,1100,7657,3,7,1100,0,233000
4,1.75,2190,9225,4,7,1250,940,375000
3,1,970,9360,4,5,970,0,206000
3,2.25,1480,7565,3,7,1220,260,439000
3,2.5,2200,7350,5,8,1570,630,365000
4,2.5,2030,5202,3,8,2030,0,304500
4,2.5,2050,12500,3,7,1300,750,260000
4,1.75,1690,8392,3,7,1190,500,405000
3,1.75,1510,5200,4,7,860,650,624000
3,1.75,1890,11141,4,8,1890,0,575000
3,1.75,1440,7200,3,7,1440,0,239950
4,2.5,2030,39049,4,7,1530,500,515000
3,1.5,1940,9887,4,7,1140,800,232500
4,2.5,1880,7965,3,7,1880,0,324900
2,1,1120,8661,3,7,1120,0,399000
4,1.75,1870,22072,3,7,1070,800,285000
3,2.25,1450,19206,3,7,1450,0,410000
4,2,2280,7200,4,7,2280,0,500000
5,2.25,2540,3750,4,7,1510,1030,660000
1,1,600,3720,3,6,600,0,229000
3,2.5,1600,1311,3,8,1600,0,465000
3,2.5,2500,10359,3,10,2500,0,705000
3,2,1370,8336,5,7,1370,0,371500
3,2.25,1620,998,3,8,1540,80,461000
3,2.5,2230,3939,3,8,2230,0,679950
3,1,1030,4583,3,7,1030,0,210000
3,1.5,2050,6384,3,7,1350,700,442000
3,2.5,1600,2788,4,7,1600,0,245000
3,1.75,1390,8980,4,8,1390,0,278500
3,2.5,2010,14298,3,7,2010,0,350000
4,2.75,1670,6000,5,7,840,830,605000
3,2.25,2520,6170,3,7,1850,670,364950
4,1.75,2100,7960,3,8,1340,760,735000
4,1.5,1740,7292,3,7,1020,720,180000
4,3.75,3730,17000,4,10,2820,910,1.56E+06
3,2.5,3290,90796,4,10,3290,0,685000
2,1.75,1320,2609,4,7,920,400,422000
2,2.25,1320,1034,3,7,1320,0,304000
3,1,1150,11802,4,7,1150,0,346500
4,3.25,4690,14930,3,10,3680,1010,600000
2,2.25,1010,1107,3,8,710,300,459000
4,2.5,3160,39960,3,10,3160,0,940000
3,1.75,2370,9750,4,7,1280,1090,355000
3,1.75,2120,5000,3,7,1980,140,765000
2,2,1400,10052,3,8,1400,0,431750
3,2.5,2580,8154,3,10,2090,490,699000
2,1,1150,15000,3,6,1060,90,224000
3,2.25,2870,8170,3,10,2250,620,850000
4,2.25,2100,9984,4,7,1290,810,418800
4,2.25,3220,8436,3,8,3220,0,800000
2,1,1010,7200,3,6,1010,0,200000
4,1.5,2470,6000,3,7,1480,990,700000
4,2.75,2700,37011,3,9,2700,0,385000
3,1,1220,5652,3,6,1220,0,575000
3,1.75,1710,10950,3,7,1060,650,290000
3,1,1300,7975,4,7,1300,0,415000
1,1,790,2400,3,7,790,0,439000
3,2.5,1690,4088,3,7,1690,0,498000
4,1.75,2360,8286,3,7,1320,1040,875000
4,2.25,2450,62290,3,8,2450,0,510000
3,1,1260,7660,3,6,1260,0,280000
2,2.5,1340,1240,3,8,1150,190,400000
3,1,1180,8775,3,7,1180,0,190000
2,2,1670,7772,4,6,860,810,448000
4,2.25,2590,8190,4,8,2590,0,673000
4,1.75,1120,8250,4,7,1120,0,252000
3,2.25,2250,5301,4,8,1510,740,750000
3,2.25,2070,2833,3,8,1490,580,675000
3,2,1170,6750,5,7,800,370,592500
4,2.5,2480,5000,3,7,2480,0,599000
3,1.75,1700,8481,3,7,1700,0,300000
4,2.5,2500,8540,3,9,2500,0,639000
3,2.75,2770,5800,4,8,1650,1120,1.08E+06
3,2.5,1960,3953,3,8,1960,0,395000
3,2.25,1550,1485,3,8,1550,0,380000
3,1.75,1800,6000,5,7,900,900,471001
3,2.5,2424,6143,3,9,2424,0,391500
2,2.25,1040,1516,3,8,1040,0,430000
3,1.5,2450,12497,4,7,2450,0,358000
2,1.5,1240,1055,3,8,1200,40,277700
3,2.5,2930,6050,3,9,2930,0,650880
4,2.5,3120,7448,3,9,3120,0,444900
4,2.25,2550,7800,3,8,1580,970,560000
4,3.75,2452,4800,3,7,2452,0,430000
4,2,1440,7680,3,7,1200,240,397000
3,2,1820,1358,3,9,1820,0,479950
4,3.25,3160,10043,3,9,3160,0,1.25E+06
4,2,2990,12970,4,7,1960,1030,590000
3,1,1090,3523,4,6,1090,0,152500
4,2.5,1930,8458,3,7,1930,0,325000
3,2.5,1430,10200,3,7,1430,0,405000
4,2.25,2770,13129,4,8,2770,0,652427
3,2.5,2170,9798,3,7,2170,0,340000
4,1.75,2000,7350,3,7,1100,900,267000
4,1.75,2220,6350,3,7,1110,1110,526000
5,2.75,3630,38461,3,11,3630,0,716500
3,1.75,3160,76230,4,8,2160,1000,625000
4,3.25,2780,7875,3,9,2780,0,700000
3,3,1740,3700,3,7,1740,0,612000
4,2.5,3030,6820,3,9,2530,500,998000
3,2.5,1730,4286,3,7,1730,0,339950
4,2.5,2181,5521,3,8,2181,0,340000
2,1.75,1170,976,3,9,780,390,530000
3,2.5,2610,6405,3,8,2610,0,605000
3,1.75,1010,9600,5,7,1010,0,230000
3,1,860,5185,4,6,860,0,198000
4,2,1560,7569,4,7,1560,0,279000
3,1.75,2210,8955,3,8,1560,650,685000
3,1.5,1360,7680,3,7,1360,0,352500
3,2.5,2820,5001,3,9,2820,0,690000
4,2.5,3400,9692,3,9,3400,0,830000
4,2.5,1720,3515,3,8,1470,250,536500
3,2,1390,10155,3,7,1130,260,190500
2,1.5,910,966,3,8,820,90,455000
3,1.5,1600,8040,4,7,1050,550,383900
3,2,1600,7995,3,7,1600,0,332500
2,1.5,1010,3060,4,7,1010,0,395000
3,1.75,1370,9680,4,7,1370,0,400000
3,1.75,1890,32340,3,8,1890,0,445000
3,2.5,2160,9888,4,9,2160,0,733000
4,2.5,2070,3982,3,7,2070,0,450000
4,2.5,2680,3626,4,7,1680,1000,612000
4,2.75,2790,6600,3,9,2790,0,459000
1,1,1160,5000,3,7,1160,0,336000
4,2.25,2180,8000,4,9,1630,550,340000
4,2.5,2280,27441,3,8,2280,0,575000
3,1.75,1260,10488,2,7,1110,150,194000
4,3.75,3250,10949,4,9,2940,310,1.21E+06
3,2.75,1690,5763,5,7,1180,510,410000
3,2.75,2500,5568,5,9,2500,0,1.19E+06
4,2,3410,15143,4,8,3410,0,599000
4,1.5,1840,9009,3,7,1840,0,262000
3,1,1320,5000,4,7,1090,230,594000
5,1.5,2040,11772,4,7,1030,1010,287000
3,1.5,1810,349351,3,7,1810,0,430000
3,1,1070,7615,4,7,1070,0,195000
2,2,1390,1302,3,7,1390,0,186950
4,2.5,2420,9147,3,10,2420,0,389000
3,1.75,1720,10710,3,7,860,860,340000
4,2.5,3130,21100,3,9,2530,600,937500
2,1.5,870,747,3,8,800,70,313000
4,3,2240,7035,3,7,2240,0,400000
5,2.75,2930,31411,4,9,1520,1410,610000
4,2.25,2100,8075,3,8,2100,0,280000
4,2.75,2810,7302,3,9,2810,0,699900
3,2,1650,3952,3,7,1650,0,550000
4,2.5,2560,4020,3,9,2560,0,410000
3,2.5,1500,7350,2,7,1060,440,279000
3,1.75,2080,5687,4,8,2080,0,695000
4,1.75,2520,7200,5,7,1260,1260,435000
3,1.75,1340,10276,4,7,1340,0,330000
4,2.5,2846,85377,3,8,1976,870,482000
3,2.25,2990,216057,3,9,2990,0,500000
3,1,870,5200,5,6,870,0,217000
3,1.75,1420,3000,3,5,710,710,230000
2,1,910,5759,3,6,910,0,455000
6,2.75,2890,7500,4,8,1830,1060,508000
4,3.5,1460,951,3,8,1460,0,580000
3,2.5,3040,7232,3,7,3040,0,330000
3,2.25,2260,33080,5,9,1690,570,778000
4,2.5,1960,5642,3,7,1960,0,308000
4,2.5,2470,2550,3,8,2470,0,735000
3,1.75,2910,35200,3,8,2910,0,550000
2,1,1500,4000,3,8,1100,400,736000
4,2.5,2570,5520,3,9,2570,0,625000
4,2.5,2440,6733,3,9,2440,0,769000
3,1.75,1590,13500,4,7,1090,500,290000
3,2.5,2300,8938,3,9,2300,0,395000
3,3.25,3240,4185,3,8,2770,470,724500
4,1.75,2000,5100,4,7,1130,870,595000
3,2,1400,8640,5,7,1400,0,253400
2,1,780,4200,3,6,780,0,360000
4,2,1820,5000,3,7,1640,180,650000
2,1,810,4838,3,5,810,0,238950
3,1,990,8062,4,7,990,0,250000
4,2.5,2329,9436,3,9,2329,0,540000
3,2,2160,8091,3,8,2160,0,355000
5,4.25,3380,7805,3,8,3380,0,569950
4,2.75,2020,2750,3,8,1010,1010,599000
4,2.25,2870,6000,5,8,1730,1140,1.27E+06
4,2.5,3238,9112,4,8,1678,1560,355425
2,1,620,4455,3,6,620,0,425000
3,2.25,1760,45133,3,7,1760,0,387000
4,2.5,2960,4640,3,9,2960,0,426500
3,1.75,2390,6000,3,6,1240,1150,405000
3,1,910,8700,4,6,910,0,165000
5,1.75,2190,8250,3,7,1190,1000,250000
3,1.75,1740,8560,3,8,1500,240,827235
3,2.5,2420,4725,3,8,2420,0,369946
3,2.25,1490,1294,3,7,1220,270,309000
2,1.5,1010,948,3,8,1010,0,387000
3,2.5,1870,7942,3,7,1870,0,299950
2,1.75,1800,7191,4,7,990,810,380000
3,2.5,2050,3218,3,7,2050,0,427000
5,3.5,3960,25245,3,9,2500,1460,650000
2,1.5,1020,1060,3,8,1020,0,441750
4,2.5,3000,8645,3,8,3000,0,490000
4,2.5,2930,9158,3,9,2930,0,890000
3,2.25,1460,941,3,8,1460,0,337000
3,2,2080,5750,5,7,1040,1040,660000
5,1,1260,8382,3,7,1260,0,220000
3,2,1810,12420,4,7,1810,0,555700
3,2.5,1690,4898,3,7,1690,0,464000
2,1.5,880,1157,3,7,880,0,210000
4,2.5,2190,7000,3,8,2190,0,334950
6,2.5,3760,12978,3,9,2360,1400,838300
3,2.5,2450,7062,3,8,2450,0,299000
2,1,860,5080,3,7,860,0,209950
3,2.25,1480,97138,3,7,1480,0,325000
4,4,4930,22093,3,12,4930,0,1.47E+06
3,2.75,2590,12063,3,10,2590,0,695000
5,3.5,2950,2932,3,8,2950,0,619000
4,2.75,2920,4500,3,9,2920,0,730000
3,2.5,2830,5788,3,9,2830,0,590000
3,2.5,1300,10484,3,8,1300,0,374990
3,2.5,1509,1114,3,8,1509,0,401500
3,2,1310,9855,3,7,1310,0,300000
4,3,3370,7920,3,10,1860,1510,1.33E+06
3,2.5,2110,208737,3,9,2110,0,500000
3,2.25,1420,3750,3,7,1420,0,410000
4,2.5,2730,36183,3,9,2730,0,760000
3,1.75,1640,4860,3,8,1200,440,369950
3,1.75,1730,8073,3,8,1350,380,465000
5,2.5,2880,9000,5,8,1440,1440,560000
4,1.75,2240,7500,4,7,1120,1120,344950
5,1.75,1360,10609,3,7,1060,300,431200
3,1.5,1400,14850,4,7,1400,0,383000
4,1.75,1740,9150,3,7,1740,0,380000
2,2.5,1320,1157,3,8,990,330,499000
3,1,980,6530,3,7,980,0,307500
3,1.75,3860,9000,3,9,1930,1930,880000
4,2.5,3290,6012,3,9,3290,0,680000
4,2.5,2448,4949,3,9,2448,0,447055
2,1,1070,4700,5,7,1070,0,543000
2,1.75,1060,1241,3,7,960,100,352750
3,3.25,3620,8131,4,10,2730,890,996000
4,3,2560,5606,3,9,2560,0,350000
3,1,1480,32700,4,6,1380,100,290000
3,2.25,1720,8521,4,7,1140,580,628000
6,2.25,2950,11200,4,7,1700,1250,395000
3,1,1440,13824,4,7,1440,0,604000
3,3,2960,42159,3,10,2960,0,849000
2,1,980,5100,4,6,980,0,395000
3,1.75,1890,93218,4,7,1890,0,267300
2,2.5,1240,2689,3,7,1240,0,174500
3,2.5,1970,3655,3,7,1970,0,350000
3,2.25,1980,8755,4,7,1300,680,309000
3,1.75,1390,9585,4,7,1390,0,374150
5,2.25,2600,8075,4,8,2600,0,265000
3,1.75,3600,8666,4,6,2400,1200,461000
4,1.75,1940,11500,4,7,1090,850,420000
3,1.75,2160,6272,4,8,1390,770,820000
3,2.5,2370,7916,3,9,2370,0,655000
4,2.5,3600,155509,3,9,3600,0,760000
4,2.25,2000,3672,5,7,1650,350,402000
4,4.25,3250,11780,3,8,2360,890,980000
2,1,880,6780,4,6,880,0,205425
3,2.75,3240,7200,3,8,1620,1620,902000
3,1,1100,27008,3,6,960,140,157500
3,2.25,2210,8000,4,8,2210,0,250250
4,3,2800,9764,3,8,2800,0,380000
2,1,860,2599,4,6,860,0,405000
3,2.5,2280,4757,3,8,2280,0,625000
3,1.75,1980,5100,3,7,1270,710,432500
3,2.25,1445,1512,3,7,1300,145,415000
4,2.75,3420,6787,3,9,3420,0,780000
4,3.25,4330,26162,3,11,4330,0,1.21E+06
4,1.75,1420,7500,4,7,1080,340,268500
4,3.5,3590,5335,3,9,3140,450,1.21E+06
3,1.5,1940,2885,3,8,1940,0,1.33E+06
3,2.5,2720,40813,3,8,2720,0,460000
4,2.75,2000,5827,3,7,2000,0,236000
5,3.25,4500,9648,4,8,3000,1500,860000
2,1.5,1040,8526,5,6,1040,0,343000
4,2.5,2550,7500,3,8,1750,800,277500
3,2.5,2830,5831,3,9,2830,0,614000
5,3.75,3090,4943,3,10,3090,0,551000
3,2,2360,6145,3,8,2360,0,348000
2,1,1160,5395,3,7,860,300,350000
3,2.5,1960,3060,3,8,1960,0,732000
3,2.25,1360,1236,3,8,1140,220,500000
4,3.5,2760,5040,3,9,2760,0,1.10E+06
3,1,1500,2555,3,7,1500,0,707500
4,2.5,2850,8526,3,9,2850,0,895000
3,2,2540,7200,4,8,1600,940,775000
2,2.5,1160,1458,3,8,1040,120,525000
3,2.5,1420,1237,3,8,1420,0,510000
3,2,1760,6600,3,7,1760,0,290000
4,2.5,2340,8248,3,8,2340,0,569500
3,3.25,1540,704,3,9,1540,0,742000
3,2.5,2850,12593,3,9,2850,0,364988
3,2.25,2210,10794,3,7,1540,670,520000
5,3,2440,4750,3,9,1450,990,495000
3,2.5,1620,1171,3,8,1470,150,580000
2,2,1250,1178,3,7,980,270,340000
4,2.5,2960,4760,3,8,2160,800,1.02E+06
4,3.5,2840,40139,4,10,2840,0,840000
3,1.5,1140,3104,3,7,1140,0,310000
3,2.5,1440,1068,3,8,1160,280,292500
4,2.5,1830,3868,3,7,1830,0,275000
2,1,1120,35500,5,6,1120,0,243950
3,2.25,1410,1332,3,8,1410,0,406100
3,3.25,3740,136915,3,11,3100,640,710000
2,1,790,6600,3,6,790,0,436000
4,2.5,3130,5200,3,7,3130,0,320000
3,2.25,1620,1057,3,8,1540,80,450000
2,1,1030,9192,4,6,1030,0,225000
3,2.5,1670,22703,3,7,1310,360,415900
3,1,990,9798,3,7,990,0,275000
2,1,1120,2000,3,7,1120,0,524000
3,1,1100,4080,4,7,900,200,428750
3,1.75,2600,105587,4,7,1300,1300,482000
3,3.5,1450,1263,3,8,1160,290,395000
4,3.75,3370,6766,3,9,3370,0,800000
4,2.5,3290,11446,3,8,3290,0,520000
4,2.75,2360,4924,3,8,2360,0,525000
3,1.75,1920,43560,4,7,1340,580,510000
4,1.75,3130,18253,3,7,3130,0,652500
4,1.75,1430,4096,3,7,1430,0,485000
3,1.75,2390,9000,3,8,1500,890,570000
3,3.25,1510,1125,3,8,1510,0,530000
4,3.75,5300,37034,3,11,5300,0,1.15E+06
3,2.5,1670,5298,3,8,1670,0,304000
3,2,2480,13310,2,7,2480,0,1.20E+06
5,3,2100,9752,3,8,1200,900,298450
3,2,1610,15005,4,7,1610,0,345000
3,1,1590,8160,3,7,1090,500,325000
5,1.5,1720,5000,3,8,1720,0,775000
4,1.75,2090,6485,3,7,1280,810,210000
4,2.5,1980,4500,3,8,1980,0,545800
3,2,2090,4190,4,8,1490,600,860000
3,1,1410,5000,3,6,980,430,410000
3,2.5,1750,22357,3,8,1750,0,437000
5,2.75,3650,20150,4,10,2360,1290,1.58E+06
4,1.75,1520,7700,4,7,1520,0,499950
1,1,550,16345,3,4,550,0,188000
5,1.75,2060,10911,4,7,1360,700,417500
3,1.5,1630,9282,4,7,1630,0,224950
4,1.75,1590,10523,4,7,1590,0,372500
3,2.5,1930,5790,4,7,1930,0,435000
2,1,760,6035,3,6,760,0,447000
4,3.25,4020,11588,3,11,4020,0,1.05E+06
2,1,1190,11400,3,7,1190,0,238950
3,1.5,1440,8370,3,7,1440,0,224000
3,2.5,2070,9900,3,8,1420,650,272500
3,1,1640,26127,3,6,1640,0,250000
3,1,960,213008,2,6,960,0,200000
3,1.75,1490,3800,3,6,700,790,263000
6,1.75,2490,8732,4,8,2490,0,470000
4,2.75,2230,10160,3,7,1400,830,280000
3,2.5,1380,1021,3,8,1160,220,540000
3,1,920,5546,2,6,920,0,207000
3,1.5,1200,5000,3,6,1200,0,229000
4,1,1460,18599,3,5,1460,0,135000
2,1,1060,10600,3,6,1060,0,279475
3,1.75,2030,17100,4,7,2030,0,440000
2,2.25,1530,1324,3,8,1280,250,546000
4,2.75,2600,6050,5,8,1960,640,749950
4,3.5,3290,5559,3,8,2290,1000,965000
3,2.5,1670,4220,3,7,1670,0,310000
4,3,2800,7198,3,8,2800,0,444000
3,2.5,3220,54160,4,9,2690,530,768000
4,3.5,4440,8125,5,10,3140,1300,2.25E+06
4,1.75,1710,7200,5,7,910,800,271000
3,1.75,2290,44866,3,8,1390,900,450000
1,1,1100,4373,2,6,820,280,250000
4,1.75,1640,13566,4,7,1120,520,414250
4,2,1780,12161,5,7,1160,620,415000
3,2.5,2330,3141,3,8,2330,0,625000
3,2.5,2330,3995,3,9,2330,0,660000
3,1,2000,22500,3,7,1680,320,525000
4,2.5,1920,7345,3,8,1920,0,303500
3,1.75,1680,3420,3,7,960,720,475000
2,1,850,5250,4,7,850,0,294000
3,1.5,1830,8000,4,7,1830,0,562000
3,2,1520,11067,3,7,1140,380,434900
3,1,1480,15416,4,8,1480,0,243000
6,3,3870,43787,3,8,2700,1170,585000
3,1.75,1380,8400,3,7,1380,0,275900
3,2.25,1610,10454,3,7,1610,0,280000
5,2,1380,4300,3,7,1380,0,462000
5,1,1590,5000,3,7,1190,400,518000
5,3.5,4320,40816,4,11,4320,0,1.67E+06
6,2.5,2820,8600,5,8,1430,1390,893880
3,1.75,2190,17550,3,7,2190,0,375000
4,2.75,2250,7412,4,8,1480,770,345000
2,1,920,7716,3,6,920,0,229950
4,2.5,4090,215186,4,8,3670,420,640000
7,4.25,3670,4000,3,8,2800,870,824000
3,1.75,1440,7800,4,7,1440,0,491000
3,1,1210,7649,4,7,1210,0,310000
4,2.5,3020,17810,3,9,1600,1420,575000
3,1.75,1840,14005,3,8,1840,0,275000
4,2.5,2390,5021,3,7,2390,0,425000
3,1.5,1300,7370,4,7,900,400,226500
4,2.75,1590,6000,4,8,1590,0,1.06E+06
4,2.75,2210,3400,5,7,1470,740,719000
4,2.5,3550,10233,3,9,3550,0,920000
3,2,1710,134489,5,7,1710,0,397000
4,1,1340,2006,3,7,1340,0,615000
3,3.25,3960,6132,3,10,2600,1360,1.22E+06
2,2.25,1140,1332,3,8,1140,0,476000
4,2,2290,9200,3,7,2290,0,390000
3,2,1410,9600,4,7,1410,0,365500
4,2.5,2570,6466,3,9,2570,0,355000
3,1,970,9130,3,6,970,0,200450
2,2.5,1320,1157,3,8,990,330,499950
3,2,2350,5080,3,8,1780,570,568000
4,2.5,2040,109336,4,8,2040,0,375000
3,2,1620,8400,3,7,1180,440,498000
3,2.25,1550,6022,3,8,1550,0,266000
4,2.75,2280,5013,3,8,2280,0,395000
4,2.25,1760,9602,3,7,1760,0,353500
5,2.5,2900,9799,3,8,1450,1450,968000
2,1.75,1760,4400,4,7,880,880,640000
3,1,1410,8174,3,8,1410,0,261500
5,3,2670,11761,3,7,1370,1300,515000
6,3.5,3000,6320,3,8,2400,600,680000
4,3.5,3600,5697,3,9,2940,660,870515
4,3.5,3230,7200,3,10,1640,1590,1.39E+06
4,2.75,2310,10232,5,8,1310,1000,750000
2,2.5,2210,4440,4,8,1440,770,820000
4,3,3330,7650,3,9,1830,1500,1.21E+06
2,2,1090,1357,3,7,1090,0,249000
3,2.25,2120,54014,4,9,2120,0,835000
3,2.25,2030,7350,4,7,1190,840,588000
2,1.75,1710,8645,4,7,1510,200,475000
3,1,1540,3399,3,7,1200,340,530100
4,2.5,2040,7412,3,8,2040,0,545000
3,1,1170,4400,3,7,870,300,470000
4,2.25,2270,9464,4,7,1520,750,479000
4,4.5,3860,15246,3,11,2940,920,1.70E+06
2,1,870,7500,3,7,870,0,379950
2,1,1270,43560,4,5,1270,0,550000
2,1,1110,3500,3,6,970,140,600000
3,1.75,1990,13000,3,9,1990,0,700000
3,2.5,2380,6832,3,8,2380,0,574000
5,1.75,2250,8970,4,7,1500,750,390000
3,2.5,1470,1779,3,8,1160,310,379770
4,2.5,2560,5593,3,7,2560,0,600000
5,2.75,2920,6327,3,8,2920,0,562500
2,1.5,1560,10807,2,7,1560,0,181000
3,1,1510,6200,3,6,1010,500,299000
4,2.5,1930,6957,3,8,1930,0,364950
3,1.25,2350,6200,4,7,1320,1030,360000
2,1,1360,5000,3,7,1200,160,640000
4,2.5,1870,8449,3,8,1870,0,314000
3,2.25,3370,23065,3,10,1920,1450,1.60E+06
5,2.75,2670,4000,4,7,1800,870,665000
2,1,830,6017,4,6,830,0,282613
4,1.5,1500,2106,3,7,1500,0,182568
3,1,810,5240,3,6,810,0,215000
3,2.5,1680,10300,4,7,1680,0,262000
5,1,1500,9282,5,6,1500,0,235000
3,1,1010,7520,4,6,1010,0,183500
3,2,1680,11250,4,8,1680,0,450000
4,1.5,2890,9000,3,8,2090,800,910000
4,2.5,2160,8158,4,8,1660,500,585000
3,2.25,2860,8458,3,7,2860,0,365000
3,2.5,1930,4500,3,8,1930,0,425000
4,3,3040,36246,3,9,2680,360,870000
4,2.5,2620,7328,3,8,2620,0,852000
4,2.5,1880,3853,3,8,1880,0,530200
4,3.5,3370,435600,3,9,3370,0,480000
3,2.5,1920,9812,3,8,1920,0,432000
3,1.5,2290,9600,4,7,2290,0,209950
2,1.5,1670,9880,4,7,1670,0,240000
3,2.25,1830,7651,3,8,1830,0,273000
3,1.5,1730,6240,3,8,1000,730,510000
4,2.75,2300,3175,3,6,1340,960,350000
4,2.5,2440,5001,3,8,2440,0,455000
4,1,1470,6061,3,7,1470,0,150550
5,2.5,3240,9960,3,8,2020,1220,750000
3,1.5,2070,5386,4,7,1140,930,559000
3,2.5,1800,11034,4,8,1800,0,485000
2,1,1000,10200,3,6,1000,0,213000
2,2.5,1360,2693,3,6,1360,0,225000
3,2.5,2360,9005,5,7,1340,1020,480000
5,2.5,1710,9720,4,8,1710,0,549000
4,1,1280,4840,3,7,940,340,390000
5,2.25,2890,12478,3,9,2890,0,598000
4,3.5,4150,49503,3,11,4150,0,1.18E+06
4,1.75,1890,4800,3,7,1390,500,775000
4,2.25,1780,10748,4,8,1780,0,395000
2,1,1510,4032,3,8,1310,200,575000
4,2.5,2850,37522,3,9,2850,0,645000
3,2.5,2820,14250,3,11,2820,0,720000
2,1,1440,7808,4,7,860,580,395000
4,3.5,2850,2910,3,8,1970,880,710000
2,2,1470,3128,3,6,1470,0,241000
3,1.75,2650,5512,3,9,2250,400,1.05E+06
2,1,1090,4128,3,7,1090,0,440000
4,2.5,2630,48706,3,8,2630,0,625000
4,2.5,3550,8048,3,9,3550,0,625000
4,2.5,3010,9600,3,9,1510,1500,822600
4,2.5,2300,10880,4,7,1190,1110,440000
4,2.5,2460,10320,3,8,2460,0,313000
5,2,2020,4000,3,7,2020,0,385000
3,1.75,2090,12026,4,7,2090,0,248500
3,1,1230,9660,3,7,1230,0,322000
3,2.5,2090,6000,4,9,2090,0,1.37E+06
4,1.75,1570,9670,3,7,1170,400,356500
4,2.25,2500,8500,4,8,2500,0,760000
3,2,1810,2159,3,7,1010,800,550000
4,2.5,3640,6389,3,9,3640,0,932990
3,2,2320,7800,4,7,1160,1160,320000
4,2.5,1820,6916,3,7,1820,0,318400
3,2.25,1640,14374,4,7,1140,500,362000
4,2.25,1920,3225,5,7,1300,620,595000
3,1.75,1480,7225,4,7,1480,0,320000
3,1.5,1360,9760,5,7,1360,0,240000
3,2.5,2370,7875,3,9,2370,0,522500
4,2.5,2410,7950,3,8,2410,0,617950
2,1,880,6731,4,7,880,0,454000
2,1,740,6840,3,6,740,0,122000
4,3.25,2610,2552,3,10,2160,450,725000
4,2.75,2410,9549,4,7,1780,630,758000
4,1.75,2220,6731,4,7,1110,1110,711777
3,2,1340,4320,3,5,920,420,186000
5,2.5,4250,20441,4,11,2490,1760,1.81E+06
4,2.25,3160,34560,4,10,3160,0,965000
3,2.5,3030,9053,3,8,3030,0,509900
4,2.5,2170,10500,3,7,1570,600,420000
3,1.75,1550,9060,3,7,1550,0,225000
2,2.5,1260,1347,3,8,1260,0,350000
3,1.75,1900,8540,3,6,950,950,235000
4,2.5,2300,11165,4,8,2300,0,592000
3,1,960,5512,4,6,960,0,225000
2,1.5,1620,3760,5,7,1170,450,545000
2,1,900,3400,5,6,900,0,191000
4,2.25,4470,60373,3,11,4470,0,1.12E+06
3,1.5,1300,8280,5,7,1300,0,396000
3,2,1490,7770,4,7,1490,0,259900
5,2,1760,21562,3,8,1560,200,480000
3,1.75,1560,16194,3,8,1560,0,500000
4,3.75,3190,17186,3,10,3190,0,1.70E+06
4,2.5,1954,5075,3,8,1954,0,235245
3,2.5,2070,10908,3,8,2070,0,567000
3,2.5,2100,12338,3,9,2100,0,521900
4,2,1720,7560,3,7,1720,0,206000
3,1.75,2040,5775,3,7,1410,630,552500
3,3.25,2640,4080,3,9,1840,800,930000
3,2.5,3190,6899,3,9,3190,0,814842
3,2.5,2960,69351,4,9,2960,0,750000
2,1,800,4342,3,6,670,130,410000
4,2.25,2380,36446,4,8,2380,0,570000
4,2.5,2130,4000,3,8,2130,0,392000
3,1,1140,8144,3,7,1140,0,277000
3,1,1160,8813,3,7,1160,0,317000
5,2.5,3050,13212,4,8,1590,1460,707000
3,1.75,1740,46580,4,7,1740,0,340000
1,1,1940,6300,3,8,1940,0,611206
4,2.5,2060,7475,3,8,1440,620,575550
3,1,1450,3350,4,7,1450,0,450000
3,2.25,1560,12000,4,7,1110,450,491500
4,2.5,2570,9470,3,9,2570,0,1.10E+06
4,2.5,2630,6326,3,9,2630,0,589500
2,1.5,1680,17400,3,7,1680,0,453000
2,1.75,1150,698,3,7,1150,0,346100
4,4.5,2690,7350,5,7,2690,0,500000
4,2.5,2990,6145,3,8,2990,0,375000
4,3.5,3100,2261,3,9,2250,850,1.29E+06
3,1,1330,3740,3,6,1330,0,389000
3,2,1860,217800,3,8,1860,0,440000
2,1,790,7500,3,7,790,0,130000
5,1.75,1710,11900,3,7,1070,640,319950
2,1,1800,119790,4,7,1200,600,390000
4,2.5,2090,7241,4,7,1140,950,469500
3,2,1890,29185,3,7,1470,420,570000
3,1,1090,6710,5,5,1090,0,219500
4,1.75,2000,8700,5,7,1010,990,275000
3,2.5,2760,9471,3,8,1760,1000,800000
2,1,910,9000,3,5,910,0,301000
4,1.5,1220,4900,3,6,1220,0,250000
3,2.25,1540,17424,3,7,1540,0,315000
3,1.5,1870,3300,3,7,1870,0,933000
3,1.75,1480,3900,4,7,1480,0,245000
3,2.25,1350,980,3,8,1050,300,397500
6,4.5,5740,10312,3,11,3610,2130,1.38E+06
3,1.75,1120,9730,3,7,1120,0,362000
2,1.75,1090,3272,5,8,1090,0,265000
3,1.75,1290,6604,3,7,1290,0,232000
4,2.75,2390,6820,4,7,2140,250,799000
2,1,790,7128,3,6,790,0,189000
4,3.25,3840,6214,4,10,2590,1250,2.15E+06
4,2.5,2150,5100,3,7,1290,860,346500
4,2.25,2160,9593,3,8,2160,0,580000
5,2.25,2520,11700,3,9,2520,0,610000
4,1,1170,8147,3,6,1170,0,350000
4,2.5,2410,7517,3,8,2410,0,440000
2,2.5,3180,9400,5,10,2610,570,1.51E+06
3,2.5,1930,4505,4,7,1440,490,421000
3,1,1470,9750,3,7,1470,0,475000
3,2.5,2430,7613,4,8,2430,0,384200
4,2.25,2870,8393,4,8,1480,1390,890000
4,2.5,2240,5500,3,8,2240,0,389950
4,2.5,2030,11375,3,7,1330,700,385000
3,1.75,1240,4000,3,7,1240,0,259000
3,1.75,2190,6000,4,7,2190,0,255000
3,1,1300,8266,4,7,1300,0,650000
3,1,1640,6180,4,7,1640,0,525000
2,1,1120,5650,3,6,720,400,245000
3,2.5,1690,5025,3,8,1690,0,256883
2,1,1340,8100,4,7,1340,0,438400
3,1.5,1140,8500,4,7,1140,0,188000
5,2,3160,3990,3,7,1870,1290,695000
5,3.25,3070,5000,3,9,2050,1020,1.11E+06
3,2.5,2370,9000,4,8,1570,800,545000
4,2.5,2250,10160,5,8,2250,0,1.06E+06
3,1.75,1670,6900,3,7,1170,500,239950
3,2.5,1940,10350,3,7,1420,520,295000
3,1.75,1780,13095,4,9,1780,0,325000
3,1,1510,4350,5,6,1510,0,195000
3,2.5,2507,18400,3,8,2507,0,551870
4,2.5,2810,52062,4,9,2810,0,855000
3,2.5,1740,6992,3,7,1740,0,261500
3,1.5,2180,5000,4,8,1090,1090,720000
3,1,1680,8910,4,7,1680,0,489900
4,2.5,2030,3905,4,7,1630,400,831000
3,2.75,2130,1400,3,9,1080,1050,539000
2,1,970,5665,4,6,970,0,315000
4,2.25,2070,7350,4,8,2070,0,280927
4,2.5,2530,5048,3,8,2530,0,417838
2,2.25,1290,2436,3,7,1290,0,315000
2,1.5,1930,3521,3,8,1930,0,509000
3,1.75,1230,8917,4,7,1230,0,220000
3,2.5,2960,18600,3,8,2960,0,605000
2,1,820,6000,3,7,820,0,478000
4,2.75,3430,6500,3,9,3050,380,780000
3,1.75,2030,217800,4,8,2030,0,395000
3,1.75,1200,9266,4,7,1200,0,235000
3,2.5,2250,9235,3,8,2250,0,549000
2,1,750,8125,4,6,750,0,261000
2,1,930,6900,3,7,930,0,287000
2,1,1190,7408,3,6,830,360,229000
4,2.5,2496,8058,3,9,2496,0,661000
3,3,3570,6250,3,10,2710,860,840000
3,1.75,1370,5858,3,7,1370,0,257950
5,2,2270,8652,3,7,1150,1120,513000
3,2.5,2150,25705,3,6,2150,0,380000
4,2.5,2789,3960,3,7,2789,0,272000
4,2,2195,2681,3,7,1060,1135,392450
4,2,2000,6380,4,6,1860,140,520000
4,3.25,2110,3000,3,8,2110,0,796000
4,2.75,2850,7510,3,8,2850,0,637000
5,2.25,2510,9887,3,8,2510,0,955000
4,2,2100,4857,3,8,2100,0,424000
3,2,1550,8509,3,7,1150,400,369000
8,2.75,2530,4800,4,7,1390,1140,680000
4,1.75,2150,8555,4,7,1460,690,560000
2,2.5,2280,6230,3,8,2280,0,752500
3,1.5,1260,3135,4,7,780,480,499000
3,2,2740,23505,3,10,2740,0,535000
4,2.5,1800,8100,3,7,1800,0,250000
6,2,1870,6969,4,7,1870,0,380000
3,2,1430,6000,5,7,1430,0,352450
4,2.5,2320,5493,3,8,2320,0,530000
1,2,1150,9812,4,7,1150,0,115000
3,1,2010,6000,3,7,1210,800,350000
3,2.5,2540,51836,4,8,1820,720,485000
5,4,3760,28040,3,10,3760,0,1.03E+06
2,1,760,6407,3,6,760,0,261590
3,1.75,1790,7123,3,7,1790,0,390000
2,1.5,800,1196,3,8,800,0,280000
3,1,1070,7140,3,7,1070,0,327500
4,3.25,3330,9000,3,9,2870,460,1.21E+06
4,2,2090,6630,3,7,1070,1020,200000
2,1,670,2378,3,5,670,0,175000
3,1,1260,7920,3,7,1260,0,240000
2,1,790,11234,4,6,790,0,250275
4,2,2800,8540,4,8,1730,1070,740000
3,1,1890,3330,4,7,1390,500,570000
3,1.75,1440,11364,3,7,1440,0,337000
4,2.5,3040,6887,3,8,3040,0,647000
3,1.5,2500,6000,5,7,1730,770,417000
3,3.25,2610,4500,4,9,1660,950,925000
3,2.5,1500,10652,4,7,1500,0,240000
4,1.5,2650,34000,4,7,2650,0,615000
3,1,1400,7800,3,7,1400,0,217000
4,3,3720,57499,3,9,1880,1840,650000
3,1,1620,9450,3,7,1620,0,265000
5,2.25,2060,4800,3,8,2060,0,815241
3,2,1450,6081,4,7,1450,0,405000
3,4.25,2820,7200,4,10,2460,360,1.60E+06
3,2.5,2490,23891,3,9,2490,0,700000
3,2.5,1620,7410,5,7,1620,0,355300
3,2.25,1780,9315,3,7,1780,0,509000
3,1,1240,8840,3,6,1240,0,294950
2,1,880,3200,3,7,880,0,415000
3,1,980,9682,3,7,980,0,201000
5,3.25,3540,5971,3,10,2000,1540,1.35E+06
3,2.5,1150,887,3,7,1150,0,288000
3,1.75,1520,15344,3,8,1520,0,230000
5,2.25,3070,64033,3,9,2730,340,420000
2,1,880,1712,4,7,880,0,323000
3,2.25,1560,8280,4,7,1560,0,239950
4,2.25,2170,4080,3,7,1920,250,655000
2,1,790,8100,3,6,790,0,259950
6,2.5,1560,7144,3,6,1060,500,194990
4,2.5,3430,35120,3,10,3430,0,1.21E+06
4,2,2850,4497,3,7,1730,1120,650000
3,1,1140,3240,4,6,1140,0,160000
5,2.5,2450,20805,4,9,2450,0,1.55E+06
3,2.5,1260,11877,3,7,1260,0,312620
5,2.5,2820,67518,3,8,2820,0,675000
3,2.5,1470,1256,3,8,930,540,397500
3,1.5,1000,6914,3,7,1000,0,378000
5,1,1280,3876,3,7,1280,0,525000
2,1,870,8487,4,6,870,0,166000
3,2.5,3370,6550,4,8,2840,530,830000
4,2,2320,7400,5,7,1620,700,666570
5,1.75,2660,10637,5,7,1670,990,760000
6,1.5,1930,8400,3,7,1030,900,326000
3,2.25,1580,6561,3,8,1200,380,320000
3,2.5,1320,955,3,7,1320,0,285000
4,2,1720,2410,3,7,970,750,375000
2,1,1520,4700,4,7,1520,0,210000
6,2.25,3040,28535,3,8,1890,1150,330000
3,2.5,2670,10481,3,9,2670,0,810000
4,3,2590,7213,3,8,2590,0,355000
3,1,1180,3750,3,6,1030,150,425000
2,2.5,1230,987,3,7,1060,170,380000
4,1.75,2320,5490,3,8,1160,1160,416100
4,3.25,2740,7266,3,9,2060,680,689900
3,2,960,9380,3,6,960,0,210000
3,1.75,1530,9600,3,7,1200,330,284000
4,2.25,2870,5453,4,8,2220,650,665900
3,1.75,2160,8565,3,8,1730,430,433000
3,2.75,2690,8890,4,10,2690,0,1.65E+06
2,2,1210,740,3,8,780,430,610000
3,2.5,2200,5954,3,7,2200,0,315000
4,2.5,2502,8306,3,9,2502,0,453000
3,1.5,2150,4000,3,7,1470,680,500000
3,2.5,3030,4500,3,8,3030,0,525000
3,1,1000,9450,3,6,1000,0,212000
4,2.5,1820,11325,3,8,1390,430,359000
2,1.75,1670,4200,3,7,1670,0,490000
3,2.5,2330,1987,3,9,1410,920,732000
1,1,500,7440,1,5,500,0,125000
6,4.5,3500,8504,3,7,3500,0,682500
3,2.5,1600,9830,4,8,1600,0,299950
3,1,1200,10080,4,7,1200,0,186000
4,2.5,1594,7665,5,7,1088,506,269000
4,2,1390,745,3,7,1390,0,302059
2,1,1280,7861,4,6,1280,0,195000
3,3.5,2760,4500,3,9,2120,640,952000
5,4.75,5180,17811,3,11,4070,1110,1.08E+06
4,2.5,3690,11191,4,10,2190,1500,1.12E+06
4,2.25,2490,10720,4,7,1400,1090,454800
4,2.5,2390,5249,3,9,2390,0,675000
2,1,1560,4920,4,6,780,780,310000
3,1.75,1510,30185,3,7,1510,0,320000
4,3.25,4060,13000,3,11,4060,0,1.80E+06
3,1,1200,7727,4,7,1200,0,219950
4,1.5,2650,6900,4,9,2400,250,1.46E+06
3,2,1150,6000,5,7,1150,0,252500
4,3,2530,10000,3,7,2530,0,459000
4,2.5,2750,5767,3,9,2750,0,419900
3,1.75,1400,6750,3,7,1040,360,447000
4,2,1830,6000,5,7,1070,760,378500
3,2,1080,7236,5,7,1080,0,390000
3,2.5,1650,3436,3,7,1650,0,485000
3,1.75,1170,8148,3,7,1170,0,265000
4,2.25,2690,15000,3,9,1890,800,700000
4,2,2130,5500,5,7,2130,0,762000
4,2.5,2780,10480,3,7,1390,1390,990000
5,3.5,3100,10200,3,9,1660,1440,905000
2,1,740,6180,3,6,740,0,342000
3,1.5,1190,8726,3,7,1190,0,195000
2,1,1000,4956,4,7,1000,0,484950
3,1,1200,9087,5,7,1200,0,339900
3,3.5,3840,53696,3,9,3840,0,970000
4,2.25,2100,12738,4,8,2100,0,375000
4,2.25,1800,2752,3,8,1800,0,338800
2,1,910,3750,3,7,910,0,415000
4,2.5,1920,8497,3,8,1920,0,270000
3,1,1020,4980,4,7,850,170,350000
2,1,1100,3975,3,7,900,200,395000
4,2.75,2440,12051,5,8,1440,1000,518000
3,1,1500,6800,3,7,1500,0,525000
4,2,2240,7725,5,7,1120,1120,450000
2,1.75,1390,5025,4,8,1390,0,686500
3,3.5,1500,1249,3,8,1240,260,489000
3,2.5,2030,7549,3,8,2030,0,562500
2,1,1080,4080,3,8,1080,0,485000
3,2.5,2820,7200,3,9,1780,1040,705000
2,1,1840,4322,4,7,1160,680,513000
2,1.5,1840,9000,3,8,1340,500,720000
3,1,940,8400,5,7,940,0,253905
4,2.5,3180,13118,4,11,3180,0,1.20E+06
3,2.5,1540,1256,3,8,1540,0,543000
4,3,2740,2811,3,8,2240,500,495000
3,1.75,1400,7735,4,7,1400,0,269950
4,2.25,2540,228254,3,8,1450,1090,540000
3,1.75,1490,10844,3,7,1210,280,445000
2,2.5,2210,6327,3,8,2210,0,802000
4,2.75,2630,4501,3,8,2630,0,619990
3,1,1320,6534,3,7,1320,0,159000
4,3.5,3290,20107,3,10,2220,1070,799000
6,2.5,3300,13501,3,8,2060,1240,484000
5,2.5,2170,2752,3,8,2170,0,359800
3,2.5,1770,2875,3,8,1770,0,439950
3,2.25,2680,100188,4,8,1580,1100,575000
3,2.25,2780,31510,3,8,2780,0,666000
4,2.5,2140,7245,3,7,2140,0,495000
4,2.25,2010,7688,3,8,1170,840,229000
4,2.75,2640,5000,3,9,1840,800,1.08E+06
3,2.5,2070,12708,3,8,2070,0,560000
3,2.5,2350,715690,4,9,2350,0,750000
3,2.75,2990,207781,3,9,2990,0,785000
3,1,1380,5400,4,7,1380,0,380000
4,4,5545,871200,3,11,3605,1940,937500
3,3,1380,1081,3,8,1380,0,473000
3,1.5,1470,9570,3,7,1280,190,458000
4,2.5,2370,9679,3,8,2370,0,675000
4,2.5,2260,6300,3,7,2260,0,453250
4,2.5,2495,5751,3,7,2495,0,436000
2,2.5,2310,3313,3,9,2310,0,1.25E+06
2,1,1170,6000,3,6,1170,0,285950
3,2.5,1800,14036,3,8,1800,0,425000
3,1.75,1250,6041,5,7,1250,0,530000
3,2.5,1880,6047,3,8,1880,0,380000
3,2.25,2480,8755,3,8,2480,0,325000
3,1,1080,21043,3,6,1080,0,210000
3,1.75,2040,5000,3,7,1780,260,600000
3,1.75,2070,5500,4,7,1130,940,645000
4,3,2800,7845,3,8,2800,0,457000
4,1,1430,27153,4,5,1430,0,275000
2,1,1250,4960,3,7,940,310,370000
3,3.5,2540,10578,3,9,2010,530,719000
3,2.5,2050,4185,3,9,2050,0,700000
4,2.5,1830,6360,3,8,1830,0,284000
5,4.25,4420,13497,3,11,3510,910,1.21E+06
4,1,1710,7000,3,7,1710,0,433000
4,2.25,1720,9753,4,7,1120,600,264950
5,1.75,2100,7347,3,7,1070,1030,330000
6,3.5,6563,32670,3,10,5153,1410,1.30E+06
3,2.25,1715,6819,3,7,1715,0,257500
3,2.5,1578,7340,3,7,1578,0,259950
2,1,740,5100,4,7,740,0,450000
3,1,1010,9514,3,7,1010,0,270000
3,1.75,1560,14288,3,6,780,780,385000
2,1,920,5120,5,7,920,0,400000
4,2.75,2130,9339,3,7,1330,800,325250
3,2.5,1720,3676,3,7,1720,0,255950
4,1.75,1470,5350,3,7,980,490,465000
4,2.5,2830,6163,3,9,2830,0,527000
4,2.25,2030,8764,4,8,2030,0,579000
3,2.5,1780,6771,3,7,1230,550,310000
5,3.25,3850,16249,3,9,3030,820,507000
4,2,1800,4800,3,7,1800,0,632750
6,3.5,4430,11453,3,9,3000,1430,875000
4,2.5,2070,3808,3,8,2070,0,348000
3,1,1300,14138,4,7,1300,0,400000
5,2.5,2025,7760,3,7,2025,0,260000
3,2.5,2840,7500,3,11,2840,0,1.09E+06
3,1,1060,12000,3,7,1060,0,400000
2,1,870,4280,4,6,870,0,503000
4,2.5,3000,8584,3,7,3000,0,397000
3,1.5,1240,11200,4,7,1240,0,345000
3,1,1560,14333,4,7,1560,0,387500
3,2.5,4310,32093,5,10,2510,1800,1.74E+06
3,1.5,1850,10572,4,8,1850,0,1.38E+06
3,1.75,1300,8500,4,7,1300,0,249000
3,1,940,8571,3,6,940,0,239000
4,1,1360,8136,3,7,1360,0,328000
3,3,1850,12556,3,9,1850,0,565000
5,1.5,1750,9780,4,7,1750,0,385000
2,2.5,980,1013,3,8,980,0,334900
2,2.5,1550,2657,4,8,1550,0,426000
3,1,1220,6600,3,6,1220,0,286700
3,2.5,2040,7580,3,8,2040,0,319900
3,1.75,1380,14000,4,5,1380,0,249900
4,3.5,3390,3960,3,10,3390,0,775000
3,2,2150,5400,4,7,1380,770,597500
3,3,4120,60392,3,9,3180,940,560000
4,2.75,2550,7636,3,8,1440,1110,582800
5,2.25,1790,10300,3,7,1270,520,409950
3,1,1290,5500,3,7,980,310,372220
4,3.5,3480,7232,3,9,2580,900,1.51E+06
4,1,1630,8400,3,6,1630,0,209950
3,1.75,1900,8910,4,7,1900,0,229950
2,1,680,6400,3,6,680,0,179900
2,1,1210,6000,4,7,1000,210,710000
3,1.75,1680,7770,4,7,1680,0,530000
3,1.5,1190,8100,3,7,830,360,425000
3,1,1280,9630,3,7,1280,0,389000
3,1,1170,7350,4,7,1170,0,312500
4,1.75,1800,5210,5,7,1080,720,340000
4,2.5,3700,7051,3,11,3700,0,950000
4,2,2110,4140,3,9,1710,400,725000
4,2,1450,7560,3,7,1450,0,234950
3,1,1400,5100,3,7,1400,0,887200
3,1,1600,16868,3,7,990,610,670000
2,1,840,3840,4,7,840,0,445000
5,3,2600,13674,5,8,1300,1300,599950
3,2.25,1960,7708,4,7,1490,470,204250
3,3.25,1410,1246,3,8,1410,0,429000
2,1.5,1230,1561,3,7,1230,0,139500
3,1,1370,6780,3,6,1370,0,335500
4,2.5,2330,30122,3,8,1490,840,1.15E+06
4,2.5,3320,11901,5,9,2650,670,852600
3,1,1000,4959,3,8,1000,0,610000
3,1,1670,4080,3,7,1170,500,533000
3,1,1330,9540,4,7,1330,0,320000
3,1.5,1670,5000,4,7,1670,0,585000
2,1,1150,4400,4,7,1150,0,463000
4,2.5,2150,39449,3,7,1420,730,486000
3,2.5,1710,6773,3,8,1710,0,304000
3,2.25,1650,3788,3,7,1650,0,233703
1,2.25,1220,2100,4,8,1220,0,611900
2,2.5,1520,1588,3,8,1240,280,430000
3,1,940,7125,4,7,940,0,185000
2,1.5,1240,1892,3,7,1240,0,352900
3,2.5,2320,5663,3,8,2320,0,589000
4,2.5,2090,4200,3,7,2090,0,340000
4,1.75,1610,11305,3,7,1610,0,371000
3,1.5,2390,4600,3,8,1750,640,420000
4,2.5,2010,9075,4,8,1310,700,510000
4,2.75,1680,11180,4,7,1680,0,625000
3,2.5,1560,4100,3,7,1560,0,303000
2,1,950,3880,4,6,950,0,520000
2,1,1280,5500,3,7,1280,0,239950
4,2.5,3052,12145,3,8,3052,0,425000
4,3,3060,50002,4,8,2460,600,959750
4,1,1220,7980,3,6,1220,0,165000
3,1.75,1590,9620,3,7,1590,0,349000
2,1,810,4368,3,6,810,0,450000
3,2.25,1640,1023,3,8,1640,0,645000
3,3.5,3780,8295,3,9,2430,1350,1.81E+06
3,2.5,1910,3427,3,8,1910,0,615000
3,1.75,1760,4125,4,7,1760,0,688500
8,4,4020,7500,3,8,2010,2010,900000
4,2.5,2510,4543,3,8,2510,0,660000
3,2,1680,8487,3,7,1680,0,305000
2,1,860,6000,3,6,860,0,122000
2,1,860,8308,3,7,860,0,315000
3,2.25,1640,1873,3,8,1640,0,759000
2,2.5,1590,1679,3,8,1590,0,395825
4,2.5,2807,9430,3,8,2807,0,630000
3,2.5,1680,1683,3,9,1120,560,629950
3,3,3730,35900,3,9,2960,770,825000
3,1,1320,7200,4,7,1320,0,300000
4,2,2430,8960,3,7,1430,1000,255000
2,1,1150,9186,3,7,1150,0,324950
3,2.75,1850,9600,5,7,1850,0,489200
4,2,1390,745,3,7,1390,0,288790
4,2.5,3270,45537,3,9,3270,0,735000
4,2.5,2060,5742,3,7,2060,0,275000
3,1.75,1380,8362,3,7,1380,0,235000
3,1.5,1370,7439,4,6,1370,0,168000
4,2.25,2020,12500,2,8,2020,0,375000
4,2.25,2570,9600,4,9,2570,0,1.22E+06
4,3.5,4190,15724,3,11,4190,0,1.16E+06
2,2.5,1100,1760,3,7,1100,0,340000
4,2.5,2040,5523,3,7,2040,0,345000
4,2.5,1950,4553,3,7,1950,0,322000
3,1,1380,7334,3,7,980,400,165000
3,2.5,2100,4097,3,9,2100,0,990400
3,2.5,2380,2500,3,9,2380,0,549950
3,1.75,1300,5413,3,7,1300,0,536000
5,3.25,3960,6352,3,10,3960,0,919990
4,1.75,1400,11934,3,7,1050,350,295000
5,2.5,2803,8550,3,8,2803,0,379000
7,2.75,3410,4056,4,8,2130,1280,750000
3,1.75,2560,8400,3,7,1970,590,460000
3,2.5,1900,8744,3,8,1900,0,560000
4,2.25,3130,41382,3,9,3130,0,762500
3,2.5,2630,185130,3,9,2630,0,475000
2,1.5,1260,1575,3,7,1260,0,374000
3,3.5,2080,5100,3,8,2080,0,357500
3,2,2420,208652,3,8,2420,0,590000
4,2.5,2610,7333,3,8,2610,0,360000
5,3.25,3080,13394,4,9,2230,850,1.13E+06
3,2.5,1860,3730,3,8,1860,0,309620
4,1.75,2140,159865,4,7,1140,1000,362950
5,3,2460,7240,3,9,1840,620,637000
3,1.75,1810,21138,4,7,1240,570,300000
5,2,1880,4179,3,7,940,940,349950
3,1,1240,3500,4,7,1240,0,660000
3,2.5,2160,6288,3,8,2160,0,549950
2,1,960,6263,4,6,960,0,660000
3,2,1620,7800,3,7,1200,420,525000
4,2.5,2390,6426,3,9,2390,0,359800
5,2.5,2900,5901,3,9,2900,0,808900
1,1,810,2451,5,7,810,0,235000
5,2.5,2080,8347,4,7,1460,620,474950
3,2.25,1970,7210,4,8,1380,590,339000
4,1.75,2500,7690,3,7,1250,1250,387000
2,1.5,1140,2500,3,7,630,510,355000
3,1.75,1780,37801,3,7,1300,480,526000
4,1.5,1130,5200,3,6,1130,0,179950
3,1.75,1950,52256,4,8,1950,0,412000
3,2.5,1150,1193,3,8,1020,130,436000
5,3.75,3760,4702,3,9,2780,980,799950
3,2.25,1670,6240,4,8,1240,430,545000
3,1.5,1330,6768,4,7,1330,0,348000
2,1,1140,5650,3,6,980,160,374000
3,1,1500,12616,3,7,1500,0,396000
2,1.75,2140,5000,3,7,1000,1140,675000
5,2.75,3030,7679,3,9,3030,0,837219
3,2.25,1590,7267,4,7,1100,490,405000
3,2.25,1630,6449,3,7,1310,320,445000
3,2,1490,3880,3,7,1490,0,550000
5,3.5,3990,42436,3,9,2710,1280,668000
3,1,1470,7680,3,7,1220,250,546940
4,1.75,1400,7920,3,7,1400,0,259950
3,2.5,1870,9825,4,7,1250,620,325000
4,1.5,1800,3245,4,8,1800,0,875000
3,2.25,1936,9495,3,8,1936,0,338900
2,2.5,2220,4000,3,9,2220,0,1.43E+06
5,2.5,2510,7525,4,7,1710,800,400000
5,2.5,2310,8303,3,7,1300,1010,469950
3,1.5,2790,6900,3,8,1700,1090,560000
5,1.75,2030,10200,4,7,2030,0,246000
3,1,1122,6554,3,5,1122,0,265000
4,2.5,2708,4772,3,9,2708,0,436952
5,1.75,1770,15525,4,7,1770,0,200000
3,2,2080,11375,3,8,2080,0,342500
3,1.75,2200,12231,4,7,1250,950,322000
4,4,5635,9695,3,10,4360,1275,950000
3,1,1700,11390,4,7,1700,0,210000
2,1,890,3271,4,6,890,0,409000
3,1.75,2080,87991,3,6,1040,1040,280000
3,1.75,1810,7300,4,7,1240,570,430000
4,2.75,2490,9714,4,8,1400,1090,608000
3,2.5,2120,4512,3,8,2120,0,475226
2,1,1670,8195,3,7,1670,0,660000
3,1.75,1910,17003,4,8,1910,0,299000
5,3,2100,7715,3,7,1250,850,330000
3,2.25,1290,1182,3,8,1000,290,525000
4,2.75,2060,6659,3,7,1280,780,322500
3,2.5,3090,67082,3,9,3090,0,567500
5,3.5,3740,24684,3,9,2760,980,448000
4,2,3140,10437,4,8,2040,1100,925000
3,2.5,1880,5500,4,7,1880,0,617000
3,1,1010,10125,4,7,1010,0,215000
3,2.5,3530,9753,3,10,3530,0,898000
3,1,1060,8000,4,6,1060,0,160000
4,2.75,2610,4160,5,8,1910,700,650000
4,2.5,2900,4950,3,8,2900,0,520000
3,1,920,8400,3,7,920,0,206000
4,1.75,2220,6500,4,8,2220,0,480000
3,1.75,1010,7171,4,7,1010,0,325000
5,1.75,2190,27260,4,7,2190,0,310000
3,1.75,1420,1361,3,7,960,460,294000
3,1.75,2590,32380,3,8,2590,0,808000
2,1.75,1020,10346,4,6,1020,0,187000
4,2.5,2400,6053,3,8,2400,0,425000
2,1,1570,8210,4,8,1150,420,506000
3,1,1060,9954,4,7,1060,0,215000
5,2.75,2670,4780,3,8,2670,0,480000
4,2.25,2700,8580,3,8,2700,0,338150
4,2.5,2340,9748,3,8,1610,730,339900
3,2.5,2680,327135,3,8,2680,0,630000
3,1.5,1480,13457,3,7,1480,0,475000
5,4.5,5220,67319,3,11,5220,0,1.57E+06
3,1.5,1390,1882,3,7,1390,0,175003
5,3.5,4330,11979,3,12,2090,2240,3.17E+06
4,2.5,3220,22588,3,10,3220,0,875000
4,2.25,2530,9200,5,9,1570,960,902000
4,2.5,1770,5855,3,7,1770,0,248000
2,1.5,790,1123,3,8,700,90,365000
3,1.75,1910,8329,3,8,1910,0,323000
2,1,870,4600,4,7,870,0,357000
3,2.5,2620,108464,4,8,2620,0,427000
3,2.25,1920,9600,4,8,1560,360,652000
2,1.5,1620,1444,3,9,1080,540,525000
3,2.5,1600,6848,3,7,1600,0,290000
3,2,1540,67953,3,7,1540,0,445000
3,1.75,1660,6250,3,7,830,830,410000
2,1,780,7200,2,6,780,0,315000
3,1.5,1200,15606,3,7,1200,0,309950
3,1,680,2400,4,6,680,0,230000
3,1.75,1300,7958,3,7,1300,0,245100
4,2.5,1980,7264,3,7,1980,0,240000
2,1,2240,7200,4,7,1120,1120,435000
3,2,2260,7200,3,7,1130,1130,759000
3,1,2130,3825,3,7,2130,0,335000
2,1,1410,5000,4,7,940,470,442000
3,1,920,7314,3,6,920,0,208000
4,1.75,1680,19405,4,7,1560,120,275000
4,1,1660,10656,4,7,1180,480,535000
4,2.5,1960,11600,5,6,980,980,215000
5,3.75,3990,18897,3,8,3090,900,740000
3,1.5,1690,9600,3,7,1210,480,212000
2,1,1190,4440,3,6,1190,0,382500
3,2.25,1680,7262,5,7,1180,500,530000
4,3,2420,4800,3,7,1520,900,950000
2,1,1160,6000,4,7,860,300,468000
3,1.75,2650,7378,3,7,1460,1190,340000
4,2.5,2040,5472,3,8,2040,0,325000
2,1,780,6685,4,5,780,0,135000
4,1.5,2120,5000,4,8,2120,0,625000
2,1,990,8760,3,7,990,0,179000
3,1,1480,5100,3,7,1480,0,397500
3,2,1450,9132,3,7,1450,0,391500
4,0.5,2300,5570,3,8,2300,0,312500
2,1,1470,81021,4,6,1470,0,380000
4,3,3140,9058,3,9,2140,1000,946000
4,3,2910,8027,5,8,1800,1110,825000
3,1.75,1580,3764,3,7,1280,300,536000
3,2,1510,7884,3,6,1510,0,332000
5,1.75,1950,8720,3,7,1050,900,274000
3,1,1920,6710,3,7,1320,600,350000
3,1,1210,5200,3,6,1210,0,430000
3,2.5,1970,2752,3,8,1970,0,425500
4,2.5,3780,10962,3,10,3780,0,980000
3,3.75,3250,5797,4,8,2370,880,967500
4,2.75,3270,50994,4,8,2720,550,435000
3,2,1500,8775,3,6,1390,110,255000
3,1.75,1780,10409,3,7,1280,500,342000
3,2,2000,7000,3,7,2000,0,561000
3,2.25,1760,1800,3,7,1330,430,440000
4,2.5,2950,4502,3,7,2950,0,455000
4,3,2320,13068,3,8,2320,0,400000
3,2,1560,3200,3,7,1560,0,539950
4,1.5,1680,10500,3,7,1680,0,525000
3,2.5,2230,5800,3,7,2230,0,440000
3,2,1780,8621,3,8,1780,0,406500
5,2,3020,6000,5,7,1860,1160,530000
6,3,2400,9373,3,7,2400,0,280000
5,1.5,2940,13425,3,8,1470,1470,464500
2,1.5,1010,6000,4,7,1010,0,269000
4,1.75,2280,5959,3,7,1250,1030,525000
4,3.5,3180,4869,3,8,2390,790,440000
3,1.5,1940,3570,4,8,1740,200,815000
4,2.5,2450,27081,3,8,2450,0,729000
2,2,1500,761,3,8,1500,0,670000
3,1.75,1350,10125,3,8,1350,0,251000
4,2.25,3470,8000,3,9,2360,1110,1.73E+06
3,1.75,1330,7848,3,8,1330,0,347000
4,2.5,1720,9600,3,7,1120,600,200000
3,2,1340,2550,3,7,1340,0,495000
4,3,3590,89640,3,10,3590,0,879000
3,2,1760,6428,4,7,980,780,690000
4,2.25,2090,8579,3,8,2090,0,546200
4,3.25,5640,35006,3,11,4900,740,2.00E+06
2,1.5,1110,1189,3,8,1110,0,371000
3,1.75,1470,4950,3,7,1030,440,459500
2,1.75,1390,6670,3,6,720,670,445500
4,1.5,1690,3245,3,8,1690,0,440000
3,2.5,1630,15200,3,7,1120,510,395000
4,3.5,3840,4000,3,8,2640,1200,829900
4,2.5,2350,5100,3,8,2350,0,399950
3,2.75,2290,34548,4,7,2290,0,536000
5,2.5,2520,7863,3,7,1500,1020,545000
3,2.5,2577,156816,3,8,2577,0,495000
3,1.75,2150,2527,4,8,1400,750,762000
4,1,1420,6458,4,7,1420,0,398000
3,2,1800,5000,4,7,1080,720,618500
5,2.75,4400,18500,5,9,2250,2150,1.12E+06
3,2,1470,6000,3,8,1090,380,630000
3,1.5,1480,7749,5,7,1480,0,446450
3,2.75,4120,16365,3,12,4120,0,1.30E+06
4,2.5,2320,12042,4,7,1320,1000,470000
3,3.5,1700,2197,3,8,1260,440,585000
3,2,1410,10015,3,6,1410,0,340000
3,2.5,1990,12866,4,7,1990,0,450000
4,2.5,2210,49375,3,8,2210,0,455000
2,1,1020,4200,5,6,1020,0,393000
4,2.5,2790,43091,4,9,2790,0,665000
4,2.5,2300,4482,3,7,2300,0,332000
3,1.75,710,5050,4,6,710,0,345000
3,1.75,1650,8850,3,7,1650,0,220000
4,2.25,1970,7125,3,7,1500,470,600000
3,2.5,1990,7577,3,7,1990,0,293000
4,2,1700,2350,3,6,850,850,545000
4,2,2680,13680,4,7,2350,330,400000
4,3.25,4040,18916,4,9,4040,0,2.27E+06
4,2.5,1940,3200,3,8,1940,0,380000
3,1,1440,11925,3,7,1440,0,229900
4,2.5,2400,6137,3,8,2400,0,575000
2,1.5,940,1222,3,7,860,80,325000
3,2.25,1740,7345,3,7,1380,360,270000
4,2.5,2680,10590,3,8,2680,0,499000
4,2.75,2240,8162,5,7,1380,860,290000
2,1,1490,3825,3,7,860,630,475000
3,2.5,2060,4742,3,8,2060,0,324747
2,0.75,750,16321,3,4,750,0,435000
3,2.25,1430,2343,3,8,1430,0,439000
4,1.75,1720,10018,5,7,1720,0,248500
3,1,1610,7140,3,7,1080,530,215000
4,2.5,2560,5800,3,9,2560,0,388000
4,2.5,1961,3207,3,7,1961,0,289000
3,2.5,2620,4800,3,7,2620,0,597500
4,2.5,2080,2999,3,8,2080,0,300000
3,2.25,1870,7403,3,7,1870,0,455000
4,2.25,2640,31941,4,9,2640,0,489950
4,2.5,3230,21781,3,9,3230,0,785000
2,2.5,1420,2229,3,7,1420,0,278000
2,1,1460,9207,3,7,1210,250,430000
2,1,1250,4558,3,7,1250,0,355000
4,1,1330,8184,3,7,1330,0,290000
4,2.25,2040,14383,4,8,1270,770,366400
5,3,2830,7500,3,9,2460,370,1.24E+06
2,1,1800,5182,3,6,900,900,334998
3,2.5,2490,4540,3,8,2490,0,414000
4,2,2470,5080,3,6,1970,500,339000
4,2,1750,7800,4,6,1750,0,240000
3,1.75,1300,8480,3,7,1300,0,397500
2,1,890,5200,4,6,890,0,299950
3,1.5,1360,6000,3,6,860,500,360000
3,2.5,2200,3000,3,9,1530,670,740000
2,1,860,5160,4,7,860,0,390000
5,1.75,1730,5200,4,7,1050,680,205000
2,1,1380,5820,3,7,1380,0,320000
3,2.5,2370,9102,3,9,2370,0,330000
4,2.5,2900,10500,5,8,1450,1450,1.58E+06
4,5.25,4140,14757,3,11,4140,0,1.06E+06
3,2.5,3680,13384,3,10,3680,0,1.03E+06
5,2.5,3001,5710,3,8,3001,0,373000
4,2.5,2906,5893,3,9,2906,0,418395
4,2.25,3290,12329,4,10,3290,0,947500
5,1.5,1840,8050,4,7,1840,0,285000
3,2.5,3110,9015,3,9,3110,0,485000
3,1.75,1700,8360,4,7,850,850,455000
4,1,1400,7242,3,7,1400,0,238000
4,2,1890,4500,3,7,1490,400,805000
3,1,1180,8240,4,7,1180,0,205000
3,2.25,1358,1141,3,7,1358,0,280000
3,1.75,1340,13115,3,7,1340,0,332000
3,2.25,2610,9002,3,9,2610,0,675000
2,1,950,3960,3,7,950,0,482000
4,3.25,3450,6500,3,8,2450,1000,850000
4,2.75,2170,9658,3,7,2170,0,275436
5,1.75,1250,10530,4,7,1250,0,462000
4,2.5,2790,6540,3,9,2790,0,695000
4,2.5,2300,7707,3,8,2300,0,380000
4,2.5,2050,10271,3,7,2050,0,331500
3,2.25,2160,6527,4,7,1580,580,430000
4,1.75,1840,5100,4,5,1840,0,327000
6,4.5,3810,28176,5,10,3810,0,2.01E+06
3,1.5,1360,11250,4,7,1360,0,499950
4,3.5,4070,10976,3,10,4070,0,889000
5,3,3070,5252,3,8,3070,0,341950
5,3.25,4115,7910,3,9,4115,0,988830
3,1.75,1580,9049,3,8,1580,0,389950
3,2.25,3800,33825,4,10,3330,470,575000
3,1,1010,25277,5,5,1010,0,201000
4,2.5,2156,3562,3,9,2156,0,347500
3,0.75,1330,7020,5,7,1330,0,385000
3,2.25,3400,10000,3,10,3400,0,970000
3,3.5,3650,103672,3,10,2050,1600,680000
3,2.25,1870,4894,4,8,1750,120,615000
3,1.75,1600,9135,5,7,1600,0,625000
2,2,1651,18200,3,6,1651,0,285000
3,1.75,1220,216332,3,7,1220,0,390000
3,2.5,1680,8284,3,7,1680,0,252000
2,1,1700,3040,3,8,1460,240,710000
4,3,1730,7264,3,6,1730,0,265000
3,2.25,1790,7500,3,7,1390,400,455000
2,1,1420,21158,3,7,1420,0,250000
3,1,1160,7875,3,7,1160,0,285000
3,1,1050,6000,3,7,1050,0,400000
3,2.5,2620,21587,3,7,2620,0,672000
3,2.5,2120,3742,3,7,2120,0,400000
3,2.5,2370,4375,3,8,2370,0,366000
3,1,1160,36831,3,7,1160,0,450000
4,1.75,2430,13211,4,7,2430,0,445000
4,2,2230,5000,4,7,1510,720,690000
3,2,1410,7466,3,7,1410,0,229950
4,3.25,3890,25470,5,10,3030,860,2.95E+06
3,2.5,2610,8481,3,10,2610,0,810000
3,1.75,1440,8775,3,7,1440,0,375000
5,1.5,2180,4268,4,7,1340,840,470000
1,0.75,780,77603,1,5,780,0,190000
3,2,1820,4418,4,8,1820,0,661000
4,2,1570,7320,4,7,1570,0,450000
5,2,2800,17788,4,8,1400,1400,665000
6,2.25,2930,4320,3,9,2130,800,1.23E+06
3,1.5,1730,5750,3,7,1250,480,550000
4,3.25,3850,19842,3,11,3180,670,1.20E+06
3,1.75,1590,11914,3,7,1090,500,267500
3,3.25,2230,5460,4,8,1430,800,699950
4,4,5040,17208,5,10,2870,2170,2.85E+06
4,2.5,1910,9244,4,6,1910,0,333000
4,2.25,1770,33132,4,8,1190,580,390000
5,2,1910,4667,3,7,1010,900,650000
4,3,1980,7931,4,7,1160,820,395000
3,2.75,2100,20150,4,7,2100,0,530000
4,1.75,2960,11347,4,8,1570,1390,469000
3,1.75,1860,5584,3,8,1310,550,860000
3,2.5,1910,11550,3,8,1910,0,580000
3,1.75,1910,5753,3,8,1110,800,595000
3,2.5,2340,5957,3,8,2340,0,505000
3,2.5,1660,6263,3,8,1660,0,285000
4,2.5,2020,7289,3,7,2020,0,360000
3,2.5,2280,6134,3,8,2280,0,470000
2,1,1130,15190,4,7,1130,0,239000
2,2.25,1230,929,3,8,1020,210,460000
4,2.5,3030,16000,3,11,3030,0,875000
4,1,1410,7000,3,7,1410,0,225000
4,1.75,1830,12540,4,8,1130,700,283200
4,2.75,2810,5046,3,9,2810,0,531155
3,1.75,1630,4000,3,7,1100,530,285000
4,2.25,2190,4080,3,8,1800,390,855000
3,2.5,1572,4000,3,8,1572,0,299000
4,2.5,4250,19387,4,9,3260,990,1.34E+06
2,1.5,800,5192,5,7,800,0,335950
2,2,1240,2500,3,7,1240,0,445000
4,2.5,2980,5000,3,10,2980,0,765000
3,1,1240,5758,4,6,960,280,476900
5,2.5,2910,9636,4,7,1690,1220,530000
3,2.5,2460,5027,3,8,2460,0,305000
3,2.25,1890,7200,4,7,1230,660,435000
4,2,2120,3360,3,9,2120,0,1.20E+06
2,1,828,4524,3,6,828,0,110000
3,1,1000,18513,3,6,1000,0,180000
3,2.25,1352,1694,3,8,1352,0,325000
3,2,1340,2720,3,7,1340,0,650000
5,1.5,1690,7725,4,7,1690,0,285900
4,3,2290,2350,3,9,1610,680,991700
3,2.5,1530,3984,3,8,1530,0,467000
3,1,1020,12289,4,7,1020,0,230000
3,1.75,1330,9143,3,7,1330,0,400000
3,2.5,1780,6527,3,8,1780,0,265000
5,3,2530,5105,3,8,1520,1010,515000
3,1.5,1450,6875,4,7,1450,0,249950
4,2.5,2200,6018,3,8,2200,0,396800
4,2.5,1580,7800,4,7,1580,0,255000
4,2.5,2510,47044,3,9,2510,0,575000
3,1.75,1930,14389,3,7,1130,800,385000
5,2.75,3000,9473,3,8,1500,1500,550000
4,2.5,2980,8786,3,8,2980,0,382500
4,2.5,2040,5508,4,8,2040,0,575000
3,1,1120,8407,5,6,1120,0,225000
3,2.25,2180,4200,5,8,1520,660,727000
5,3.25,2500,7620,3,7,1250,1250,495000
3,1,1150,12402,4,6,1150,0,344000
0,0,844,4269,4,7,844,0,139950
3,1.5,1720,6570,4,8,1720,0,498000
4,1.75,1800,10890,4,6,1800,0,385000
4,2.75,2900,17400,4,8,2410,490,785000
4,2.25,2470,7447,3,8,2470,0,565000
4,2,1460,7254,3,6,1460,0,150000
3,1.5,1630,22764,3,7,1630,0,165000
4,1.75,1850,7730,5,7,1100,750,270000
3,2,2580,15653,3,9,2580,0,481000
3,1,1140,4560,4,6,770,370,474000
4,1,2290,6300,4,7,2150,140,825000
3,1.75,1640,53400,4,7,1640,0,319000
3,2,1810,17006,3,8,1810,0,649000
3,1.75,2370,6360,3,7,1280,1090,385000
4,3.5,3500,4000,3,10,2560,940,1.05E+06
4,2.5,2720,13500,3,8,1510,1210,549950
3,2.25,1590,7748,4,7,1590,0,263000
3,2,1660,3729,5,7,970,690,638000
3,2,1220,7620,3,6,720,500,320600
1,1.5,1030,5923,3,8,1030,0,525000
4,2.5,1996,4547,3,7,1996,0,285000
1,1,1080,5000,3,7,1080,0,411000
3,2.25,1520,5750,3,8,1400,120,672600
4,2.5,2720,4738,3,8,2720,0,545000
2,2,1250,7543,3,7,1250,0,163000
3,1.5,1330,6540,3,7,900,430,239000
3,2.5,1950,18533,3,8,1950,0,400000
5,3.5,3672,9742,3,9,3006,666,405000
6,2.5,1880,14350,5,7,1640,240,520500
3,2.5,2620,9112,3,9,2620,0,738000
4,3.5,4083,68377,3,10,4083,0,637000
3,1.75,1600,4400,3,7,1030,570,690000
4,2.5,2490,5170,4,9,2490,0,725000
2,1,1200,8750,3,6,1200,0,290000
3,1,1200,5404,3,6,1200,0,375000
3,1,1130,5758,3,7,960,170,485000
3,2.5,2120,10021,4,8,1230,890,625000
2,1,820,4234,3,6,820,0,389950
2,1,1120,5250,3,7,950,170,708000
3,1.75,1530,7650,4,8,1530,0,317000
4,2.5,3160,35225,3,9,2250,910,805000
3,1,1050,6874,3,6,1050,0,250000
4,2.5,2260,7500,3,8,1460,800,350000
4,1.75,1910,8250,4,7,1910,0,250000
4,1.75,1920,9500,4,7,1470,450,719521
3,1.75,1790,27427,3,7,1130,660,325000
3,1.75,2460,4240,4,7,1230,1230,930000
4,2.75,2600,36583,5,8,1580,1020,610000
3,1.75,1850,7684,3,8,1320,530,218000
3,2.75,2840,39324,3,9,2200,640,450000
4,2,1730,9139,3,8,1730,0,466750
3,2.5,2550,7200,3,10,2550,0,1.40E+06
4,2,1450,5456,5,7,1450,0,393000
3,2.5,2150,7484,3,8,2150,0,580000
4,2.5,2040,16200,3,8,2040,0,475000
3,1.75,1330,16000,3,7,1330,0,180000
3,1.75,1690,5080,3,7,1190,500,349000
3,1.75,1780,5000,3,6,1080,700,240000
3,2.5,2390,6441,3,7,2390,0,349950
4,1.75,1930,9310,4,9,1930,0,670000
3,2,1510,3750,4,7,1510,0,479200
3,1.75,1770,8240,4,7,1240,530,280000
3,1.75,1080,7942,3,7,1080,0,115000
3,2.5,1580,3075,3,8,1580,0,379000
4,3.5,4060,9486,3,10,4060,0,1.60E+06
4,2.25,2240,9990,4,10,2240,0,975000
4,1.75,4060,4000,3,10,2890,1170,970000
2,1,1150,5000,4,7,1050,100,552000
2,1,1280,5728,5,6,1280,0,272925
4,2.5,2940,14071,3,9,2940,0,675000
4,2.5,3160,8530,3,9,3160,0,650000
3,1.75,1280,10016,4,7,1280,0,215000
3,2,1660,8641,4,8,1660,0,269950
4,2.5,1960,7230,3,8,1960,0,269950
4,2.5,2940,29013,3,10,2940,0,590000
3,3,4910,43560,4,10,4000,910,1.08E+06
3,2.75,2460,3600,3,9,2460,0,790000
4,2.5,3030,10189,3,9,2380,650,1.47E+06
4,3.5,3695,6556,3,9,3695,0,994900
4,3.5,4150,16197,3,10,4150,0,550000
2,1,1860,3400,3,7,1010,850,730000
5,2.75,4450,9600,3,9,3650,800,845950
3,2.5,2979,17313,3,11,2979,0,912000
2,1,1100,7200,4,6,1100,0,150000
3,2.5,1610,1778,3,7,1610,0,380000
5,1.5,2550,6300,4,7,1560,990,369000
2,3.25,3000,24004,3,10,2410,590,780000
4,2.25,1930,3500,5,8,1540,390,689888
3,1,1340,15600,4,6,1340,0,124740
4,2,1400,7140,3,7,1400,0,220000
3,2.5,2130,8404,3,8,2130,0,378000
4,2.5,2270,5000,3,9,2270,0,812000
3,2.5,2040,9765,3,8,2040,0,325900
3,2.5,1741,5701,3,8,1741,0,300000
3,1,1040,9800,4,7,1040,0,375000
2,1.5,1160,1103,3,7,890,270,275000
2,1,1310,5200,3,7,910,400,663500
3,2,1950,8698,3,8,1950,0,361000
4,2.5,2900,4762,3,8,2900,0,354000
2,1.75,1180,5000,2,7,880,300,600000
3,3.25,1720,1977,3,8,1360,360,547500
4,1.75,1690,11739,4,8,1690,0,705000
4,2,2120,9442,5,7,1060,1060,455000
3,1,1200,10500,3,7,1200,0,153000
3,2,1660,11135,3,8,1660,0,315000
3,1.5,1460,8710,3,7,1460,0,324950
3,1,1050,5664,4,7,910,140,445000
3,2,1910,9001,4,7,1910,0,554000
3,1.5,1540,7200,3,7,1540,0,441000
3,3,4610,8400,3,8,2790,1820,1.25E+06
4,2.5,2650,10459,4,8,2650,0,350000
3,2.5,1782,1577,3,7,1782,0,326000
3,2.5,2320,4721,3,8,2320,0,655000
3,2.5,4110,35741,3,7,4110,0,1.03E+06
4,2,1650,6480,5,7,1650,0,490000
3,2,1239,6036,3,7,1239,0,253101
3,2,1840,6755,3,8,1840,0,329000
3,2.5,2030,1160,3,9,1970,60,910000
5,2,1730,10532,4,5,1730,0,325000
5,3.5,3370,16846,3,9,2650,720,600000
3,2.5,1880,4499,3,8,1880,0,529000
3,2.25,1780,7280,3,7,1340,440,449500
4,1.75,2120,4650,3,7,1190,930,582000
4,2.5,2160,9528,3,9,2160,0,360000
3,2.5,1190,1290,3,8,1190,0,469000
3,1,1160,6132,4,7,1160,0,237000
2,1,720,8040,3,6,720,0,210000
4,3,3080,9601,3,10,3080,0,560000
4,3.5,2710,5722,4,8,2040,670,539500
2,1,920,5000,4,6,490,430,280300
3,1.75,1670,39639,4,8,1670,0,600000
4,2.75,2230,9460,5,7,1480,750,550000
4,1,1330,2400,4,6,1330,0,615000
2,1,1100,8281,4,7,1100,0,320000
3,2.75,2640,11957,3,9,2260,380,698000
3,2.25,2600,220300,5,8,2120,480,695000
3,2.5,1690,4000,3,7,1690,0,452000
5,2.75,3170,8093,3,9,3170,0,890776
4,3.25,2850,4100,3,10,1820,1030,1.54E+06
3,2.5,1980,9907,3,8,1980,0,319950
2,1,710,1173,4,7,710,0,402000
3,2.5,1690,1609,3,8,1150,540,404763
4,2.5,2220,7064,3,8,2220,0,580000
3,1,1220,6719,3,6,1220,0,196000
2,2.5,2000,5150,3,9,2000,0,910000
3,2,1270,1348,3,8,1270,0,380500
4,1.75,2410,6000,3,8,2410,0,1.44E+06
3,2.5,1490,1709,3,8,1490,0,354901
3,2,2320,65340,3,9,2320,0,870000
3,2.25,2350,10450,3,8,1390,960,460000
3,2.5,2670,4534,3,9,2670,0,465750
5,2,1510,3000,3,6,1510,0,455000
4,2.5,2430,5203,3,8,2430,0,510000
3,2.25,2210,7916,3,8,2210,0,500000
3,1,980,7606,3,7,980,0,221000
3,2.25,1490,974,3,7,1220,270,312000
3,1.75,1140,9628,4,7,1140,0,120750
3,1.75,890,3800,3,7,750,140,455000
4,2.25,2460,14600,4,8,1720,740,439950
3,2.5,2070,4689,3,8,2070,0,359500
3,2.5,1210,1200,3,8,1210,0,500000
3,1.5,1040,1824,3,6,1040,0,348000
2,1,700,5000,5,6,700,0,191000
4,2.5,2300,41167,3,7,2300,0,392000
4,2.5,2780,13521,3,10,2780,0,715000
3,2,1560,1020,3,8,1560,0,515000
5,2.5,2250,7945,4,7,1360,890,446950
3,1.75,1630,4275,3,7,1630,0,567000
3,3.75,5400,24740,3,11,5400,0,1.21E+06
3,2.5,1890,3629,3,7,1890,0,285000
3,1.75,2340,10495,4,8,2340,0,780000
4,1.75,2350,54450,4,7,1250,1100,449000
3,1.75,2500,8289,4,7,1250,1250,315000
4,2.5,2060,9719,4,8,1320,740,550000
3,2,2070,9195,3,8,1220,850,539000
3,2.5,3760,5260,3,9,3230,530,825000
3,2.5,2460,5400,4,8,1520,940,464000
4,2.75,3370,7634,5,8,2110,1260,720000
4,2.5,2570,4480,4,8,1580,990,889000
4,2.5,2140,7754,3,8,2140,0,525000
4,2.5,2900,6918,3,8,2900,0,339000
4,4.25,4883,26040,3,10,3859,1024,537000
3,2.5,1810,4592,3,8,1810,0,513000
4,2.75,2080,4000,3,8,2080,0,940000
4,1.75,2290,8142,4,7,1490,800,325500
4,2.5,2980,5896,3,8,2980,0,610000
3,1.75,1790,6117,3,8,1350,440,790000
3,1,1040,6860,3,6,1040,0,239000
3,1.75,1150,7700,3,7,1150,0,415950
2,1.75,1670,4008,3,9,1670,0,565000
3,2.5,2420,8252,3,7,2420,0,455600
3,3,3740,39640,3,10,3740,0,789000
4,2.5,2650,6884,3,8,2650,0,734990
4,3,2483,6870,3,8,2483,0,360000
3,2.5,1520,2208,3,8,1040,480,499950
4,2.5,3240,20301,3,10,3240,0,749400
3,2.25,2490,8800,4,8,2490,0,590000
4,2.75,3270,9231,3,10,3270,0,940000
4,2.75,3260,5335,3,9,3260,0,650000
4,2.25,2440,8098,3,8,2440,0,330000
3,2.5,1650,6000,3,7,1650,0,280000
4,3.5,2510,3763,3,8,1990,520,680000
3,2.25,3050,10689,4,9,3050,0,438500
4,2.5,1788,10183,4,7,1788,0,294400
3,2,1940,16300,3,7,1140,800,399000
4,2.5,1613,4338,3,7,1613,0,279500
4,2.5,3160,8726,3,9,3160,0,427500
4,2,1980,4500,4,7,1980,0,500000
3,2.5,1920,1649,3,8,1600,320,542500
3,1.75,1260,7500,3,6,840,420,270000
3,2.5,1410,26375,3,6,1410,0,390000
3,1.75,2420,12676,3,7,2420,0,399500
4,2.5,3910,22710,3,8,3910,0,1.75E+06
3,2.25,1770,10000,3,7,1340,430,242500
3,1,1600,7161,3,8,1600,0,475000
2,1,850,16400,3,6,850,0,280000
4,1,1980,7991,3,7,1980,0,345000
4,2,1330,9188,3,7,1330,0,425000
3,2,1500,7828,4,7,1500,0,315000
4,3.25,3910,6293,3,9,3130,780,709950
3,1.75,1440,7070,3,7,1440,0,460000
3,1,910,7620,3,7,910,0,290000
4,2.5,2370,10083,5,8,2370,0,687000
2,1,930,5650,3,7,930,0,306000
2,2,1384,1822,3,7,1384,0,273000
4,2.5,2290,6318,4,8,2290,0,599950
4,1.75,1720,8750,3,7,860,860,385000
2,1,1500,6685,3,7,1190,310,570000
2,2.5,2680,7625,3,9,2680,0,779950
3,1.75,1980,9800,3,7,1980,0,306000
4,1.75,2600,11325,4,7,1610,990,304900
3,2.5,2060,25046,4,8,1600,460,330000
2,1,970,4560,4,7,970,0,690000
4,2.5,2160,7725,4,8,1460,700,295000
3,2.25,2450,6500,4,8,2450,0,329000
4,3.5,4030,1024068,3,10,4030,0,855000
3,1,970,7854,4,7,970,0,262500
4,2.5,3060,6826,3,9,3060,0,775000
3,2.25,1950,7221,4,8,1950,0,408000
4,1.75,1680,15084,4,7,840,840,340000
3,1.75,2140,15030,4,7,1570,570,419000
4,4,4550,54013,4,9,2300,2250,1.05E+06
4,3,3680,35736,4,8,2320,1360,595000
4,2.5,2692,8392,3,9,2692,0,436472
5,3.5,4800,14984,3,11,3480,1320,1.35E+06
3,2,1260,2550,3,7,1260,0,300000
4,2,2290,6000,5,7,2290,0,685000
3,1.75,1590,7280,3,7,1140,450,280000
2,2.5,1470,2533,3,8,1470,0,487000
4,3.25,3640,60086,3,10,3640,0,925000
3,2.5,2090,3002,3,7,1670,420,352000
3,2.25,2350,51400,3,7,1390,960,462500
4,3.25,3200,4477,3,9,2390,810,825000
4,2.5,3504,6000,3,7,3504,0,330000
4,2.25,3340,8000,4,8,3340,0,311000
3,1,1150,8100,3,6,1150,0,185000
4,3.75,4060,19290,3,10,4060,0,1.02E+06
4,1,1430,8355,4,7,1430,0,224500
3,1,880,8976,4,6,880,0,160000
3,1,1510,8800,4,7,1010,500,225900
3,2,1720,11875,5,6,1720,0,313100
3,2.5,2480,4136,3,8,2480,0,498000
4,2.5,2270,7665,3,9,2270,0,732350
3,1.75,1860,9629,4,7,1240,620,315000
4,2.5,2623,7184,3,8,2623,0,333000
4,3.5,3010,6202,3,9,3010,0,769000
4,2.5,2286,8269,3,8,2286,0,481000
3,2.5,1980,4274,3,7,1980,0,415000
3,1.75,1640,11730,5,7,1640,0,397000
3,2.25,2290,7350,3,8,2290,0,365000
4,2.5,3320,5034,4,7,3320,0,410000
4,3,3180,80837,3,11,3180,0,914600
5,2,2560,14467,3,8,1280,1280,585000
3,2.5,2650,12247,3,9,2650,0,425000
4,1,1150,8184,3,6,1150,0,307000
3,1,900,9600,4,7,900,0,329000
4,2.75,2770,3852,3,8,2770,0,572000
2,1,1040,4040,3,7,940,100,425000
4,2.75,2160,5005,3,7,1430,730,550000
4,3.5,3660,4903,3,9,2760,900,809950
2,1,820,7475,3,6,820,0,245000
3,2.5,2290,9142,3,8,2290,0,685900
3,2.5,1280,1920,3,8,1280,0,552000
3,2,1150,4500,3,7,1150,0,450000
3,2.25,1540,1005,3,8,1540,0,565000
3,1.75,2280,16671,4,6,1760,520,540000
3,1,1000,8320,5,6,1000,0,295000
4,2.5,1900,9240,3,7,1900,0,450000
4,2,1670,9987,3,7,1670,0,204700
4,1,1720,2800,4,7,1200,520,547000
3,2.5,1710,8998,3,8,1710,0,479000
2,2.5,2300,6400,3,8,2300,0,705000
3,2.5,2550,13458,3,9,2550,0,715000
2,1,1010,3627,4,6,1010,0,450000
3,3,2260,1825,3,8,1660,600,660000
3,2.5,1990,8325,4,8,1310,680,590000
3,2.25,1710,11500,3,7,1210,500,385000
3,1.5,1130,7200,3,7,1130,0,280005
4,2.5,2520,4831,3,8,2520,0,536000
3,1.75,1500,7800,3,7,1500,0,185000
3,1,1130,10650,3,7,1130,0,237000
4,1.75,2000,4000,5,7,1450,550,536500
3,1.75,2000,8400,4,8,2000,0,415000
4,2.25,3040,9690,4,9,1940,1100,760000
3,2,1700,8400,3,7,1700,0,616300
4,2.75,2550,7591,3,9,2550,0,669888
3,1.5,1460,7140,4,7,980,480,204000
3,2,1840,3075,5,7,920,920,650000
4,1.75,2520,21834,3,8,1420,1100,750000
2,1.75,1390,4160,5,6,790,600,460000
3,1,1660,8839,4,7,1660,0,392500
3,1.75,1550,7410,5,7,1550,0,280000
4,2.25,2870,6280,4,9,1980,890,1.33E+06
4,2.5,2600,8572,3,8,2600,0,300000
3,2.75,1250,1655,3,7,830,420,370000
4,2.5,2920,7200,3,8,1470,1450,1.05E+06
4,2.5,2030,4499,3,8,2030,0,365500
3,1.75,1470,8350,3,7,1470,0,212000
3,2,1560,9635,3,7,1260,300,260750
3,1,1870,7671,4,8,1720,150,375000
3,2,1330,1042,3,8,1060,270,372000
5,3.25,4770,50094,4,11,3070,1700,1.04E+06
5,3,2670,9920,3,8,1400,1270,370000
4,2.25,2930,9840,4,8,1560,1370,420000
5,3,2790,19439,5,7,1500,1290,589950
3,1.75,1660,10150,3,7,1660,0,350000
2,1.75,1270,1916,3,8,1270,0,340000
5,4.25,5040,9466,3,11,5040,0,1.28E+06
3,2,1930,11947,4,8,1930,0,342000
4,1.5,2020,6000,4,7,1010,1010,355000
3,1.75,1490,7150,5,6,1490,0,310000
3,1,1400,10800,3,6,1400,0,279900
3,3.25,4220,41300,4,11,2460,1760,3.30E+06
3,1.75,1680,10685,4,7,1680,0,637500
4,2.5,2963,5797,3,9,2963,0,325000
3,2.75,2890,12130,4,10,2830,60,1.17E+06
3,1,1280,3200,3,7,1280,0,425000
4,2.5,1750,11381,4,7,1610,140,464500
2,1,710,5200,4,6,710,0,320000
3,2,1290,1213,3,8,1290,0,450000
4,2.5,2230,4952,3,8,2230,0,297000
1,1,1050,7583,4,6,1050,0,210000
3,3.25,2770,6278,3,9,1980,790,461000
4,2.5,3490,3677,3,9,2850,640,680000
2,1,770,5200,5,6,770,0,176000
4,2.75,3010,10450,3,9,3010,0,810000
5,3.5,3210,4060,3,10,2290,920,1.29E+06
5,3.5,4060,8309,3,9,2960,1100,630000
3,1,1190,7560,5,6,1190,0,288000
5,4.5,4850,40902,3,10,4850,0,569950
3,1,1000,3844,5,7,900,100,412000
2,2,1520,5010,3,7,1520,0,400000
4,2.25,1950,6000,3,7,1350,600,564500
2,1,1122,9100,4,6,1122,0,185000
3,2,1770,1800,3,8,1770,0,690000
2,2.75,1310,1268,3,8,1310,0,525000
5,2.25,2560,10360,4,8,1870,690,667000
4,2.25,2270,5102,5,8,1340,930,735000
5,2,2280,3600,3,7,2280,0,534000
3,2.25,1460,968,3,7,1140,320,443750
3,2.25,2130,8800,3,8,1270,860,283000
3,1.75,1430,20193,3,7,1430,0,453000
3,1.75,1720,15225,4,7,1020,700,430000
3,1.75,1950,8325,4,7,1950,0,510000
4,3,2580,6740,3,8,2580,0,360000
4,2.75,2610,8760,4,8,1760,850,762500
2,2,1360,4688,3,7,780,580,488000
4,4.25,5010,19412,3,11,4000,1010,2.35E+06
3,1.5,1240,9975,3,6,1240,0,405000
4,3,2320,7200,3,7,1260,1060,770000
4,4.5,3780,6000,4,11,2770,1010,1.60E+06
3,2,1540,10410,4,7,1540,0,275000
4,2.5,2080,8100,5,8,1220,860,665000
4,3,2320,4468,3,8,2160,160,637500
4,3.75,3450,8395,4,10,2640,810,1.67E+06
5,2.75,3100,10014,4,9,1660,1440,975000
4,2.5,4040,11350,4,10,3690,350,1.25E+06
3,2,2660,5000,3,8,1940,720,727500
3,1.5,1700,8067,3,7,1250,450,315000
4,2.5,2990,7231,3,9,2990,0,698000
3,1.75,1930,213008,3,7,1300,630,568000
3,2.5,2040,10086,3,8,2040,0,542500
3,1.75,1780,11096,3,7,1210,570,500000
3,2.75,1970,5200,3,8,1970,0,925500
3,1,1090,22080,5,7,1090,0,267500
3,2.25,2030,8690,4,8,1360,670,287500
4,2.5,2520,4950,3,8,2520,0,865000
3,1.5,1300,7907,3,7,900,400,270000
3,2,2030,17120,4,8,1890,140,295450
2,1,710,4240,4,6,710,0,271000
3,1,1060,6000,3,8,1060,0,420000
3,1.75,1650,10150,3,8,1230,420,539900
3,1.75,1680,8610,4,7,1290,390,427000
3,2.5,1584,3200,3,7,1584,0,263000
3,1.75,1520,9600,4,7,1520,0,190000
3,1,1330,5100,3,7,900,430,553000
3,2,1440,3900,3,8,1440,0,391265
3,3,1390,1080,3,7,1140,250,280000
2,1.75,1340,4664,3,8,1340,0,415000
3,2,1850,16535,3,7,1850,0,265000
5,2.75,2540,27007,3,8,1520,1020,420000
3,2,1170,5450,5,6,1170,0,260000
1,1,530,6350,5,5,530,0,238000
4,2.5,2710,4069,4,10,2710,0,865000
3,2.5,1820,6848,4,7,1820,0,875000
4,2.5,2840,9354,3,10,2840,0,650000
3,2.5,2290,4203,3,9,2290,0,590000
3,2.5,1870,5874,3,7,1870,0,306000
4,1,2070,7519,3,7,1160,910,501000
4,2.5,3340,10422,3,10,3340,0,1.15E+06
2,2.5,1270,1242,3,7,1270,0,348000
3,1.75,2400,14012,3,9,2400,0,357000
3,1,1000,19204,3,7,1000,0,249000
3,1.75,1320,5750,5,7,1320,0,660000
4,2.5,2340,6420,3,8,1590,750,668750
3,2.75,2600,12860,3,7,1350,1250,430000
5,1.75,2780,7786,3,8,1390,1390,528000
3,2,1310,7332,3,7,1310,0,230000
2,1,760,7114,3,6,760,0,430000
3,2.5,2460,10300,3,10,2460,0,995000
3,1.5,990,4500,5,7,990,0,421500
3,2,1560,6300,3,7,1560,0,528000
3,2.5,1940,3211,3,8,1940,0,555000
4,2.5,2970,7961,3,8,2020,950,635000
4,4,5780,7173,3,11,4130,1650,2.89E+06
4,1.75,1710,7724,3,8,1710,0,430000
5,2.75,2440,6858,3,8,2440,0,340000
2,1,1040,5765,3,7,1040,0,358803
4,1,1680,5043,4,6,1680,0,366350
3,1,1980,8505,3,7,1030,950,233000
3,1.75,1880,9360,4,7,940,940,445500
3,1.75,2600,15064,4,8,1700,900,860000
4,1.75,2040,6348,3,7,1020,1020,551000
3,2.5,1970,3667,3,7,1970,0,420000
4,1,1530,7200,3,7,1400,130,245000
3,2.5,2520,3750,4,9,2520,0,875000
2,1.75,1160,6828,3,7,860,300,458500
4,2.25,1990,7610,4,8,1290,700,529219
2,1,1040,4000,3,6,1040,0,341000
3,2.5,2470,9226,3,9,2470,0,607000
3,1.5,2030,10075,5,7,1080,950,389000
5,3.25,4560,19080,5,9,2490,2070,1.68E+06
4,2.5,1990,5511,3,8,1990,0,302500
2,2,1180,3003,3,6,1180,0,209900
3,1,1280,6967,3,7,1280,0,195000
4,2.5,2130,4750,3,8,2130,0,370000
3,1.75,1200,7360,4,7,1200,0,385000
4,2.5,3390,10519,3,10,3390,0,583000
3,2.5,2270,5536,3,8,2270,0,507250
3,2.5,1580,8541,3,7,1580,0,213550
3,2.5,2830,3750,3,10,2830,0,959000
4,2.5,2020,7277,3,8,2020,0,308000
4,1.75,1960,6138,4,7,1260,700,564000
3,2.25,1170,1249,3,8,1170,0,519950
3,2,1550,6039,5,7,830,720,430000
4,2.5,2650,18903,3,11,2650,0,745000
4,1.5,1950,12559,3,6,1950,0,225000
4,2.5,2280,9725,3,8,2280,0,565000
4,2.5,1780,15000,2,7,1780,0,355000
3,2,2690,435600,3,8,2690,0,575000
4,2.75,3210,41689,4,8,1610,1600,399950
4,1.75,1880,12150,3,7,1280,600,310000
4,2.75,2880,5750,5,9,1710,1170,920000
3,1.75,1680,8648,4,7,1680,0,372500
3,1.5,1300,7885,3,7,1300,0,263000
1,1,930,7129,3,6,930,0,210000
3,2.25,1330,1198,3,8,1080,250,325000
4,2.5,2440,7797,3,8,1560,880,278800
3,2.5,2010,2212,3,8,1390,620,472217
7,4.75,5370,10800,3,8,5370,0,884900
4,2,1580,4800,3,7,1580,0,557510
5,1,1410,9000,5,7,1410,0,230000
4,3.5,3990,23544,3,10,2300,1690,570000
3,2.5,2238,7209,3,8,2238,0,330000
4,2.5,2020,3440,4,7,1480,540,542000
2,1.5,1180,834,3,8,1180,0,325000
4,2.25,2180,10754,5,7,1100,1080,315000
3,2.5,2260,4550,4,7,1380,880,622500
2,1,720,4758,3,6,720,0,225000
3,1.75,1540,4800,4,6,770,770,565000
2,1.75,1410,1005,3,9,900,510,399900
3,2.5,2100,213008,3,8,2100,0,506000
3,2,1440,5457,3,7,1440,0,250000
3,1.75,1300,7800,5,7,1300,0,445950
4,3,4590,9150,3,10,3490,1100,960000
3,1.5,2700,24539,3,7,2120,580,524950
4,1.75,2251,12731,4,8,1390,861,305000
3,1.75,1840,5664,3,7,1270,570,625000
3,1,1120,7500,3,7,1120,0,230000
4,2.25,2170,10500,4,8,1270,900,431000
5,3,2620,5477,3,10,2620,0,975000
3,1,1050,9083,3,7,1050,0,325000
3,1.75,1850,22767,5,6,1850,0,572000
5,4,4780,118047,3,11,4780,0,1.64E+06
5,3.75,3860,6901,3,7,3860,0,470000
3,2.25,1970,35100,4,9,1970,0,437500
2,1.5,1570,3600,4,7,1320,250,782000
3,1,840,6500,5,6,840,0,203000
5,2.75,2860,5379,3,9,2860,0,720000
3,1,1690,20063,4,7,1690,0,240000
3,3,1860,7440,5,7,1040,820,301350
3,2,1220,6404,3,7,1220,0,249900
3,1,1420,8000,3,7,1420,0,408000
3,1.75,1370,1990,3,9,1370,0,720000
4,2.5,3150,7277,3,9,3150,0,681716
4,2.5,1790,5257,3,7,1790,0,251100
6,2,2650,4621,3,8,2650,0,302000
2,2.5,2170,7546,3,8,2170,0,745000
7,2.75,2310,2400,3,6,2310,0,580000
3,1,1120,8443,3,7,1120,0,365000
2,2.5,1410,1281,3,8,1090,320,400000
4,2.5,2360,7475,3,8,2360,0,340000
3,1.75,1380,8182,5,7,1380,0,425000
3,2,1090,8400,4,6,1090,0,235000
3,1.75,1880,6360,4,7,1040,840,600000
4,2.5,2390,8432,3,9,2390,0,664000
4,2.5,3060,5000,3,9,3060,0,710000
3,2.75,1650,5700,4,7,1650,0,350000
3,2.5,1360,3718,3,7,1360,0,369950
4,2.5,2920,24074,3,9,2920,0,555000
2,2,1350,4225,3,8,1350,0,428000
4,2.5,2930,5000,3,9,2760,170,800000
4,1,1450,32234,4,6,1450,0,282510
2,2.5,2150,5760,3,8,2150,0,741500
3,1,970,8580,3,7,970,0,156000
3,1,1860,9225,3,7,1860,0,265500
4,2,1690,8208,4,7,1210,480,478000
3,2.25,1780,6120,4,9,1390,390,771000
3,2.5,1530,1131,3,8,1530,0,375000
3,2.5,1630,1755,3,8,1320,310,419900
3,1,1060,12690,3,7,1060,0,400000
4,3.25,3990,18115,4,11,3990,0,2.72E+06
3,1.75,1540,6273,4,6,770,770,263500
4,1.75,2510,8989,4,8,1680,830,595000
5,4.5,4630,6324,3,9,3210,1420,809000
4,2.5,2600,5188,3,8,2600,0,359900
2,1,1050,6600,3,6,1050,0,123000
3,2.5,2370,5344,3,9,2370,0,535950
3,2.5,1770,3744,3,7,1270,500,643002
4,2.5,3340,6924,3,8,3340,0,576000
3,1.75,1420,7920,4,7,1420,0,235000
3,1.5,1950,7620,4,7,1010,940,275000
4,3,3990,7838,3,9,3990,0,810000
3,3.5,3830,221284,3,10,3530,300,800000
3,1.75,1740,10800,3,7,1740,0,340000
1,1.5,1100,3451,4,8,1100,0,220000
5,2.5,3090,23265,3,8,2990,100,458000
3,2.5,1800,2700,3,8,1800,0,365000
4,2.5,2040,11841,3,7,2040,0,240000
3,2.5,2290,14374,3,8,2290,0,622500
3,1.75,1080,3200,4,7,880,200,805000
4,2.5,2460,6454,3,7,2460,0,452500
4,2.5,2610,5562,3,9,2610,0,610360
2,1,970,18557,3,6,970,0,315000
3,1,1310,7125,4,7,1310,0,240000
4,2,3060,8000,4,8,2040,1020,877500
5,2,2000,4211,4,7,1280,720,690500
4,1.75,2390,17717,4,8,2390,0,926250
3,1,860,7740,3,6,860,0,207000
5,2.5,2810,14207,3,9,1540,1270,830000
4,2.5,2350,7245,3,8,2350,0,598850
3,2.25,2950,78843,3,9,2950,0,759000
2,1.75,1490,224334,3,8,1490,0,475000
3,1.75,1470,5000,5,7,1470,0,554600
3,2.5,2010,2263,3,8,1340,670,749950
3,1.5,1380,3031,4,7,1380,0,549900
3,1,1610,11250,3,7,1090,520,375000
4,3,2130,4838,4,7,2130,0,370000
5,3.25,3620,5500,3,9,3620,0,856000
4,2.5,2770,89298,3,8,2770,0,700000
3,2.5,1940,14952,3,8,1940,0,297000
4,2.5,3110,6142,3,9,3110,0,751000
3,2,1010,14183,3,8,1010,0,390000
3,1.75,1680,250470,4,7,1070,610,350000
3,1.75,1760,6788,3,7,1760,0,1.15E+06
5,1.75,2344,4800,4,7,1544,800,791000
2,2,1170,1890,4,8,1170,0,613000
1,0,600,24501,2,3,600,0,280000
2,1,1020,6380,3,7,1020,0,290000
4,4,3180,7650,3,8,2530,650,775000
3,1.75,1590,7560,3,7,1130,460,250000
3,1,800,5760,3,6,700,100,265000
4,2.5,2220,4228,3,8,2220,0,334990
3,2.25,1960,44634,3,7,1130,830,449000
3,2.5,3010,7014,3,8,3010,0,538000
2,1,1290,2482,3,7,1290,0,300000
3,2.5,2680,28243,3,9,2680,0,660000
2,2.5,1560,1222,3,8,1080,480,435000
3,1.5,1480,10588,3,7,1480,0,224000
4,2.25,2630,39000,3,9,2630,0,454000
3,2.5,1950,9906,3,8,1950,0,530000
4,2.5,1780,2992,3,7,1780,0,455000
3,2.25,1680,35127,3,7,1680,0,285000
4,1,1440,7404,3,6,1080,360,250000
4,2.5,2930,18199,3,9,2930,0,749000
3,2.5,2390,6435,3,8,1600,790,432500
3,2.5,2680,7757,3,8,2680,0,320000
3,1.5,1970,3400,4,8,1420,550,490000
3,1.75,1850,16863,4,7,1280,570,445000
4,2.5,2280,65836,3,8,2280,0,535000
3,2.5,2000,7251,3,9,2000,0,577500
4,2.5,3220,7873,3,10,3220,0,763000
3,1,1360,13000,5,6,1360,0,630000
3,1.75,1830,5488,4,7,1010,820,450000
3,1,1330,77972,3,7,1330,0,900000
5,2,3110,6131,5,7,1560,1550,719000
3,2,2010,12950,3,8,2010,0,310000
3,2,1940,55756,5,9,1940,0,732000
2,1.75,1010,4000,5,7,1010,0,441500
3,2.75,2710,9204,3,9,1480,1230,1.43E+06
3,2,2510,5200,5,8,1470,1040,562000
3,2.5,2060,7458,3,9,2060,0,348000
4,2.5,2180,3375,4,7,1420,760,657000
3,1.75,3610,8502,3,10,2610,1000,1.02E+06
4,2.5,1620,219542,3,7,1620,0,365000
3,1.75,2000,36000,3,6,2000,0,443950
3,2.25,2370,217800,3,7,2370,0,587000
1,1,560,4120,3,4,560,0,90000
4,2.5,2630,5710,3,8,2630,0,560000
3,1,960,3600,4,7,960,0,477000
3,1.75,1670,6034,3,7,990,680,280000
3,3,2630,10156,4,9,2630,0,778000
3,2.5,2860,5805,3,9,2860,0,1.01E+06
3,2.25,2070,7207,3,8,1720,350,535100
3,2,1150,700,3,7,800,350,340000
5,4,1680,7268,3,8,1370,310,545000
3,2.5,2588,5702,3,8,2588,0,306000
3,2.5,1520,1488,3,8,1520,0,385000
1,1,860,4800,3,6,860,0,330000
4,2.25,2860,15054,3,8,1460,1400,460000
4,2.5,2720,10006,3,9,2720,0,594950
2,1,700,3400,3,6,700,0,399000
3,1.75,1900,13600,4,8,1900,0,1.21E+06
3,1,1260,9638,4,7,1260,0,490000
4,2.5,2350,4675,3,9,2150,200,880000
2,1.5,1760,12000,4,7,1760,0,500000
4,3.25,3520,19354,4,9,2010,1510,1.11E+06
2,1,730,6728,3,6,730,0,122000
3,2.25,1610,5159,3,7,1610,0,449950
3,1,1090,3264,4,6,1090,0,152000
3,2,2090,5015,5,7,2090,0,785000
3,3.25,3140,37120,3,9,1760,1380,532500
3,1,1010,9945,4,6,1010,0,310000
3,1.75,1070,7200,3,7,1070,0,208000
3,2,1900,9975,3,8,1500,400,545000
4,2.5,3150,13700,4,9,3150,0,1.26E+06
3,2.5,2400,7745,3,9,2400,0,750000
5,1.5,2680,28014,4,8,1450,1230,898000
3,1,940,7811,3,6,940,0,350000
3,1,1080,4930,3,6,1080,0,265000
4,2.5,1889,6000,3,7,1889,0,277950
4,2,1830,4590,3,8,1830,0,700000
5,3.5,3680,8680,3,9,3680,0,1.38E+06
5,4.25,6510,16471,4,11,3250,3260,1.90E+06
2,1,990,57499,2,6,990,0,220500
4,2.5,1940,7107,3,7,1940,0,322500
4,2.5,3520,9901,3,10,3520,0,828000
4,2.25,2260,43847,3,8,2260,0,600000
3,2.5,2130,6969,3,7,2130,0,320000
3,2.25,1850,10855,3,8,1370,480,520000
3,3.25,1470,1152,3,8,1470,0,615000
4,2.5,1800,9229,3,7,1800,0,285000
2,1,1980,5000,4,7,1090,890,496752
4,2.25,1810,9240,3,7,1810,0,268643
3,1,1820,8142,3,7,1040,780,309000
4,1,1020,42966,4,6,1020,0,200000
4,2.5,2080,11176,5,8,2080,0,635000
3,2.5,1780,7192,4,7,1250,530,252500
3,2.5,1740,5267,3,7,1740,0,335000
4,2.25,2750,6180,4,8,1500,1250,635000
5,2.75,3740,6750,4,8,1980,1760,595000
4,2.25,2010,7280,4,8,2010,0,324900
3,2.25,1180,9630,3,7,1180,0,342400
4,2.75,2420,8700,4,7,2420,0,279950
3,2.25,1960,17126,3,8,1400,560,285750
3,2.25,1250,811,3,8,1250,0,419950
2,1,960,6700,3,7,960,0,395000
6,2,2020,7071,3,7,1010,1010,335000
3,2.5,1480,2159,3,8,1480,0,650000
3,1,1830,13900,3,7,1830,0,423000
4,1.75,2560,8270,3,7,1480,1080,448000
3,2.5,1750,3900,3,8,1750,0,453000
3,0.75,770,7000,3,4,770,0,205000
4,1.75,1770,12278,3,7,1350,420,630000
2,1.75,1450,15798,3,7,1230,220,655000
2,1,720,5160,3,6,720,0,248500
4,2.75,2640,3750,5,7,1840,800,750000
4,2.75,1890,1475,3,9,1200,690,671000
3,2,1610,4160,4,7,1010,600,485000
2,2.5,2550,216344,3,7,2550,0,345000
3,1,1110,7962,3,7,1110,0,210000
3,2.5,2550,5376,3,9,2550,0,711000
3,1,1120,6600,3,7,1120,0,549995
3,2.5,1600,2244,3,7,1600,0,260000
3,2.25,1440,6232,3,7,1440,0,432250
2,1.5,940,5000,4,7,810,130,392000
3,2.5,1950,4197,3,7,1950,0,313200
4,2.5,2960,28005,3,10,2960,0,760000
4,2.75,2320,12368,3,8,1670,650,445000
2,1,990,4332,3,7,990,0,620000
4,3.5,3100,5600,3,9,3100,0,735000
3,1.75,1520,7252,3,7,1140,380,405000
3,1.75,1500,8173,3,7,1500,0,435000
4,2.5,2030,4596,3,8,2030,0,349500
5,2.75,2990,7200,3,8,2990,0,490000
2,2.5,1680,977,3,9,1680,0,935000
4,2.25,2060,7283,3,8,1220,840,410000
2,1,710,14700,5,6,710,0,187250
4,2.5,2810,10986,3,10,2810,0,742000
3,2.75,2980,27144,5,8,2180,800,947500
3,2.5,2480,6031,3,8,2480,0,475000
5,4,4850,36450,3,10,4850,0,975000
5,3.5,3990,9938,3,11,3990,0,1.07E+06
4,2.5,2450,5079,3,9,2450,0,555000
3,2.5,3150,151588,3,9,3150,0,720000
3,2,2420,38781,5,7,1210,1210,349900
4,2.5,1850,7324,3,8,1850,0,325000
3,2.25,1960,2345,3,7,1750,210,310000
2,2.25,1540,958,3,9,1540,0,640000
4,3.75,3550,15151,3,11,3550,0,959900
4,1.75,1470,4236,4,7,1470,0,638000
4,2.5,2230,14694,4,7,1180,1050,549950
4,2.5,2230,5650,3,7,2230,0,440000
2,1,1510,6807,3,7,1090,420,415000
5,1.5,1420,9900,3,7,1050,370,485000
3,2.5,2660,10928,3,9,1830,830,768000
3,2.5,2850,21780,3,10,2850,0,799990
3,2.5,1380,1389,3,8,1380,0,527500
3,2.5,2360,4670,3,7,2360,0,441500
3,2.5,3440,103672,3,9,3440,0,560000
5,3.25,3160,5000,3,10,2180,980,957000
4,2.5,2230,4541,3,7,2230,0,253000
3,2,1560,4080,3,7,1560,0,449950
4,2.5,2490,8750,3,8,2040,450,532500
3,2,1940,6440,5,7,970,970,651000
3,2,1310,6738,4,7,1310,0,249900
4,1,1120,3844,3,7,1120,0,329000
4,3.25,1690,1321,3,8,1320,370,519990
3,2,1910,8050,4,7,1000,910,275000
2,1,1040,5527,3,7,1040,0,535000
2,1,1550,38449,3,6,1550,0,222000
3,3.25,1710,1960,3,8,1360,350,445000
3,1.75,1530,8503,4,7,1150,380,536000
4,2.75,3100,14568,3,8,3100,0,564500
4,2.5,3260,6902,3,8,3260,0,552500
4,2.5,2780,11904,5,8,1730,1050,1.65E+06
4,4.5,5670,84267,3,11,5670,0,935000
3,2.25,2080,2856,3,7,1550,530,267500
4,2.5,2720,5771,3,8,2720,0,455950
4,2.5,3190,14565,3,11,3190,0,862000
2,1.5,1510,1962,4,8,1510,0,451101
4,2.5,2500,10330,3,10,2500,0,740000
2,1,1340,9840,3,7,1340,0,290000
4,2,1890,8362,3,7,1890,0,312000
2,1,840,5087,3,7,840,0,315000
3,3.25,1320,1327,3,8,1040,280,385000
4,2.5,2770,21806,3,9,2770,0,533300
3,3,2680,12285,4,8,2680,0,417400
4,1.75,2150,9000,4,7,1110,1040,550000
4,2.75,3880,15025,3,7,3880,0,702000
3,2,1620,2640,5,8,1620,0,665000
3,2.5,1870,7344,3,8,1470,400,455000
2,1,790,11234,4,6,790,0,435000
3,2.25,1453,2225,4,8,1453,0,460000
3,2,2050,9396,5,7,1170,880,399950
4,1,1440,7100,3,7,1440,0,500000
5,3,3670,10583,5,8,2060,1610,569000
3,1,1460,9750,4,7,1460,0,201000
3,1.5,1980,11214,3,7,1980,0,235000
3,2.25,2840,107157,4,9,2840,0,490000
3,1.75,1580,7344,5,7,1580,0,260000
4,2.5,2240,4025,3,7,1250,990,630000
2,1.75,1250,7029,4,7,1250,0,468000
3,2.25,2400,12350,4,8,1420,980,705640
3,2.5,2130,219978,3,8,2130,0,515000
4,2.75,2250,5700,3,8,1200,1050,648475
4,3.5,4740,172497,3,11,4740,0,1.20E+06
3,2.5,1500,9636,3,7,1500,0,405000
3,2.5,2180,40278,3,9,2180,0,580000
3,2.25,2160,15360,3,8,1410,750,550000
3,2,1300,14350,3,7,1300,0,502000
5,3.25,3230,5000,3,9,2350,880,815000
4,2.75,3090,7650,3,8,2340,750,734000
3,1,1020,7650,3,7,1020,0,293000
3,1.75,1300,2580,5,7,820,480,462000
2,1,930,3750,4,7,930,0,500000
3,1.75,1240,8050,4,7,1240,0,347000
3,2,2560,6800,4,8,1380,1180,695000
3,1,1200,6120,4,7,950,250,476500
4,2.5,2880,213444,5,8,2140,740,579950
4,1.5,1600,9289,4,7,1600,0,224000
4,2.5,2060,3608,3,7,2060,0,269000
3,1.75,1540,8925,4,7,1540,0,392500
2,2.5,2470,609,3,11,1910,560,1.23E+06
3,2.25,1760,7023,3,7,1760,0,289200
3,3.25,3230,5000,3,9,3230,0,715000
3,1.75,1180,16552,4,7,1180,0,390000
3,1.75,1660,8208,4,8,1660,0,490000
4,1.75,1700,5846,3,8,1700,0,616000
3,1.75,1320,7280,3,7,1320,0,420200
3,1.75,1500,13430,3,7,1500,0,383000
4,3.25,2470,4760,5,9,1890,580,1.33E+06
2,1,790,13170,3,6,790,0,280000
4,2.5,2660,8027,3,8,2660,0,447000
4,1,1520,9800,4,7,1520,0,389000
4,2.5,2660,5539,3,8,2660,0,423000
3,1.5,1140,20383,3,7,840,300,319900
3,1.5,1480,1722,3,7,1480,0,319000
3,3,2400,7260,3,7,1440,960,335750
3,3.25,3700,2264,3,11,2280,1420,1.48E+06
2,1,900,57063,4,6,900,0,275000
3,2.5,1740,2350,3,8,1130,610,585000
3,3.25,1410,1253,3,8,1410,0,382000
2,1,1260,7810,3,6,1260,0,255000
3,2.25,2110,11319,4,8,2110,0,479000
4,3,2400,5400,4,7,1600,800,475000
3,2.75,2800,9750,5,7,1400,1400,915000
3,2.25,1620,8701,3,7,1220,400,469950
3,3.5,1660,2298,3,8,1260,400,608000
5,2.75,2190,12687,5,7,1370,820,446000
2,2.25,1730,31491,4,7,1730,0,800000
3,2.5,2370,4200,3,8,2370,0,388598
3,2.5,2190,10000,4,7,1540,650,760000
4,2.5,2340,6896,3,7,2340,0,465950
3,2.75,2810,12813,3,8,2040,770,607000
2,1,720,5600,4,7,720,0,435000
4,1.5,2500,6300,4,7,1500,1000,250000
4,1.5,1300,7200,4,7,1300,0,259500
3,2,1470,1656,3,8,1310,160,380000
4,3.25,4240,11189,3,10,4240,0,1.66E+06
2,1,960,6250,4,6,740,220,435000
2,1,800,5000,3,7,800,0,435000
4,2.5,2320,10046,3,7,2320,0,475000
2,1.5,1120,1312,3,7,1000,120,215000
4,2,2280,8339,4,7,1220,1060,721000
3,2.5,1910,66211,3,7,1910,0,440000
4,2.5,2610,8031,3,8,2610,0,510000
5,1.75,2180,9178,3,7,1140,1040,275000
5,3.5,4460,2975,3,10,3280,1180,490000
3,1.5,1780,16000,2,7,1240,540,279000
3,2.5,3580,54450,3,9,3580,0,725000
2,1,1160,17635,3,6,1160,0,700000
4,2.25,3060,7920,3,7,1530,1530,390000
3,1,1210,7175,3,7,1210,0,215000
5,1.5,1790,11656,3,7,1790,0,225000
3,2.5,1740,22089,4,8,1130,610,445000
4,3.5,2770,8763,3,8,2100,670,359000
5,2,2020,5000,4,7,2020,0,488000
4,2.5,2330,14289,4,8,2330,0,542500
4,1.5,2480,6000,3,8,1520,960,579000
3,1,1300,7420,4,6,1300,0,208000
3,1.75,1160,5850,4,6,1160,0,190000
4,3.5,4010,15365,3,11,4010,0,1.39E+06
3,1.75,1070,8000,3,7,1070,0,415000
5,3.25,2440,15815,3,8,1990,450,680000
4,2.5,2060,6958,3,7,1220,840,462000
4,1.75,2220,4760,3,7,1320,900,397500
3,2.5,3240,7857,3,10,3240,0,800000
4,2.5,2960,5027,3,7,2960,0,500000
3,1.75,1300,958,3,7,840,460,330000
4,2.5,2860,3345,3,8,2190,670,499950
3,2.5,1740,1279,3,8,1740,0,545000
3,2.5,2190,7982,3,8,2190,0,700000
2,1,1270,1399,3,7,1270,0,370000
4,3.5,2770,10505,3,8,2770,0,285000
5,3.75,3050,8972,3,9,3050,0,909950
3,3.25,4460,51177,3,9,4460,0,739500
3,2.5,1200,813,3,9,1200,0,412000
5,4.5,10040,37325,3,11,7680,2360,7.06E+06
3,1,2200,21450,4,9,1600,600,573500
4,2.75,2050,17859,4,7,1300,750,584999
3,1,1610,8500,3,7,1610,0,180000
5,2.5,2970,24759,4,8,1670,1300,469500
4,2.25,4470,86225,3,10,4470,0,885000
5,3,2920,2808,3,8,2140,780,830000
5,2.5,2100,17825,4,7,1400,700,309900
4,1.75,1820,8118,4,7,1080,740,264000
3,2.5,1410,2675,3,7,820,590,546500
4,2.5,3030,8335,3,10,3030,0,740000
4,4.25,3010,4887,4,10,1940,1070,870000
3,1,880,18205,4,6,880,0,218000
5,1.75,2840,12870,4,7,2840,0,345000
5,2.75,2790,20824,3,9,1680,1110,840000
5,2.75,3060,6895,3,8,3060,0,381000
3,2.25,1530,1279,3,7,1116,414,390500
2,1.5,880,1805,3,7,880,0,235000
3,2.5,2590,18980,4,10,2590,0,396500
2,2.25,1240,705,3,7,1150,90,352499
4,1.5,2290,10372,3,7,1510,780,776500
4,2.5,2009,5000,3,8,2009,0,303210
5,3,2830,8854,4,8,1500,1330,865000
4,2.25,2580,8820,4,9,1620,960,305000
3,1,1140,7316,3,6,1140,0,330000
5,5.25,3410,8118,3,11,3410,0,2.25E+06
5,4.25,3970,4500,3,9,2860,1110,811500
3,2,2320,17688,3,8,2320,0,450000
3,3,1860,2875,3,8,1710,150,399950
3,1,1190,9486,4,7,1190,0,375000
4,2.5,2150,7670,5,7,1240,910,229950
5,4,4770,31570,3,12,4770,0,1.48E+06
2,1.75,2620,14138,3,8,2120,500,1.36E+06
5,2.25,4200,5800,4,9,2910,1290,1.34E+06
3,1.75,1380,7500,3,7,1380,0,240000
3,1.75,1496,1423,3,8,1248,248,370000
5,2.5,1990,6840,4,7,1990,0,438000
3,1.75,2140,5808,3,7,1070,1070,620000
3,1.75,1628,286355,3,7,1628,0,250000
3,1,2090,4000,3,8,1890,200,717500
4,3,2910,8540,3,9,2910,0,701000
4,2.25,2440,9320,4,7,1880,560,650000
3,3.25,1460,1592,3,8,1130,330,350000
4,2,2680,14157,3,8,1460,1220,525000
3,1.75,1390,7399,4,7,1390,0,246000
6,5.25,6160,27490,3,11,4040,2120,1.28E+06
3,2.25,1630,10962,4,8,1100,530,305000
4,2.5,1890,7200,4,7,1500,390,506500
3,2,1690,16061,3,7,1690,0,459800
3,2.5,1960,6997,3,7,1960,0,405000
5,1.75,2120,8625,3,7,1200,920,534000
5,2.25,3220,9603,3,8,3220,0,605000
2,2.5,980,1021,3,8,980,0,329900
3,2.5,2980,43301,4,8,1930,1050,615000
5,2.5,3400,9500,4,8,3400,0,1.28E+06
3,2.5,1500,1119,3,7,1110,390,605000
3,1.75,1190,6000,3,7,1190,0,203000
4,2.5,2710,5500,3,9,2710,0,668500
3,1.75,2230,13529,3,9,2230,0,1.45E+06
4,1.5,2140,7920,3,7,1190,950,378000
4,2.5,2720,11049,3,10,2720,0,975000
3,1,1720,8910,4,7,1720,0,399950
3,2.5,1600,6250,3,7,1600,0,308950
3,1.75,1840,11440,4,8,1340,500,366000
4,1.75,2300,11700,4,9,1960,340,615000
3,1.5,970,8400,3,7,970,0,155000
3,2,2950,12196,4,7,2310,640,495000
2,1,1100,7500,3,7,1100,0,353000
5,3.25,3420,5669,3,9,2620,800,855000
3,1,1180,7200,4,7,1180,0,425000
5,2.75,2550,7725,5,8,1390,1160,480000
3,1.5,1030,7184,4,7,1030,0,275000
4,2.5,2470,5074,3,8,2470,0,356000
4,4.25,5584,68257,3,11,5584,0,1.68E+06
3,1,1170,11000,2,6,1170,0,119500
3,1,1150,8848,3,7,1150,0,227500
4,2,2780,11583,3,8,1190,1590,645000
3,2.5,1270,1283,3,7,1270,0,292000
4,2.5,1680,6655,3,7,1680,0,213400
4,2.75,2740,7872,3,10,2740,0,530000
3,2.5,1995,1483,3,8,1760,235,505000
3,1.5,2060,15837,3,6,2060,0,200000
3,2.5,1570,3143,3,7,1570,0,325000
3,2.5,2610,7567,3,9,2610,0,780000
3,1.5,1580,1228,3,8,1580,0,495000
5,1.5,2050,9360,3,7,1520,530,375000
5,3.5,4180,17841,3,10,3160,1020,1.02E+06
3,2.5,2760,6187,3,10,2760,0,834538
5,2.5,2530,4229,3,7,2530,0,349900
3,1,880,7500,3,7,880,0,230000
4,3,2040,5050,3,8,1490,550,289950
3,2,1680,81893,3,7,1680,0,350000
4,2.75,2500,12848,3,8,2120,380,390000
3,2.5,1830,6807,5,7,1830,0,440000
3,2.5,1770,3873,3,7,1770,0,316500
3,2.5,1710,5633,3,7,1710,0,372000
3,2.25,1870,9315,3,7,1350,520,497000
4,2,1490,13736,4,6,1490,0,410000
5,2.75,3300,7560,3,10,3300,0,1.11E+06
3,4,4380,42769,5,11,4380,0,1.05E+06
3,2,1360,6685,3,7,1360,0,290000
3,2,1470,2052,3,7,1470,0,215000
3,1,910,7700,4,7,910,0,300000
4,3.25,2864,8035,3,8,2864,0,380000
3,1,1250,8276,5,6,1250,0,219000
2,2,1560,4675,3,8,1560,0,509000
4,3,2740,10925,3,8,1670,1070,385000
5,2,2450,9488,4,7,1240,1210,550000
3,2.5,1980,4500,3,7,1980,0,317950
4,2.5,1700,9000,5,7,1700,0,410000
3,2,2168,12616,4,7,2168,0,625000
3,2.25,1750,1572,3,9,1470,280,626000
4,2.5,2180,3893,3,8,2180,0,726500
6,4.5,2750,4400,3,8,1770,980,869900
3,2,2130,35169,4,8,2130,0,880000
3,2.25,2940,6500,3,9,2940,0,885000
2,1,780,13500,4,7,780,0,306000
3,1.75,1530,26642,3,7,1180,350,410000
3,1.75,1640,6435,3,7,1190,450,415000
3,2.5,2020,6628,4,7,1250,770,300000
2,1,1110,6800,5,7,1000,110,440150
2,2.5,1860,3504,3,7,1860,0,380000
2,1,1290,6528,4,7,1290,0,529100
3,2.5,1720,3581,3,7,1720,0,389700
3,1.5,1290,1286,3,7,1290,0,440000
5,2.5,2540,3832,5,8,1760,780,620000
3,1,1210,7440,3,7,1210,0,324950
2,2,1540,7110,3,7,960,580,495000
3,2,1510,3000,4,7,910,600,489000
2,2.25,1490,6770,3,8,1490,0,480000
4,1.75,2280,3680,5,7,1470,810,665000
3,2.25,1640,7730,4,7,1220,420,190000
3,2,2310,6000,4,9,1560,750,815000
4,2.5,3010,9000,3,8,3010,0,530000
3,1.5,1560,9600,4,7,1560,0,335000
3,1.75,1670,5375,3,7,1270,400,699000
4,4.5,6380,88714,3,12,6380,0,1.82E+06
3,1.75,1060,8100,4,7,1060,0,295000
4,1.5,1890,7540,4,7,1890,0,330000
3,1,1040,11900,5,6,1040,0,330000
4,2.5,3370,5000,3,9,3370,0,825000
3,2,1490,7697,3,7,1490,0,305000
3,1,1220,4541,3,7,890,330,280500
4,3.5,2850,4416,3,7,2040,810,875000
4,1.5,1890,6938,3,8,1890,0,825000
3,1.75,2040,7281,3,7,1020,1020,253000
5,5.5,7050,42840,4,13,4320,2730,3.80E+06
3,2,2570,159865,5,7,2570,0,625700
5,2.25,2140,8700,3,8,1220,920,564000
3,2.5,2000,6341,5,8,1040,960,625000
4,2.5,3130,5999,3,7,3130,0,315000
4,2.75,2410,5650,5,8,2070,340,745000
2,3,3160,66646,3,7,3160,0,589900
4,3.5,4220,8417,3,10,4220,0,1.06E+06
3,2.25,2700,4025,4,8,1760,940,552500
3,1,1320,5500,3,7,1320,0,420000
2,1,960,8276,3,5,960,0,305000
3,1.5,1740,5200,4,7,1060,680,219000
3,1.5,1160,10125,4,7,1160,0,210000
5,2.25,2550,9200,4,8,1580,970,454000
6,4,5330,18116,3,11,3950,1380,1.13E+06
5,3.5,2780,3583,3,8,2180,600,475000
4,3.25,3770,4103,5,9,2710,1060,1.45E+06
3,2.5,2590,7237,3,8,2590,0,620000
4,2,2060,5000,3,7,1030,1030,612500
2,1,1450,4750,3,7,850,600,210000
6,2,3560,5120,3,9,3560,0,835000
3,4,4200,30120,4,11,3600,600,2.23E+06
5,2.5,3890,27311,3,10,3890,0,1.10E+06
3,2.25,1580,920,3,8,1580,0,389950
3,1,1450,4000,4,8,950,500,525000
3,1.75,1150,6423,3,5,590,560,285000
5,2,2590,8610,4,7,1340,1250,480000
4,3.5,2380,5809,4,7,1750,630,413000
4,2.5,2640,25038,4,8,2640,0,657000
2,1,1300,11080,4,7,1300,0,425000
2,1,640,7768,3,6,640,0,165000
3,1.5,1600,7500,3,7,1600,0,405000
3,2.5,2650,11250,3,9,2650,0,660000
4,2.5,2320,7379,3,8,2320,0,316000
2,1,860,8250,3,7,860,0,345000
2,1.75,590,6138,2,5,590,0,156000
3,2.75,2180,7519,4,7,1310,870,568500
3,1.75,2120,10875,3,8,1540,580,578000
2,1,880,6900,3,6,880,0,190000
3,1.5,1840,10956,4,8,1840,0,525000
4,2.5,2800,21370,3,8,2800,0,515000
4,3.5,2710,2147,3,10,2220,490,690000
4,2.75,3330,9143,4,10,3330,0,1.10E+06
3,1.75,1490,5000,3,8,1250,240,565000
4,2.5,2080,5191,3,8,2080,0,601000
3,2.75,3010,206910,3,10,3010,0,750000
3,1,1250,4800,4,7,1250,0,340000
3,1.5,1470,18459,4,6,1470,0,169000
4,2.25,3070,8400,4,8,3070,0,600000
3,2.5,2320,7140,3,8,2320,0,308000
3,2.75,3060,13554,3,10,3060,0,864000
2,1,1640,17335,3,7,840,800,379500
4,2.25,1995,7102,4,8,1995,0,266000
2,1,620,6600,3,6,620,0,175000
3,2.25,1700,3333,3,7,1100,600,575000
2,1,920,5157,3,6,920,0,475000
3,1,1060,7246,4,6,1060,0,275500
5,2.75,2570,7260,3,8,2570,0,329000
3,1.75,1140,9628,4,7,1140,0,195000
3,2,1390,6005,3,8,1390,0,267000
4,2.75,4250,10925,3,10,4250,0,1.21E+06
5,3,2870,4369,3,8,2090,780,540000
3,2,1770,6000,3,7,1100,670,423500
2,1,1620,6120,3,7,1620,0,750000
3,1.5,1340,10224,4,7,1340,0,417000
2,1,1030,8786,3,6,1030,0,250000
3,1,970,11963,4,6,970,0,205950
2,2.5,2380,9374,3,8,2380,0,818000
4,2,1710,4178,4,8,1710,0,895000
5,2,2290,7125,3,7,1190,1100,580000
2,1,1200,9000,3,6,1200,0,179950
4,2.5,2370,41338,3,8,2370,0,597000
3,1,1100,4128,4,7,720,380,339000
3,1,1150,35415,4,7,1010,140,450000
4,2.5,1530,2248,3,7,1530,0,350000
4,2.5,2840,6284,3,9,2840,0,636230
4,2.25,1330,8400,3,8,1330,0,540000
3,1,1010,7903,3,6,1010,0,279000
4,1,2300,7680,3,7,1270,1030,372000
2,1,1060,8187,4,6,1060,0,254000
3,1.75,1640,7437,3,7,1090,550,556000
2,1,770,8149,5,6,770,0,275000
4,2,2120,6865,3,7,1060,1060,285000
3,2.5,2890,21780,3,8,2890,0,421000
3,2.5,2600,4438,3,7,2600,0,581000
3,1.75,1260,8400,3,7,1260,0,289000
3,1.75,1290,8688,4,7,1290,0,214946
4,3.5,3920,37122,3,10,3920,0,850000
3,2.25,2670,150270,3,9,2670,0,865000
3,2.5,2440,5750,3,9,1980,460,679900
4,3,3240,5562,3,10,3240,0,895000
3,1,1410,18600,5,7,1410,0,343000
4,1.75,1990,12950,4,8,1850,140,524400
6,2.5,2890,8122,3,8,1630,1260,502000
4,3.25,3160,8876,3,9,2460,700,558000
2,1,1510,11165,4,7,1510,0,549000
2,1,810,4080,4,6,810,0,325000
3,2.25,1840,8400,3,8,1290,550,472800
3,2.5,2160,9063,3,8,2160,0,530000
3,1.5,1330,9900,3,7,1330,0,400000
3,2.5,1600,2231,3,7,1600,0,214000
4,2,1980,10585,2,6,1980,0,239000
2,2,1670,4996,3,8,1670,0,554000
3,2.5,1970,4036,4,7,1970,0,432000
4,2.5,2590,7910,3,9,2590,0,570000
4,2,2190,4560,5,8,2190,0,980000
5,5.25,4830,18707,5,9,3930,900,1.68E+06
3,2,1810,7209,4,7,1240,570,260000
3,2.75,2390,9313,5,8,1390,1000,689800
4,2.5,2160,7826,4,7,1390,770,440000
3,2.5,2750,10000,3,8,1650,1100,895000
4,2.5,2580,4818,3,8,2580,0,379950
3,2.5,2140,2770,3,8,1770,370,636000
5,2.5,2490,7666,4,7,1490,1000,292000
3,1.75,1600,4888,3,6,1600,0,239950
4,2.25,3080,10487,4,9,3080,0,1.17E+06
3,2.25,4320,19225,4,10,2160,2160,1.78E+06
3,1.75,2240,8153,3,7,1120,1120,440000
4,2.5,2100,8501,5,7,2100,0,344000
2,2.25,2470,7658,4,8,1480,990,898000
3,3.5,2840,4468,3,10,2840,0,717550
2,1.5,1000,1251,3,7,930,70,377000
3,1.75,2060,58341,3,8,1100,960,510000
3,1.5,2010,9480,3,8,1570,440,429950
3,2.75,2870,6600,3,8,2870,0,755000
4,1,1640,3844,4,7,1460,180,325000
3,2.5,1580,6065,3,8,1580,0,485000
3,2.25,1940,6500,3,8,1440,500,219000
4,2.5,2240,12032,3,9,2240,0,592500
2,1.5,1820,7800,4,7,1240,580,460000
3,2.5,3030,30007,4,10,3030,0,766950
4,1.75,2190,5060,3,7,1190,1000,567500
3,2,1160,10079,3,7,1160,0,315500
3,1.75,1330,5000,4,7,1210,120,532500
4,1.5,2040,10488,3,7,1190,850,261000
3,1.75,1850,7735,4,8,1850,0,585000
4,2.5,1890,7867,3,8,1890,0,355000
4,2.75,2460,8643,3,9,2460,0,579950
2,1.5,1900,4450,5,7,1500,400,650000
4,2.5,1570,9600,3,7,800,770,365000
3,2.5,2160,4297,3,9,2160,0,520000
3,1,1290,47044,3,7,1150,140,450000
4,2.75,2750,14982,3,9,1720,1030,604700
2,1,750,34133,3,6,750,0,210000
2,1,860,7204,3,7,860,0,284000
2,2,1850,4667,3,8,1850,0,589000
4,2.5,2341,9594,3,9,2341,0,640000
3,1,1230,9600,3,7,1230,0,392000
3,2.5,1580,7000,3,8,1580,0,280000
1,1,740,5000,3,7,740,0,299000
3,2.5,2510,3819,3,8,2510,0,667000
3,1.75,1020,5000,5,6,1020,0,285000
3,2.5,2980,16996,3,10,2980,0,725000
2,1,870,6150,3,6,870,0,245000
3,3,1950,1983,3,9,1610,340,785000
3,2.25,2730,9388,3,7,1390,1340,345000
5,2,2050,10200,3,6,1430,620,475000
3,1,1010,6400,3,7,1010,0,185000
3,2.25,3330,15258,3,10,3330,0,762500
3,2,1300,8400,4,7,1300,0,251000
3,2.5,1860,5321,3,7,1860,0,326995
4,2.25,2530,5000,4,7,1690,840,734000
3,2.25,1860,8378,3,7,1860,0,350000
2,1,790,5120,3,6,790,0,375000
3,1.75,1300,12378,4,6,1300,0,380000
4,1.75,1630,8000,3,7,1630,0,215000
4,2,2660,8160,4,7,1380,1280,635000
2,1,1180,9261,4,7,940,240,343000
3,1,1240,4000,3,8,1240,0,400000
3,2,1200,2016,4,7,600,600,483500
4,2.5,1820,9161,4,7,1220,600,325000
3,2,1560,8853,3,7,1560,0,270000
3,1.75,1360,10573,4,7,1360,0,223000
4,2.5,2510,17200,4,9,1540,970,750000
3,2.25,1540,5338,5,7,770,770,539000
5,2,2880,12000,3,8,2880,0,780000
4,1.5,1880,6200,5,8,1440,440,680000
5,3.5,3490,21780,3,8,3490,0,830000
3,2.25,1330,969,3,7,1330,0,325000
3,2.5,3087,5002,3,8,3087,0,399950
4,3.5,3380,8098,5,9,1690,1690,860000
3,1.75,1530,10300,4,7,1530,0,370000
3,1.5,1790,4800,3,8,1790,0,940000
5,3.5,3630,8100,3,10,3630,0,1.56E+06
3,1.75,1480,8394,4,8,1480,0,450000
3,1,1210,33919,3,7,1210,0,290000
4,2.5,2490,5812,3,8,2490,0,344200
4,1.75,2020,6000,3,7,1620,400,397000
5,3.5,4010,6000,3,9,2560,1450,625000
3,1.5,1280,2114,3,8,1280,0,687500
2,2.75,2700,8572,3,9,2700,0,810000
4,3.75,4490,34982,3,12,4490,0,1.68E+06
3,1.75,1580,9147,4,7,1210,370,515000
4,1.75,2040,3570,4,7,1020,1020,495000
6,2.5,2590,10890,4,7,1340,1250,250000
3,1.75,1900,10454,3,7,1390,510,405000
2,1,1310,2814,3,6,810,500,299800
3,1,1450,6776,3,7,1450,0,150000
5,2.5,2430,6168,3,8,2430,0,502500
3,1,1030,4700,3,7,1030,0,365000
4,2.5,1900,4054,3,7,1900,0,299950
5,3,2750,3800,5,7,1750,1000,840000
3,3.25,2250,60548,3,9,2250,0,729000
3,2,3250,50529,4,8,3250,0,562000
3,1,2230,8163,3,7,1230,1000,235000
3,2.5,2950,6545,3,8,2950,0,482000
4,1,1520,80150,2,5,1520,0,365000
4,2.5,1900,21780,3,7,1900,0,212000
2,1,2320,11250,4,6,2320,0,360000
5,3.25,2920,6960,3,9,2120,800,1.54E+06
4,1.75,1350,9293,4,7,1350,0,626000
3,1.5,1120,6653,4,7,1120,0,425000
5,2.5,1970,12375,3,8,1570,400,575000
3,1.75,2160,4000,3,7,1080,1080,410000
2,1,630,4200,3,6,630,0,148000
3,2.5,2090,7640,3,7,1360,730,543000
4,3,3540,10202,3,8,2720,820,1.03E+06
4,3,2530,4560,3,7,1540,990,785950
5,3.25,3730,10626,4,10,3730,0,2.54E+06
3,2.25,1440,5150,3,7,1440,0,330000
3,1,1440,5623,4,6,720,720,420000
3,1.75,1840,5000,4,7,920,920,499000
3,1.75,1360,5445,4,7,1360,0,450000
4,2.25,2800,18673,5,9,1650,1150,940000
2,2.25,1700,2383,3,8,1700,0,472500
3,1,1440,54315,3,7,790,650,500000
3,1,1100,5700,3,7,1100,0,480000
5,3,4150,7500,5,11,3510,640,3.07E+06
4,2.5,2290,5515,3,8,2290,0,450000
3,1.75,1680,8629,3,8,1200,480,308000
2,2.25,1330,1380,3,8,1060,270,479000
3,1.75,1560,7245,3,7,1560,0,422500
6,3,1880,7200,4,7,1880,0,326000
3,1,1410,47916,3,7,1410,0,211000
3,2.5,1980,7800,3,8,1980,0,359950
4,3.25,1980,9988,3,8,1340,640,510000
3,2.5,2050,7205,3,8,2050,0,375000
3,2.5,2440,4800,3,10,2440,0,625000
3,2.25,3020,6000,3,8,1980,1040,439000
5,3,2140,5937,3,7,1280,860,367777
3,2.5,2860,4500,3,8,1980,880,1.23E+06
3,2.5,2240,3825,3,7,2240,0,676000
2,1.5,1430,1650,3,7,1430,0,297000
4,2.75,3630,15405,4,8,1850,1780,769000
3,1.75,1970,9512,3,8,1970,0,371000
4,2.5,2300,15188,4,7,2300,0,243500
4,2.5,3520,7815,3,10,3140,380,1.40E+06
3,2.75,3160,9072,3,9,3160,0,553000
5,4.5,4230,9701,3,10,4230,0,935000
4,2.25,1720,8300,4,8,1720,0,240000
3,1,1260,6000,4,6,1260,0,248000
4,2.25,2740,11343,5,10,1980,760,1.04E+06
3,2,2168,4000,3,8,2168,0,575000
3,1,1020,4960,3,6,920,100,219950
4,2.5,3000,5639,3,8,3000,0,759900
3,2.25,1700,8100,3,7,1200,500,245000
3,1.75,1330,9200,4,7,1330,0,183000
2,1,1370,5922,3,8,1130,240,703011
4,4.5,4240,13162,3,10,4240,0,2.19E+06
3,3,1820,1641,3,8,1540,280,625000
3,2.25,1500,7482,4,7,1210,290,290000
3,2.5,2140,2868,3,8,1770,370,666000
4,3.5,3040,8414,3,9,2420,620,684000
3,2,1530,3400,3,7,990,540,529000
5,3.75,3570,14648,3,9,3570,0,624000
4,2.75,1640,3000,3,7,1000,640,320000
3,2.25,1900,7250,3,7,1250,650,245000
3,1.5,2100,67269,4,7,1220,880,480000
3,2.25,1650,6250,3,7,1650,0,390000
3,1,1230,10350,4,7,1230,0,250000
4,1.75,2070,9120,4,7,1250,820,430000
3,1.5,1710,5120,4,7,1710,0,747000
2,2,2280,6815,3,8,2280,0,835000
3,3,4040,14338,3,10,3030,1010,950000
3,2,1790,11430,3,7,1190,600,525000
3,3.5,3470,4171,3,9,3470,0,834800
4,2.5,2640,7883,3,8,2640,0,359000
3,2.5,2000,9669,4,8,2000,0,324360
4,2.5,4060,8547,3,9,2790,1270,495000
4,2,1800,13551,4,7,1800,0,305000
3,2.5,1980,7807,4,9,1980,0,775000
3,1,1030,24750,3,5,1030,0,249000
4,2.5,3160,4620,3,9,2020,1140,1.28E+06
4,1.75,2250,292288,4,7,2250,0,411000
4,2.75,2910,10650,3,8,1780,1130,590000
4,2,1550,4815,3,7,1550,0,613000
3,2.5,1560,9361,4,7,1360,200,545500
3,2.5,1790,11542,5,7,1190,600,416000
3,3.5,1790,1682,3,7,1480,310,246950
3,1,970,9600,3,7,970,0,242000
2,2.5,2510,17986,3,9,2510,0,811000
4,2.5,1914,3272,3,8,1914,0,300000
4,2.5,2640,10720,3,8,2640,0,377500
3,1.5,1710,4000,3,8,1710,0,675000
4,2.25,2100,12172,5,9,2100,0,1.08E+06
3,2.25,1490,9414,3,7,1490,0,525000
4,2,1570,9600,3,6,1570,0,171800
4,2.5,1910,10300,3,8,1910,0,458400
5,3.75,3360,6000,3,8,2640,720,725000
3,2,1760,11410,5,7,1060,700,317000
4,2.75,2960,5040,3,9,2210,750,857500
3,1,1870,4984,3,7,1120,750,499950
3,1.75,1170,8148,3,7,1170,0,399000
4,1.75,1980,10800,5,6,990,990,711000
5,4.25,4230,6907,3,10,3450,780,1.40E+06
5,2.75,2590,6120,3,8,2590,0,961000
3,2,1420,6060,5,7,830,590,340000
4,2.5,1980,6566,3,8,1980,0,332000
2,1,1100,7680,4,7,1100,0,300000
3,2.5,1720,11656,3,8,1720,0,540000
3,1,1000,12070,4,7,1000,0,204000
3,1.75,1410,9150,5,7,1410,0,365000
4,1,1330,9715,4,7,970,360,458450
3,2.25,3100,11985,4,7,1790,1310,302500
2,1,1750,60872,4,7,1180,570,650100
4,2.75,2730,35075,3,8,1530,1200,575000
4,2.5,2980,4074,3,8,2980,0,480000
2,2.25,1200,1137,3,7,1200,0,445000
3,3,3700,16857,3,10,2170,1530,1.10E+06
3,2.25,1130,1221,3,8,1030,100,437000
4,2.75,2030,8600,4,7,1230,800,305000
3,1,950,4760,3,6,950,0,300000
4,3,3350,199253,3,10,3350,0,700000
1,1.5,1180,1688,3,8,1070,110,250000
3,1,970,7790,3,6,970,0,219000
4,2.75,2720,4613,3,9,2720,0,594000
4,2.5,2530,6500,3,8,1720,810,650000
4,2,2020,8100,4,7,1160,860,370000
3,1.75,1890,9100,4,7,1890,0,359950
3,1.75,2340,6750,5,7,1620,720,645000
3,1.75,2080,12714,4,8,1540,540,436800
3,1.75,1790,9860,4,7,1410,380,539000
3,2.25,2100,8163,3,7,2100,0,299900
4,1,1140,5940,3,7,1140,0,569950
4,2.5,2650,9301,3,9,2650,0,429000
3,1,970,7742,4,6,970,0,219900
3,3.5,2150,4368,3,8,1610,540,500000
4,2.5,2100,3125,3,7,1400,700,595000
4,3,2420,12000,3,9,2420,0,725000
3,2.25,1620,4500,4,8,1620,0,800000
2,1,1770,5522,4,7,960,810,243000
3,2.5,3240,33151,3,10,3240,0,604000
4,3,1490,6766,5,7,1490,0,570000
3,1,1710,5992,4,7,1560,150,650000
4,1.75,1750,18810,3,7,1220,530,360000
3,2.5,1230,922,3,8,1080,150,399950
4,2.75,3610,8580,3,9,3610,0,982000
3,1,1010,11244,4,7,1010,0,350000
4,2,2530,10800,5,8,1350,1180,880000
2,1,1240,6400,4,7,1060,180,559000
4,2.5,2240,4648,3,7,2240,0,287000
2,1,790,7095,3,6,790,0,159100
4,2,1610,6200,4,7,1610,0,243500
1,1,2880,7560,3,7,1440,1440,550000
4,1.75,2430,9747,3,8,1780,650,459950
3,1.75,2170,10018,4,7,1630,540,260000
5,2.25,2460,8710,4,8,1330,1130,599000
3,1,1200,12500,3,6,1200,0,204000
4,2.5,1940,5414,3,8,1940,0,420000
2,1,1110,6000,3,7,1010,100,585000
2,1,670,6720,5,6,670,0,304950
3,2.25,1270,1406,3,8,1060,210,594000
2,1,1550,7713,3,7,1550,0,599000
4,2.5,4500,35200,3,13,4500,0,2.34E+06
3,1,1140,5000,3,7,1140,0,276000
3,2.5,2200,4544,3,8,2200,0,525000
5,2.25,3270,16553,5,9,2470,800,1.18E+06
4,2.75,3200,13729,3,11,3200,0,1.27E+06
3,1,1740,4800,3,8,1740,0,430000
2,1,950,6000,3,7,950,0,492000
3,1,2160,11484,4,7,2160,0,453000
1,1,670,1800,5,6,670,0,435000
4,2.5,1980,7403,3,7,1980,0,243500
3,1,1410,7854,4,7,1410,0,380500
4,1,1640,8467,4,6,1220,420,261490
4,2.75,2550,8632,3,8,1700,850,691000
5,3,2970,7261,3,9,2970,0,726888
3,2.5,1530,9406,3,7,1270,260,332000
5,3,3690,49709,3,9,2690,1000,575000
4,2.5,2490,40608,3,9,2490,0,635000
3,2.5,2230,8296,3,7,2230,0,385000
3,1.75,1680,6108,3,8,1680,0,366000
3,2.5,2340,8414,3,7,1280,1060,345000
4,1,1640,10455,3,7,950,690,218000
2,2.25,1240,720,3,7,1150,90,331000
3,2.5,2110,4038,4,8,2110,0,355000
3,1.75,1370,9900,4,7,1370,0,320000
3,2.5,2160,10200,3,7,1360,800,405000
2,1.75,800,4800,4,6,800,0,388000
4,2.5,2190,6896,3,7,2190,0,452000
3,3.25,2940,5432,4,10,2440,500,1.71E+06
4,2.5,2570,27972,3,8,2570,0,635000
5,3,3640,28531,3,10,3640,0,1.20E+06
4,2.5,2230,3600,5,8,1630,600,1.00E+06
2,1,840,4200,3,5,840,0,208417
3,1.75,1470,7590,3,7,1470,0,449950
4,2.5,3090,18645,3,9,3090,0,370000
3,2,1430,4200,4,7,830,600,345000
4,2.5,3100,36562,3,10,3100,0,700000
4,2.25,2000,8068,5,8,2000,0,710000
4,2.5,2090,6906,4,8,2090,0,601000
2,1.5,1860,5100,3,7,1060,800,510000
4,1.75,1580,9382,3,7,1080,500,787500
3,1.5,2680,4775,5,8,1880,800,1.36E+06
3,2,2400,217800,3,8,1590,810,608000
4,2.75,2450,4187,3,8,2450,0,735000
3,2.5,1790,6452,3,7,1790,0,315000
3,2,1080,9225,2,7,1080,0,147400
4,3.5,2340,2810,3,8,1730,610,735000
3,1.5,1700,8050,3,7,1130,570,950000
4,1.5,1800,8786,3,7,1330,470,272750
4,3.25,3180,194278,3,10,3180,0,890000
2,1.75,1270,7800,4,7,890,380,299000
3,1,1560,3825,3,8,1390,170,900000
3,2.5,1805,3402,3,7,1805,0,266000
2,2.5,1470,690,3,8,1470,0,650000
2,1,1100,4160,3,7,1100,0,625000
3,2.5,2190,4882,3,9,2190,0,503000
4,2.75,2400,12469,4,8,1760,640,839000
5,3.5,3530,218472,3,7,2380,1150,487500
3,1.75,1750,3250,4,7,1230,520,524950
3,2.25,1840,13020,3,8,1390,450,403000
2,1,540,2500,3,5,540,0,425000
2,1,870,5689,4,7,870,0,365000
4,2.5,2120,3720,3,8,2120,0,615000
2,1.75,1290,1624,3,8,1290,0,258800
4,2,2020,7767,3,8,2020,0,315000
5,2.25,1970,15247,3,7,1450,520,435000
4,2.5,3570,17411,3,10,3570,0,965000
4,3.5,3320,8808,3,9,3320,0,786000
4,2.5,2040,5875,3,8,2040,0,345000
4,2.25,2070,8720,5,8,1360,710,645000
3,2.75,3640,10300,4,9,2060,1580,925000
4,2,2220,23750,3,7,2220,0,532500
4,3,2580,9601,4,7,2130,450,355000
4,2.5,4290,175421,3,10,4290,0,792500
5,1.75,2020,5100,5,7,1320,700,475000
4,1.5,2430,4995,4,7,1730,700,580000
3,1.75,1620,9600,4,7,1620,0,314000
2,1.75,2120,7680,5,6,1130,990,530000
3,3,2520,2152,3,8,1560,960,780000
3,1.75,1410,4080,4,7,1000,410,600000
4,1.5,2000,6778,4,7,1170,830,284950
2,3,1650,960,3,8,1350,300,559000
5,3.5,3931,9497,3,10,2650,1281,450000
4,2.25,3070,13720,3,9,3070,0,858000
2,2,1440,9985,3,8,1440,0,457000
3,1,1200,8316,4,6,1200,0,190000
2,1,840,7870,3,6,840,0,251000
2,1,850,8400,4,6,850,0,320000
2,1.5,1640,4080,5,7,1540,100,710000
4,2.5,2940,10382,4,9,2940,0,752000
5,2.25,1750,5000,3,8,960,790,758800
4,2.5,2390,5800,3,9,2390,0,647000
2,1,1320,6135,4,7,880,440,369000
3,3.5,4660,5500,5,10,3040,1620,2.15E+06
3,1,1370,5250,3,7,1070,300,655000
3,3.25,1290,1153,3,7,1290,0,331000
5,2.25,2300,11505,3,8,1300,1000,298950
3,1.75,1690,3449,3,7,1690,0,289000
3,2.25,1830,7943,3,8,1830,0,448500
3,3,1440,1350,3,8,1440,0,435000
5,2.75,2790,7600,4,7,2790,0,359900
3,2.25,1640,7261,3,7,1640,0,349000
5,2.75,2160,5720,5,7,1500,660,550000
3,1.75,1340,3900,5,7,1340,0,635000
4,2.25,2350,46173,4,8,2350,0,635000
3,1.5,1110,5500,3,6,1110,0,375000
2,1,1170,3000,3,7,1170,0,527500
4,3.25,4400,262666,3,11,4400,0,1.15E+06
3,2.5,3180,10492,3,10,3180,0,1.00E+06
2,1,900,2728,3,7,900,0,290000
5,1.5,1940,10202,4,7,1940,0,540000
3,1,1190,8820,3,6,1190,0,166950
5,3.5,3190,4247,3,8,2430,760,780000
2,1,1030,4366,3,7,1030,0,410000
5,3.5,3600,9312,3,10,2680,920,817500
3,1.5,1690,161913,2,7,1430,260,370000
5,3.25,5620,12672,4,11,4140,1480,2.50E+06
4,2.5,2500,4500,3,7,2500,0,475000
3,1.75,1340,13241,3,7,1340,0,427800
5,3.5,3060,8862,3,8,3060,0,605000
5,2.25,3550,7992,3,8,3550,0,575000
3,1.5,1480,2700,3,7,1480,0,856000
3,1.75,1480,7500,4,7,1480,0,315000
5,2.5,3450,35880,3,11,3450,0,950000
2,1.75,1820,8409,4,6,910,910,345000
3,1.5,2120,41325,4,7,1420,700,325000
2,1,870,8400,3,7,870,0,240000
4,2.5,2390,4200,3,9,2150,240,1.20E+06
3,2.5,1690,6642,3,7,1690,0,467000
4,1.75,2140,11651,3,8,2140,0,340000
4,2.25,2170,8240,4,8,2170,0,648000
4,2.75,3550,9400,3,9,3550,0,659950
2,1.25,860,1277,3,7,860,0,321950
4,2,1650,7552,4,7,860,790,360000
3,2.5,1520,5649,4,7,1520,0,375000
4,2.5,2620,8331,3,9,2620,0,460000
3,2.5,2300,7800,3,9,2300,0,737000
4,2.5,2750,8471,3,7,2750,0,418000
2,1,800,17965,4,5,800,0,230000
3,1.75,1500,7367,3,8,1500,0,529000
3,2.5,2390,8315,4,9,2390,0,640000
5,3.25,3490,23400,4,8,1890,1600,610000
3,2,1590,8670,3,7,1590,0,255000
4,3.5,3470,7396,3,8,2520,950,810000
4,2.5,2850,4650,3,8,2850,0,360000
4,1,1070,7467,3,7,1070,0,200000
2,1,700,5940,3,7,700,0,282150
2,1,2140,6000,4,7,1070,1070,680000
3,1.75,2880,18296,3,8,1580,1300,285000
3,2.5,1720,8550,4,7,1720,0,270000
3,2.25,1850,7151,3,7,1850,0,255000
2,1.25,1230,1569,3,9,1050,180,540000
3,2.5,2370,5321,3,8,2370,0,398096
4,1.5,1430,6380,4,7,1130,300,525000
3,1,1980,3243,3,8,1980,0,796000
3,1.75,1510,11234,3,7,1210,300,279950
4,2.5,2410,7069,3,9,2410,0,635000
3,1.75,1210,7500,3,7,1210,0,460000
3,3.5,3010,5717,3,10,3010,0,848000
3,2.25,1340,4080,3,6,1170,170,330000
4,3.5,3960,6654,3,10,2850,1110,1.20E+06
5,4,3310,8400,3,10,3310,0,1.65E+06
4,2.5,2430,11870,5,8,1590,840,605000
4,2.25,2380,4876,4,9,2240,140,875000
3,1.5,1800,4700,3,7,1200,600,607500
3,1.5,1060,9039,3,7,1060,0,255000
3,2,1590,5009,4,6,1590,0,463000
4,2.5,2670,20894,3,9,2330,340,405000
4,2.5,2180,11132,4,8,1620,560,275000
4,2,1880,5100,3,8,1880,0,453000
3,1.75,1310,9645,3,7,1310,0,242000
3,1,1220,3400,3,7,1060,160,500000
3,4,4160,31796,3,11,4160,0,1.11E+06
3,1,1040,9750,3,7,1040,0,217500
3,2.5,1860,415126,3,7,1860,0,472000
3,2.75,2450,5750,3,9,2450,0,605000
5,3.25,3620,4650,3,8,2790,830,394000
3,2,1090,7350,4,7,1090,0,219000
4,2.25,2130,8410,4,8,2130,0,671500
5,4.25,4650,108464,3,10,3260,1390,985000
3,1.75,1516,2897,3,7,998,518,575575
4,1.75,2400,10050,5,8,2400,0,635000
4,2,2580,6000,5,9,1300,1280,1.10E+06
4,2.5,2730,9260,3,8,2730,0,620000
4,2.25,2320,7350,3,8,2320,0,345000
4,2.25,2070,8893,4,8,2070,0,365000
2,1,1100,6240,4,7,1100,0,570000
3,1.75,1680,6200,3,7,1680,0,545000
4,2.5,3190,4980,3,9,3190,0,419000
6,2.75,3360,84506,5,7,2040,1320,735000
3,1.75,1790,50529,5,7,1090,700,349000
3,2.5,3350,7752,3,9,2180,1170,1.30E+06
3,2.75,2360,16117,4,8,1710,650,691100
5,2.25,1980,13132,4,7,1260,720,307700
3,1,1130,9147,5,7,1130,0,426000
1,1,1370,6250,4,7,1370,0,565000
3,2.5,1770,5000,3,7,1770,0,255500
3,2.5,2880,13500,5,8,1520,1360,1.99E+06
3,2.25,1840,9781,3,7,1840,0,334000
4,3.5,3190,6000,4,9,2410,780,1.25E+06
4,2.5,2340,52272,2,8,2340,0,290000
3,1.75,1320,10454,4,7,1320,0,249950
3,1.5,1020,10152,5,6,1020,0,165000
3,1.75,2190,8500,4,9,2190,0,1.57E+06
3,2.5,1740,4145,3,7,1740,0,385000
3,3.5,3870,3819,3,11,2760,1110,1.44E+06
3,2.5,1365,1090,3,7,1315,50,530000
3,2.25,1646,9519,3,7,1646,0,305000
4,2.75,2200,5207,5,7,1120,1080,370000
3,1.5,2220,8994,4,8,1110,1110,500000
3,2.5,2060,11231,3,8,2060,0,440000
4,2.5,3030,12590,4,10,3030,0,1.05E+06
3,2.5,1870,6821,3,7,1870,0,275000
3,2.5,1060,1536,3,8,1060,0,415000
3,2.5,2190,3600,3,9,2190,0,650000
3,2,1420,1369,3,9,1340,80,550000
3,1.75,1330,12618,3,7,1330,0,265000
3,2,1590,5200,3,7,1320,270,720000
3,2.5,2720,6014,3,7,2720,0,299900
3,3.25,4330,14600,3,10,3630,700,722800
3,2,1060,1184,3,7,730,330,346000
5,3,3230,5167,4,8,2000,1230,729953
3,2,1640,9825,4,7,1090,550,455000
3,2.75,2930,5569,3,9,1860,1070,559900
4,2.5,1890,6156,3,7,980,910,325000
3,1.75,1350,7200,5,7,1350,0,450000
2,1,1230,2726,3,7,880,350,575000
3,0.75,1110,3960,3,7,1110,0,413252
2,1,1550,15250,5,7,1550,0,260000
4,1.75,3280,35160,3,7,2080,1200,605000
4,2.5,3620,42580,3,10,3620,0,900000
3,1,1200,8514,3,7,1200,0,165050
3,2.5,3260,91911,4,9,3260,0,850000
3,2.5,2820,14890,3,9,1770,1050,853505
4,1.75,2180,4431,3,8,2020,160,625000
5,3.5,2760,3865,3,8,2760,0,424950
3,2.5,1740,4497,3,7,1740,0,299950
3,1,1480,17360,3,8,1480,0,600000
2,0.75,650,5360,4,5,650,0,230000
2,1,830,7590,2,6,830,0,110000
2,1,860,8511,3,7,860,0,353000
5,3.25,3920,4832,3,9,3030,890,616200
3,1.75,1670,5100,5,7,990,680,615000
3,1.75,2100,5000,3,8,2100,0,700000
3,1.75,1490,3840,3,8,1490,0,835000
3,2.5,2260,5100,3,8,2260,0,435000
4,1,1070,5750,3,6,870,200,400800
3,2.5,2130,5088,3,8,1840,290,395000
3,2.25,1200,1400,3,8,1200,0,320000
4,2.75,2530,14178,3,8,2530,0,469950
3,2.5,1940,9775,3,8,1440,500,545000
4,2.5,2480,4334,3,8,2480,0,399000
3,2.25,1310,12825,3,7,1310,0,291750
3,2.25,2380,6000,3,8,2040,340,490000
4,3.75,7620,29536,3,11,5980,1640,1.68E+06
3,1.75,2060,12558,4,7,1350,710,625000
4,2.5,2070,2992,3,8,2070,0,364950
4,2.5,2400,7292,3,8,1530,870,415000
5,3.25,3410,9088,3,9,2760,650,2.40E+06
3,2.25,2540,9961,4,8,1320,1220,299000
2,1,1200,6278,3,7,1080,120,486700
3,2.25,2510,9900,3,8,1610,900,267000
4,2.5,2400,7693,3,8,2400,0,450000
5,3.5,3400,9804,3,9,2550,850,970000
3,2.25,1570,8111,3,8,1570,0,485000
4,2.25,1780,2684,3,7,1780,0,435000
3,1.75,1710,9707,4,8,1710,0,522500
4,3.5,3370,3634,3,9,2750,620,812000
3,2.5,2460,12600,4,8,1810,650,405000
3,2.5,2390,6550,4,8,1440,950,750000
3,2.5,1680,934,3,8,1680,0,558000
3,2,1360,8752,4,6,1360,0,763000
3,3.25,1740,1693,3,8,1360,380,470000
3,2.25,1960,10385,3,8,1960,0,613000
3,2,2170,3978,5,7,1340,830,330000
2,2.25,1230,1280,3,8,960,270,387000
3,1.75,2310,7620,3,8,2310,0,588000
4,2.5,2960,223462,3,10,2960,0,472500
4,2.5,1900,3301,3,7,1900,0,335000
3,2.5,2630,10047,3,9,2630,0,665000
2,2.25,1240,705,3,7,1150,90,315000
5,3.5,4370,12240,3,11,3270,1100,1.50E+06
4,2.5,1710,9627,3,9,1440,270,749000
4,1.75,1970,8390,3,7,1140,830,265000
4,1.75,2410,8400,3,7,1600,810,432000
5,2.25,3480,9200,3,8,3480,0,860000
4,1.5,1710,4600,3,7,1710,0,495800
4,2.5,3140,11049,3,10,3140,0,990000
3,2.25,2240,6450,3,7,1440,800,527000
3,1,1260,8910,4,7,1260,0,445000
4,1.75,2360,7620,4,7,1180,1180,385000
4,1.75,1660,3800,3,7,1660,0,619000
3,2.5,3560,8297,4,8,1650,1910,756000
4,1.75,1870,7575,3,7,1480,390,348500
2,1,730,2600,4,6,730,0,465000
4,2.5,1940,3864,3,8,1940,0,390000
2,1.5,1280,11071,3,7,850,430,386500
4,2,2260,10800,3,9,2260,0,685000
3,2.75,2600,64626,3,8,2600,0,415000
4,2.5,2830,14538,3,8,2830,0,695000
3,1.75,1410,6886,3,7,1410,0,465000
3,2,2190,19800,3,7,2190,0,464950
3,1.5,1100,1751,3,8,940,160,375000
2,1,820,4320,3,5,820,0,102500
3,1.5,1900,7584,5,7,1900,0,335000
3,2,1230,7789,3,7,1230,0,278000
4,2.5,2110,35091,4,8,1290,820,460000
4,2.5,2267,3577,3,7,2267,0,306000
3,1,1220,8040,3,7,1220,0,467000
3,1.5,1460,11407,3,7,1460,0,381000
3,1.75,1500,8352,5,6,750,750,300000
3,2.5,2840,6854,3,9,2840,0,751000
4,3.5,3110,108464,4,8,3110,0,875000
4,1.75,1650,7276,3,7,1010,640,260000
3,1.75,1180,10541,4,7,940,240,385000
3,1.5,1370,11400,3,7,1370,0,280000
3,2.5,3630,9475,3,11,3630,0,964000
3,3,2290,15600,3,8,1420,870,465000
5,2,2620,7030,3,8,1420,1200,399000
4,2.75,3110,35235,4,9,3110,0,749950
4,2.5,3360,7685,3,9,3360,0,455000
5,3.75,3700,7920,3,9,2900,800,1.40E+06
2,1,770,7434,3,6,770,0,264950
3,2.5,1870,4060,3,7,1870,0,285000
3,3.25,3050,12700,3,8,2240,810,585000
3,2.25,1760,11946,3,8,1760,0,500000
5,2.25,1700,13500,4,7,1700,0,347950
5,3.25,3990,13087,3,9,2400,1590,649000
4,3.25,3380,7500,3,7,2420,960,328000
4,2.75,2530,11549,3,7,1700,830,525000
3,1,1360,6186,4,6,760,600,255544
4,2,1810,42981,4,7,1810,0,295000
2,1,1580,2199,3,8,1580,0,720000
4,1,1190,7620,3,6,1190,0,312000
5,2.75,3380,8179,3,9,3380,0,600000
4,2.5,3000,5471,3,8,3000,0,540000
2,1,1140,5250,4,6,1140,0,329950
3,2.5,1820,11012,3,8,1820,0,505000
2,1,890,4730,3,7,890,0,587750
3,0.75,490,38500,4,5,490,0,150000
5,3,2840,6240,5,9,2440,400,1.43E+06
3,1.75,2700,18246,4,7,1510,1190,381000
2,1.75,2220,33000,4,8,2220,0,494950
4,1.75,2300,13342,3,7,2300,0,1.34E+06
4,2.75,2390,9300,3,8,1430,960,770126
4,2.75,2520,12500,3,8,1720,800,508500
3,1.75,1410,15210,3,7,1410,0,404000
4,2.5,3160,16564,3,10,3160,0,795000
3,1.5,1410,9000,3,7,1410,0,275000
6,3,3840,14040,3,8,2460,1380,612000
5,3.25,3710,34200,3,8,2510,1200,635000
3,1,1130,8159,4,7,1130,0,411500
3,2,1640,4875,4,7,1040,600,231000
4,1,1290,5000,3,7,1290,0,275500
3,2,1760,7147,4,6,880,880,287500
5,2.75,1940,4182,3,7,1240,700,345000
4,3.5,3560,7178,3,10,2590,970,833000
3,1.75,1570,6500,3,7,920,650,550000
4,2.5,1770,6666,3,7,1770,0,309950
3,2.25,1780,9720,3,8,1280,500,292000
4,2.25,2470,7698,3,8,2470,0,359900
3,2.5,1650,5994,4,7,1650,0,273000
3,2.5,2330,3610,3,8,2330,0,473975
3,2.5,1730,1803,3,7,1730,0,187000
4,2.5,3060,7710,3,9,3060,0,588000
3,1,1050,5402,4,7,1050,0,339950
4,2.5,2360,15008,3,9,1920,440,535000
3,1,1250,8450,4,7,1250,0,333000
4,3.25,5180,49936,4,10,5180,0,1.24E+06
4,2,1760,5307,4,7,1170,590,625000
4,1.5,1730,7700,4,7,1010,720,317500
4,1.75,1730,6500,3,7,1250,480,700000
4,2.5,2430,6099,5,8,1470,960,760000
3,1,1350,92721,2,6,1200,150,450000
3,2.5,1440,2163,3,7,1440,0,405000
2,1,1160,17700,3,7,1160,0,425000
2,1.5,1490,4080,3,7,930,560,389250
4,2.25,2110,6375,4,8,1600,510,925000
2,1,770,9370,3,7,770,0,180000
4,2.5,3020,8302,4,10,3020,0,490000
5,2.5,2200,4942,3,8,2200,0,495000
3,2.5,1760,5390,3,8,1760,0,382495
3,2.5,2410,4293,3,7,2410,0,450000
3,2,3000,17800,3,8,1500,1500,400000
4,3.5,4370,8510,3,10,3610,760,1.97E+06
3,2.5,1730,6930,3,8,1730,0,258000
4,2.75,2640,4000,5,8,1730,910,895000
5,2.5,2350,4000,3,9,2350,0,910000
4,2,1820,9350,4,8,1820,0,519900
3,1,910,7686,3,7,910,0,169000
2,1,670,11505,3,5,670,0,390000
4,2.5,2750,11830,3,9,2750,0,627000
3,1.75,1660,9697,4,7,1660,0,449000
5,2,2400,9537,5,7,1210,1190,390000
3,2.75,3940,9671,5,9,2140,1800,1.45E+06
3,1,1280,8712,4,7,1280,0,216000
3,1.75,1160,5082,3,6,580,580,137900
2,1.75,1340,1368,3,7,1060,280,520000
6,3,3510,5760,4,10,3510,0,1.75E+06
4,2.5,3160,6540,3,8,1580,1580,452100
2,1,740,6550,4,5,740,0,202000
5,3.5,4280,6530,3,10,4280,0,1.14E+06
5,2.75,3250,8100,3,8,3250,0,718000
4,1,1360,5900,4,7,1360,0,329950
2,1,1000,6227,3,6,1000,0,200000
4,2.75,2340,6350,4,7,1310,1030,645000
2,2,1070,635,3,9,720,350,256950
4,1,1370,7140,3,6,1370,0,387500
3,1.5,2420,5000,4,8,2200,220,870000
4,2.25,1910,8400,3,7,1910,0,435000
3,2.5,2120,7201,3,8,2120,0,507000
3,1.75,1460,8372,4,7,1460,0,225000
4,1,1970,4740,3,7,1670,300,410000
3,1,1150,3090,3,6,1150,0,260000
4,2.5,2540,4241,3,8,2540,0,717000
2,2.5,1090,923,3,7,1090,0,310000
3,1,1180,2250,3,7,1180,0,490000
3,1.75,1590,7617,3,7,1590,0,210000
2,1,820,6771,4,6,820,0,260000
4,2.25,1830,7614,3,7,1830,0,240000
3,1,1340,4800,4,5,1340,0,225000
4,2.5,3380,27589,3,10,3380,0,1.43E+06
3,1,910,6630,4,6,910,0,245000
3,2,1530,5401,4,7,1530,0,570000
3,2.25,1230,1380,3,8,1230,0,549000
2,2.5,1790,5400,4,8,1790,0,405000
4,3,3640,5096,3,8,2740,900,630000
3,2.5,1570,6932,3,7,1570,0,295000
4,2.5,2740,16007,3,9,2740,0,1.23E+06
5,1.75,1720,14040,4,8,1150,570,449000
4,2.5,3010,5701,3,8,3010,0,359950
3,2.5,2680,43995,3,9,2680,0,600000
3,2.25,1890,8400,3,8,1520,370,425000
3,2.5,2390,15084,3,8,2390,0,790000
2,1,740,4275,5,6,740,0,392800
3,2,1060,5750,3,7,1060,0,315000
2,1.5,1240,1101,3,8,1080,160,403000
3,2,1560,1156,3,8,1560,0,500000
3,2.5,2270,7917,3,8,2270,0,340000
4,1.75,1530,17664,3,7,1530,0,302000
3,2.25,1530,6600,4,7,1240,290,337500
3,1.75,1730,7200,4,6,1730,0,226450
4,2.5,2154,4153,3,9,2154,0,390000
3,1,1610,5500,3,7,1610,0,440000
4,2.25,2310,7490,3,8,2310,0,320000
3,2.25,1860,12000,4,7,1860,0,267500
4,2.5,2640,7388,3,7,2640,0,360000
3,1.75,1730,7416,3,7,1730,0,355000
4,1.5,1770,6650,3,7,1770,0,375000
3,1.75,1340,63597,4,7,1340,0,415000
3,2.5,1256,1154,3,7,1256,0,316750
3,2.5,1740,1308,3,8,1740,0,568000
3,1.5,1220,7300,3,7,1220,0,175000
3,2,1700,11475,5,6,970,730,225000
3,2.5,1470,3000,3,7,930,540,435000
3,2.5,1600,2042,3,8,1600,0,375000
4,2,2180,10447,4,8,1280,900,419000
3,2.5,1730,4408,3,8,1730,0,445000
4,2.75,2150,16728,4,8,1240,910,607000
3,1.75,1920,11340,4,7,1230,690,324500
5,3.5,2473,9282,5,7,2473,0,343000
3,1.75,1070,7754,3,6,1070,0,152000
2,2,1610,17600,3,6,1610,0,290900
3,1.75,1510,8301,3,7,1510,0,366000
6,5,2850,6600,3,7,2850,0,655000
5,4,3460,5400,3,10,2830,630,980000
2,2.25,930,747,3,8,630,300,355000
3,3.5,2300,5611,3,8,2300,0,675000
3,3,2900,11769,3,10,2900,0,799950
4,3.25,4250,12281,3,12,3020,1230,1.62E+06
5,1.75,1880,10000,3,7,960,920,405000
4,2,2720,8819,3,8,2240,480,560000
5,2.5,2220,9360,4,7,1110,1110,299000
4,3.5,2860,2199,3,10,2860,0,1.45E+06
4,2.5,2150,5000,3,8,2150,0,580000
2,1,1130,6908,3,6,1130,0,325000
3,3.5,1630,1329,3,9,1360,270,507200
4,2.5,3210,8938,3,10,3210,0,750000
3,2.5,2600,23361,3,8,2150,450,540000
4,2,1680,3813,4,7,1680,0,500000
4,3,1900,7194,4,7,1900,0,285000
1,1,790,12000,3,6,790,0,248000
3,2.25,1810,7630,4,7,1810,0,280000
4,2.25,2300,7524,4,8,2300,0,263850
3,1,1100,5132,3,6,840,260,280000
4,3.5,4420,20759,3,11,4420,0,2.33E+06
3,1,1230,7492,3,7,1230,0,320000
4,2.75,2090,8064,5,7,2090,0,710000
4,1.75,1940,13370,4,8,1940,0,252000
5,2.5,2700,16570,4,8,1750,950,744500
2,0.75,1160,15029,4,6,870,290,405000
3,2.75,1580,4007,3,7,1580,0,325000
4,3,2860,10292,4,8,2860,0,1.32E+06
3,1,1610,5100,5,7,1010,600,535610
2,1,820,8423,3,6,820,0,265000
4,1.75,2600,41041,4,8,2600,0,1.02E+06
3,2,1740,41275,3,8,1740,0,665000
3,2.5,2260,74297,3,9,2260,0,418200
4,2.75,2950,5803,3,9,2950,0,600000
2,1.5,840,867,3,7,840,0,270000
3,2.25,1660,10247,5,7,1130,530,450000
4,1.5,1310,137214,4,7,1310,0,320000
3,1,1020,6120,4,7,1020,0,208000
4,2.75,2660,4500,5,8,1860,800,765000
3,2.25,1190,1149,3,8,1050,140,400000
3,1.5,2390,4452,3,9,1790,600,790000
3,1.5,1180,7700,4,7,1180,0,390000
5,3,2370,6000,3,8,1340,1030,770000
3,1.75,1310,18400,3,7,870,440,234500
4,3.25,4830,22257,4,11,4830,0,3.64E+06
6,3,2020,4129,3,7,1230,790,599950
3,1.75,1470,6550,3,7,1070,400,525000
3,2.25,1580,4379,4,8,1580,0,500000
3,2.5,2360,6699,3,7,2360,0,430000
6,4.75,5770,16747,3,12,4500,1270,1.68E+06
5,3,2270,5001,3,7,1360,910,310000
3,2,1570,7200,4,7,1570,0,335000
4,2,1640,6000,4,9,1640,0,735000
2,1.5,1020,1525,3,7,1020,0,212000
3,2.5,2170,8140,3,9,2170,0,389950
6,4,5310,12741,3,10,3600,1710,1.05E+06
3,1,1520,7200,3,7,1030,490,226000
3,2.5,2180,7169,3,8,2180,0,560000
3,1,1210,5750,4,7,1210,0,440000
4,1.5,1690,11054,4,5,1690,0,235000
3,1,1030,6600,3,7,1030,0,175000
3,1.75,2140,13260,3,7,1240,900,340000
3,1.75,1740,8424,5,7,1040,700,364500
2,1.5,1390,1756,3,7,1390,0,299950
4,1.75,1770,9375,4,7,1170,600,507000
4,2.5,3240,13044,4,9,3240,0,1.20E+06
3,2.5,3820,35016,4,9,3820,0,775000
3,2.5,2640,432036,3,10,2640,0,790000
3,1,1130,4100,3,7,990,140,400000
4,2.75,2300,12633,3,9,2300,0,623000
5,2.5,1660,4000,5,8,1660,0,780000
2,1,750,7000,3,6,750,0,258000
3,2,1650,6000,3,7,1650,0,241000
3,1,890,5965,3,7,890,0,328000
3,1.75,1820,32666,4,7,1820,0,265000
3,2.25,1280,1187,3,8,1080,200,539000
3,2.25,1410,14110,3,7,1170,240,352500
3,1.75,1050,6150,4,6,950,100,400000
3,2.5,1630,5996,3,7,1630,0,350000
3,2.25,2630,12899,4,9,2630,0,990000
4,2.5,2820,15233,4,9,1820,1000,450000
3,1,1200,9322,4,7,1200,0,280000
4,3,2660,4600,3,8,1820,840,1.23E+06
3,2.5,1509,1114,3,8,1509,0,420000
3,1,1070,5750,3,7,1070,0,239300
4,2.75,2680,16934,4,7,1340,1340,445000
2,1,710,7200,3,6,710,0,215000
3,2.25,1620,6000,3,7,1280,340,247500
5,2.75,3170,7062,3,9,3170,0,919950
3,1,1300,8879,3,7,920,380,325000
4,2.25,1450,7245,5,7,1450,0,375000
4,3,4190,8805,5,9,3490,700,2.55E+06
2,1,840,5510,3,7,840,0,400000
3,2.5,2740,83199,3,9,2740,0,400000
4,2.5,2790,74495,3,9,2790,0,725500
4,2.5,2220,6800,3,7,2220,0,419950
3,3.5,3220,3960,3,10,2760,460,1.26E+06
3,2.5,2400,12546,3,9,2400,0,535000
3,1,1010,7680,4,7,1010,0,350000
4,3,2160,5200,3,7,1320,840,228950
4,2,1870,6000,3,7,1870,0,449000
5,1.75,3000,6000,5,7,1500,1500,380000
3,1,1790,6120,3,6,1790,0,302100
3,1.5,1070,8886,4,7,1070,0,240000
4,2,2220,3760,4,7,1370,850,771000
2,2.25,1230,1078,3,7,1160,70,325000
4,2.25,2060,10358,4,8,1320,740,558000
4,2.5,2880,23994,3,9,2880,0,535000
4,1,1270,3630,3,7,1270,0,402500
3,2.5,2120,9736,3,9,2120,0,531000
3,1.75,1480,7560,3,6,1100,380,375950
4,2.75,2530,13474,4,8,2530,0,349900
3,1.75,1880,10032,4,8,1880,0,681000
4,2.75,3110,49765,4,8,3110,0,531500
5,3.5,2700,11675,4,6,1950,750,565000
5,3.5,2160,2323,3,9,2160,0,750000
4,2.5,3680,13351,5,9,3680,0,1.90E+06
3,2.5,1980,6608,3,8,1980,0,272000
5,2.5,2260,7040,3,8,2260,0,365000
3,1,1020,6173,3,6,780,240,235000
2,1.75,2040,114562,4,7,2040,0,499000
4,3,2150,8119,3,8,2150,0,1.20E+06
4,3,2500,5000,4,7,1460,1040,670000
4,2.5,3760,29224,3,11,3760,0,1.01E+06
2,1,810,6480,5,6,810,0,510000
3,2.5,2050,15020,3,9,1600,450,760000
2,2,970,5000,3,7,970,0,325000
4,4,2630,59586,3,7,1470,1160,631000
2,1,1230,3800,3,7,1230,0,435000
4,3.25,3740,12080,3,10,2000,1740,1.09E+06
4,2.5,2050,4953,3,9,2050,0,383000
3,2.25,1710,1193,3,9,1140,570,685000
3,2.5,2329,5720,3,8,2329,0,327555
3,2,1050,18304,4,7,1050,0,250000
5,2.75,2980,4502,3,9,2980,0,515000
3,1.5,1000,13991,4,7,1000,0,390000
3,2,1750,15500,3,7,1490,260,472500
4,1.75,2400,21196,5,8,1590,810,569000
4,2.75,3370,6675,4,8,1920,1450,813000
3,2.5,2460,6600,4,8,1560,900,931000
4,2,1720,5472,3,6,860,860,275000
4,3,1984,4419,3,7,1984,0,300000
3,1.5,1250,7200,4,7,1250,0,165000
2,1,1060,4000,4,7,1060,0,570000
4,2.5,2570,4865,3,8,2570,0,320000
2,2,1060,4000,2,7,1000,60,578888
3,2,1380,8536,4,7,1380,0,265000
3,1,890,8400,4,6,890,0,283000
3,2.25,1920,11500,3,8,1920,0,515000
2,1,1010,6180,3,6,1010,0,325000
4,2.5,2070,5415,3,8,2070,0,578000
4,2.25,2420,11120,4,8,1620,800,750000
2,1,660,5000,3,6,660,0,175000
4,2.25,2060,8540,4,7,1540,520,425000
4,2,1530,4080,4,7,1530,0,664000
3,1,1100,8138,3,7,1100,0,241450
3,2.25,1510,6071,4,7,1150,360,265000
4,2.75,2060,21344,2,8,1460,600,675500
2,1.5,1290,5141,4,7,1050,240,653000
4,2.75,2610,9077,4,8,1310,1300,320000
3,2.5,1710,12677,3,8,1710,0,431000
2,2.5,1280,1051,3,8,1080,200,579000
2,1,1510,4000,3,6,930,580,500000
1,0.75,430,5050,2,4,430,0,80000
5,1.75,2870,9680,5,9,1440,1430,1.16E+06
4,2.75,3480,19991,4,10,2630,850,1.58E+06
3,1.5,1500,11975,4,7,1500,0,392000
3,1.75,1500,7200,3,7,1500,0,360000
3,2,1750,5750,5,7,870,880,575000
4,2.5,1970,4558,3,8,1970,0,320000
3,1.75,1940,8729,3,8,1460,480,781000
2,2.5,1170,809,3,9,1170,0,482500
3,2,1460,9759,5,7,1460,0,495000
4,2.5,2050,9143,3,8,2050,0,360000
3,2,1720,15000,3,9,1720,0,441000
4,2.5,2200,10800,3,8,1500,700,457000
2,0.75,840,49658,2,6,840,0,210000
3,2,1330,5632,3,8,1330,0,424000
2,1,710,6732,5,6,710,0,299000
4,4.5,3850,13551,3,10,3000,850,995000
7,5.75,3700,7647,3,8,3700,0,540000
4,2.25,2920,20400,4,11,2920,0,1.65E+06
4,1.5,1150,9360,3,6,1150,0,334000
3,2.5,1970,7500,3,8,1970,0,299995
3,1,1200,10703,2,7,1200,0,200000
4,2,1760,7700,4,7,1760,0,194000
4,2.5,2150,8165,3,8,1430,720,468000
3,2,1680,8424,3,7,1680,0,289000
3,1,920,5200,4,6,920,0,209000
3,1,1800,5612,4,7,1200,600,383000
3,1.5,1190,4750,3,7,970,220,500000
3,3.25,1630,1677,3,8,1630,0,385000
4,3,3820,26895,3,11,3820,0,991500
6,3.25,2900,6400,4,8,2300,600,696000
3,2.25,1820,13362,3,8,1220,600,480000
2,2.75,1350,1252,3,8,1120,230,405500
3,2.75,1810,3292,3,8,1810,0,384205
3,2.25,2010,7495,4,8,1570,440,620000
4,3.75,4133,361548,3,11,4133,0,979500
3,1.5,1140,3292,3,7,1140,0,310000
4,3.25,2320,5900,4,9,2320,0,934550
3,2,2250,2975,4,9,1880,370,950000
4,2.25,2820,9602,3,8,1950,870,750000
3,1.75,1600,7232,3,8,1600,0,453000
2,1,750,6720,3,6,750,0,260000
4,3.5,4020,13515,3,11,4020,0,1.69E+06
3,1.75,1990,9885,4,7,1030,960,438000
3,2.25,2190,8188,3,8,1810,380,580000
4,1.5,1840,4337,4,8,1840,0,809000
5,2.75,2760,7200,3,7,1430,1330,480000
3,2.25,1450,4789,3,7,1450,0,435500
3,1.75,1210,7000,3,7,1210,0,300000
3,3,4230,54977,3,9,3780,450,887500
3,1.5,1360,7488,4,7,1050,310,238000
6,3.75,4000,6015,3,10,3080,920,570000
3,2.5,2420,36862,4,8,1530,890,475000
5,3,2320,8400,3,7,1510,810,350000
3,3.5,1480,1077,3,7,1300,180,216650
4,2.25,1820,20349,5,8,1340,480,465000
3,2.25,1350,1234,3,7,1160,190,299999
3,1.75,1540,10400,3,6,1540,0,340000
5,3.75,4320,39094,3,8,4320,0,1.80E+06
3,1,1380,6591,4,7,1380,0,389000
3,1,1180,5350,4,6,1180,0,260000
4,1.75,2540,7620,3,8,1320,1220,655000
3,1,980,6380,3,7,760,220,499950
4,2.5,2080,11050,4,8,2080,0,364000
4,2.5,2810,4500,3,9,2810,0,518380
4,2.5,3170,186436,3,9,3170,0,660000
4,2.5,2090,5195,3,7,2090,0,300000
4,2.25,2760,12100,4,9,2760,0,675000
4,2.5,2690,4736,3,7,2690,0,608000
4,2.5,3030,29163,3,10,3030,0,835000
3,3.5,1570,1486,3,8,1330,240,494000
3,1.75,2140,13068,4,7,1460,680,271675
2,1,830,7200,2,6,830,0,200000
4,2.5,3360,13636,3,10,3360,0,765000
4,2.25,2500,8500,4,8,1600,900,646000
4,2.75,1910,7700,4,7,1000,910,250000
2,1,840,892,3,7,840,0,306500
3,1.75,1530,8028,3,7,1200,330,443000
4,2.5,3340,12248,3,9,2470,870,870000
4,1.5,1100,11824,4,7,1100,0,320000
3,1,2360,5012,3,7,1560,800,532000
3,3.25,3310,5000,3,9,3310,0,770000
3,1.75,1570,8530,4,7,1190,380,500000
3,2.5,2060,2551,3,8,1900,160,680000
1,1,620,2380,3,6,620,0,382888
3,1.5,1370,10115,4,7,1370,0,264950
2,1,1020,8155,4,7,1020,0,405000
3,1.5,1590,7936,3,7,1590,0,325000
3,2.5,3580,118047,3,9,3240,340,616500
3,1,940,10360,4,7,940,0,500000
3,1.5,1780,23819,3,7,1780,0,246000
4,2.5,2110,6360,3,8,2110,0,610000
2,1.5,980,853,3,7,820,160,378000
4,2.5,2420,4981,3,9,2420,0,380000
3,2.5,2070,5013,3,8,2070,0,289950
3,1,1290,5440,4,6,790,500,450000
4,4.25,5660,193593,3,10,4100,1560,955000
4,1.5,1940,12100,3,7,1940,0,390000
4,2.5,2950,48351,3,10,2950,0,835000
3,1,1010,5490,3,6,1010,0,145000
4,4,3200,7708,3,10,3200,0,720000
3,1.5,2840,10182,3,8,1510,1330,250000
4,3.5,3950,12320,3,10,3950,0,771150
3,3.25,4160,35153,3,12,3690,470,1.70E+06
4,2.75,2870,8625,4,8,1860,1010,700000
3,2.25,1620,1425,3,8,1540,80,484000
4,1.75,1820,5015,4,6,1190,630,300000
3,1.5,1840,5000,5,7,1340,500,750000
3,1.5,2230,8558,3,8,2230,0,685000
4,3.5,3600,5217,3,9,2720,880,1.35E+06
3,2.25,2190,107593,4,8,2190,0,699950
4,3,4260,18000,3,11,4260,0,2.00E+06
4,2.5,1670,8056,3,7,1170,500,270000
3,2.25,1460,5818,3,7,1140,320,240000
4,2.5,3110,11397,4,10,3110,0,960000
9,3,2820,4480,3,7,1880,940,934000
5,3,1880,5000,3,7,1100,780,310000
3,1,1240,9300,3,7,1240,0,290000
3,3.5,2270,4088,3,8,1880,390,560000
4,1.75,1750,5500,5,7,1050,700,460000
3,2.25,2950,7232,3,8,1520,1430,1.07E+06
3,2,1790,8228,3,7,1390,400,317000
3,1.75,1810,3000,4,7,1810,0,545000
3,3.25,1210,1173,3,8,1000,210,343000
4,2.5,2880,35610,3,10,2880,0,845000
4,4,2790,16117,4,9,2790,0,865000
5,3,2240,15435,5,7,1390,850,480000
4,2.5,2550,6256,3,9,2550,0,587000
4,2,1640,5000,3,7,1640,0,492000
3,1.75,2010,8065,4,7,1090,920,299000
3,1.75,1530,14087,3,7,1070,460,257500
3,2.25,2910,10204,3,9,2910,0,770000
3,2.5,2080,3729,3,9,2080,0,898888
2,1,1810,8527,4,7,1810,0,375000
4,2.5,2520,3980,3,8,2520,0,598500
2,1,1110,5413,3,6,890,220,448000
5,1.75,1830,7986,4,7,1060,770,354000
5,2.75,2830,5310,3,9,2830,0,725000
4,1.5,2810,7140,3,8,1490,1320,575000
4,2.25,2620,98881,3,7,1820,800,525000
4,2.5,2920,6000,3,9,2920,0,675000
3,1,1320,8450,3,6,880,440,232500
5,2.75,3030,10335,3,9,3030,0,819995
3,2.5,2190,34528,3,8,2190,0,525000
3,3,1530,9997,3,6,1020,510,154000
3,1,1250,8314,3,6,1250,0,144000
5,1.5,3050,2992,4,8,1920,1130,760000
5,1.75,1850,14800,3,6,1760,90,315000
4,2,2330,6250,4,7,1400,930,344950
4,2.5,2010,6294,3,7,2010,0,427500
3,1.75,1830,4500,4,7,1830,0,518000
3,2.25,1670,6414,4,8,1670,0,587100
3,1,1700,8645,3,6,1700,0,284700
3,1,1110,6060,3,6,1110,0,279000
4,2.5,2460,7930,3,8,2460,0,730000
3,2,1350,6696,5,6,680,670,270000
4,2.5,2360,10000,3,8,1980,380,633000
3,1,1470,8200,3,7,1040,430,290000
2,2,1190,1303,3,8,800,390,455000
3,1,1864,6978,4,7,1864,0,235000
3,1.75,1570,15330,3,7,1080,490,371000
3,2.5,3830,48743,3,11,3830,0,1.15E+06
3,1,1300,5880,3,7,1300,0,333760
3,3.5,2740,3785,3,9,2190,550,660000
3,1.5,1480,7117,3,7,1170,310,285000
3,1,940,7910,4,6,940,0,370000
4,2.25,2910,10189,3,9,2910,0,998000
1,0.75,930,6600,3,6,930,0,351000
4,2.25,2620,17366,3,9,1430,1190,765000
3,2.25,3330,20053,3,9,3330,0,1.82E+06
3,1,1560,3960,4,7,1560,0,595000
4,3.5,2796,3520,3,8,2796,0,349950
3,1.75,1230,9600,4,7,1230,0,239950
2,2.5,2395,6143,3,8,2395,0,800000
4,1.75,2140,7102,4,7,1070,1070,565000
3,1,1520,7800,4,7,1120,400,250000
2,1,1840,3300,4,6,1130,710,490000
4,1,2050,7590,3,7,1280,770,329950
3,1.75,1160,7006,4,7,1160,0,285000
3,2.25,2420,7548,4,8,1370,1050,282000
4,2,2240,4508,4,8,1340,900,466000
4,2.5,3370,10602,3,10,3370,0,1.14E+06
3,1,1700,4400,4,8,1700,0,800000
3,2.25,1780,4252,4,8,1540,240,675000
3,1.75,2090,6258,3,7,1390,700,350000
4,2.5,2680,8062,4,7,1530,1150,470000
3,2.5,1740,2226,3,8,1320,420,342000
3,1.75,1370,1921,3,8,1370,0,667000
3,2.25,1780,8050,4,7,1230,550,495000
4,2.5,2910,4356,3,8,2910,0,915000
4,2,2070,9822,5,7,2070,0,375000
6,2,1900,8240,2,7,1200,700,305000
3,1.75,1760,11371,5,8,1760,0,455000
5,3,3640,8239,3,10,2540,1100,1.60E+06
4,2.5,2520,8515,3,7,2520,0,450000
2,2.5,1160,2174,3,7,1160,0,168000
2,1,830,8000,3,6,830,0,200000
3,1.75,1520,11085,3,8,1520,0,475580
3,2,1480,7480,4,7,1480,0,254000
4,2.5,2330,31705,4,8,2330,0,630000
3,2.5,1480,1590,3,8,1150,330,315000
3,2,1580,5080,4,6,800,780,214000
4,2.5,1770,4338,3,7,1770,0,279900
2,1,700,9500,3,6,700,0,190000
3,2.25,2900,35273,3,9,2900,0,485000
3,2.5,2760,11287,3,10,2000,760,830000
2,1,830,7609,3,6,830,0,135000
2,2,860,3000,3,6,860,0,316000
4,2,1760,5500,3,7,780,980,285000
3,2.5,3080,8448,3,9,3080,0,950000
3,3.5,2600,11920,5,8,2600,0,985000
2,1,850,5000,3,5,850,0,298000
4,2.5,2730,10753,3,9,2730,0,756000
3,1.75,2080,75794,3,7,2080,0,800000
3,2.25,1960,10682,3,7,1960,0,450000
3,2.5,1950,3600,3,7,1950,0,298000
4,4,3570,8250,3,10,2860,710,597326
3,2.5,2450,28185,3,9,2450,0,480000
4,2.5,3450,43216,3,9,3450,0,840000
4,2.25,2550,10000,4,7,1560,990,452250
2,1.5,1110,118047,3,7,1110,0,625000
2,1.5,1340,1402,3,8,1120,220,390000
4,3.5,4500,44384,3,12,3340,1160,1.98E+06
3,1.5,1280,5547,4,6,1280,0,167000
3,1.75,1230,7200,3,7,1230,0,220000
4,1.5,1780,8400,3,7,1080,700,473600
3,1.5,1440,9711,3,7,1140,300,450000
3,2.5,1470,1741,3,8,1170,300,454280
3,1,1610,4108,5,7,1610,0,565000
2,2,1990,6180,4,7,1010,980,776000
4,3.5,3080,4815,3,10,2300,780,1.66E+06
3,2.5,2770,39529,3,9,2770,0,715000
3,2.5,1780,1647,3,8,1080,700,672000
2,1,880,1165,3,8,880,0,360000
3,1,1110,7520,4,7,1110,0,130000
4,1.75,2500,92347,4,8,1500,1000,950000
4,2.25,1720,2300,3,7,860,860,555000
3,2.25,1640,7200,4,8,1640,0,350000
3,2.5,2390,1984,3,8,2220,170,629800
4,2.5,2770,45514,4,9,2770,0,685000
4,2,1790,2250,4,7,840,950,475000
2,1,1140,74052,4,6,1140,0,269500
3,1.75,1470,8925,4,7,1470,0,239000
3,2.75,2200,9600,4,8,1570,630,375000
4,3.5,4440,20668,5,10,3240,1200,1.73E+06
3,1.75,1310,8600,4,7,1310,0,470000
2,1,1220,28703,4,7,1220,0,350000
3,1.75,1320,6030,4,7,1320,0,409950
3,3.25,1510,2000,3,9,1330,180,650000
4,2,1480,11171,4,6,1480,0,890000
3,2.25,1630,10969,3,7,1630,0,265000
3,1.75,1240,7200,5,7,1240,0,427500
4,2.75,3350,6500,3,10,3350,0,739999
3,2.5,1610,8544,5,7,1610,0,319000
4,1.75,2400,9900,3,7,1250,1150,387500
3,1.5,1950,7560,4,7,1320,630,269950
3,2.25,2680,9162,3,8,1570,1110,599990
3,1.5,1470,11112,3,7,1470,0,418900
3,1,960,9531,5,7,960,0,374500
2,1.5,1270,1282,3,8,1000,270,313500
2,2.75,2700,9854,3,9,2700,0,850000
2,1,930,5368,4,7,930,0,420000
3,1.75,2700,18893,4,7,2110,590,625000
3,1.75,1470,7650,3,7,1130,340,328000
2,1,1090,6000,3,7,1090,0,425000
3,2.75,2170,2738,4,9,1550,620,848000
3,1,1040,5000,3,7,1040,0,217450
4,2.75,2190,2867,5,7,1470,720,637000
2,1,1630,12059,3,7,1270,360,500000
2,2.5,1480,2167,3,8,1390,90,468000
3,2.5,2230,4850,3,8,2230,0,722000
4,1,1760,7216,3,7,1090,670,429950
6,3,2880,3192,4,8,2180,700,1.13E+06
3,2.25,2570,7242,3,7,2170,400,538000
5,2.5,2380,8204,3,8,1540,840,600000
3,2.25,1800,43647,4,8,1800,0,474900
2,1,1240,11393,4,7,1240,0,226800
4,2.75,2830,10240,4,9,2830,0,774000
3,2,1830,9152,5,8,1830,0,550000
3,1.75,1950,8712,3,7,1950,0,235000
3,2.25,1460,7210,3,7,1460,0,505000
3,2.25,1990,6256,3,7,1390,600,620000
3,1,1400,5662,5,5,1400,0,343000
3,2.25,1700,1481,3,8,1700,0,550000
4,2.5,2070,6175,3,8,2070,0,272000
3,1,1200,10458,4,6,1200,0,190000
3,1.75,1830,7600,3,7,1490,340,283000
3,2.25,2090,9163,3,7,1460,630,456500
3,1.75,1560,5223,4,7,810,750,399950
3,1.5,1370,10176,3,6,1370,0,170000
3,2,1930,15540,3,8,1260,670,360000
3,2.5,2210,8010,3,8,2210,0,445000
5,3.25,3350,4000,4,8,2510,840,1.11E+06
3,1,1384,8960,4,6,1384,0,180000
4,2.5,2280,9899,3,8,2280,0,325000
2,2.5,1320,1957,3,8,660,660,352000
3,1.5,1150,3323,3,7,1150,0,310000
2,1,1010,14244,1,5,1010,0,658000
3,3,1950,1833,3,9,1610,340,798500
5,3,3223,6371,3,9,3223,0,479349
5,3,2320,7229,4,8,1370,950,552500
2,1,1250,5413,4,7,1250,0,511000
3,3,2340,2970,5,8,2160,180,660000
4,3,2150,64694,3,8,1450,700,399950
2,1.75,1220,8382,3,6,1220,0,245000
5,3,2960,15152,3,9,2960,0,875000
2,3,1410,1240,3,8,1140,270,405000
3,2.25,1520,7930,3,7,1160,360,270000
3,2.5,2200,7201,3,8,2200,0,302495
2,1,800,6050,4,6,800,0,225000
3,2.5,1700,6396,3,7,1700,0,389950
2,1,1150,11250,3,6,1150,0,254500
3,2.25,2110,2850,3,8,2110,0,525000
3,1,1500,6600,2,6,1500,0,243000
2,2,1600,64468,3,7,1600,0,995000
2,1,910,4800,4,7,910,0,422500
4,2.75,2520,6964,4,7,1260,1260,307000
3,2.5,1440,3060,3,7,1440,0,421200
3,3.25,3410,25741,4,8,3410,0,720000
3,1,940,6695,4,6,940,0,358000
3,2.75,2170,8396,3,7,2170,0,353000
2,1,870,5340,2,6,870,0,271310
3,1.75,2580,40392,3,9,1390,1190,570000
3,1.75,1170,8740,4,7,1170,0,440000
5,2.75,2580,7630,4,7,1730,850,915000
2,1,1730,6375,4,6,1730,0,396675
2,1,1640,5515,4,7,940,700,577500
2,1,1020,7679,5,6,1020,0,245000
4,1,1980,7015,3,7,1260,720,524000
3,2.5,1980,39932,3,8,1980,0,442000
5,3.5,3990,10120,3,9,2820,1170,650000
5,3.5,3180,40946,3,7,1690,1490,585000
4,2.5,1812,5026,3,8,1812,0,370000
4,2.5,2740,7571,3,9,2740,0,706000
4,2.5,1600,9921,3,7,1600,0,270000
3,4.5,4380,47044,3,9,3720,660,995000
3,2.25,1920,9672,4,8,1920,0,345000
2,1,1140,10152,3,6,760,380,153000
3,2.25,2420,23507,4,8,2420,0,774888
4,2.75,2310,5000,5,8,1480,830,524000
3,1.5,1060,7488,5,7,1060,0,325000
3,1,1580,8240,4,7,1040,540,253000
3,1.75,1690,13500,4,7,1690,0,780000
4,3,3760,8804,3,8,2470,1290,494500
3,2.5,1410,1325,3,7,1180,230,315000
2,1,1130,5413,3,7,880,250,443000
4,3,2620,214750,3,8,2620,0,678500
3,1,990,4440,3,6,990,0,226550
3,1,1250,7210,4,7,1250,0,345000
3,3,3490,4500,3,9,3170,320,1.05E+06
3,3.25,1510,1245,3,7,1510,0,319950
4,1.75,1950,12500,3,7,1330,620,325000
4,2.5,2790,6538,3,9,2790,0,751000
4,2.5,2680,5539,3,8,2680,0,449990
4,2.5,2660,8887,4,8,1880,780,513000
3,2.5,1730,4086,3,8,1730,0,350000
4,2,2560,12155,4,7,1350,1210,255000
4,2.5,2990,9374,3,9,2990,0,785000
5,3.25,2590,6180,3,7,1330,1260,599000
3,1.5,1270,1413,3,8,1270,0,440000
4,2.5,3400,4840,3,10,3190,210,745000
3,1,1090,4000,4,7,1090,0,690000
3,2.5,1920,9180,3,8,1920,0,230000
3,2.5,1330,816,3,8,1330,0,375000
3,1.5,1050,6615,4,6,800,250,420000
3,2.5,1260,895,3,7,1160,100,305000
3,2.5,2510,5320,3,8,2510,0,395000
3,2.25,1340,873,3,8,1340,0,303000
3,2.25,2080,2050,3,7,1550,530,284000
4,1.75,1850,6480,4,7,1120,730,400000
3,1.75,1130,7000,3,7,1130,0,185000
4,3.5,4040,50479,3,11,4040,0,910000
5,4,4690,8208,3,9,3040,1650,2.05E+06
3,2,1590,35988,4,8,1590,0,305100
3,1,1510,142803,3,7,1510,0,299000
5,2.25,3120,16672,4,9,3120,0,1.90E+06
3,1.75,2020,8531,3,7,2020,0,405000
1,2,1070,675,3,8,880,190,420000
4,2.75,2640,7500,3,8,1620,1020,320000
3,1,1530,4944,3,7,1530,0,640000
4,2.5,2930,8679,3,8,2930,0,635000
4,3.25,5450,37058,5,9,5450,0,610000
4,2.5,1690,4080,4,7,1140,550,591500
3,1.75,1710,10800,4,7,1710,0,368000
4,2.5,2531,6843,3,8,2531,0,370000
4,2.5,2750,6259,3,9,2750,0,360000
3,2.5,1640,7847,3,8,1640,0,480000
4,2.25,2220,8125,4,8,1450,770,555000
3,2.25,2840,59677,3,7,1580,1260,663000
3,3.25,3870,11000,3,9,2970,900,645000
3,2.25,1370,1533,3,8,1370,0,315000
4,2.5,3340,8930,3,10,3340,0,720000
3,3.25,1410,1350,3,8,1410,0,425000
3,2.5,1740,4948,3,7,1740,0,410000
2,1,980,5110,4,7,780,200,365000
3,2,1700,52826,3,7,1700,0,429000
4,3.75,5070,60123,3,11,5070,0,1.10E+06
2,1.75,1740,7290,3,8,1280,460,550000
1,1,1180,22000,3,6,1180,0,229500
4,2.5,2070,8473,4,8,1250,820,775000
3,1.75,1590,1113,3,8,1590,0,609500
3,2.75,1710,3600,3,7,1590,120,575000
3,2.25,1700,2800,5,7,1150,550,603000
5,2.5,2860,4000,4,8,2160,700,1.20E+06
4,2.5,2670,8765,3,9,2670,0,515000
4,3,2440,9600,5,7,2440,0,589000
3,2,1020,1204,3,7,720,300,238000
2,1,800,4850,4,7,800,0,440000
4,2.25,1920,8910,4,8,1200,720,635000
2,1.75,1640,3090,4,7,910,730,516000
4,2.75,2060,7350,3,7,1210,850,275000
3,1,1250,9035,4,7,1250,0,230000
2,1,1520,5400,3,7,920,600,619950
6,3.5,2820,5400,3,8,1620,1200,850000
4,1.75,1880,3720,4,7,1880,0,860000
4,2.75,3050,4750,3,8,3050,0,563950
3,2.5,2180,15484,3,8,2180,0,350000
4,2.5,2420,8404,3,8,2420,0,365000
3,1,1160,9600,4,7,1160,0,330000
4,2.5,2540,8400,5,7,2540,0,269950
3,2.5,1690,1200,3,8,1410,280,336900
3,1,1410,4840,4,6,1230,180,650000
3,2.5,2420,9000,4,9,2420,0,752888
4,2.5,2680,11590,4,9,2680,0,419625
3,2.25,1760,1146,3,9,1760,0,615000
2,1,810,5060,3,6,810,0,505000
3,3.25,1290,1230,3,9,1090,200,590000
4,2.5,2980,10179,3,9,2980,0,574000
4,2.5,2450,5280,3,8,2450,0,525000
4,2.5,2500,4945,3,9,2500,0,575000
3,3.5,3070,7050,3,8,1570,1500,850000
4,2.5,3000,7500,3,9,3000,0,1.69E+06
3,2.25,1270,2790,3,7,990,280,543500
3,2.5,2040,4627,3,8,2040,0,580000
5,2.75,2520,18625,3,8,1660,860,1.05E+06
3,2,2160,15788,3,8,2160,0,987000
4,2.5,2870,11304,3,9,2870,0,710000
3,2.25,1560,8570,5,7,1080,480,1.10E+06
3,1,1560,8232,3,7,1560,0,915000
3,2.5,2860,43821,4,9,2860,0,378500
3,1,1000,6020,3,6,1000,0,220000
4,3.5,5370,323215,3,10,5370,0,1.57E+06
3,2,3190,207346,3,9,3190,0,585000
3,1,1160,5969,3,7,880,280,508300
4,2.5,2240,6920,5,8,1380,860,535000
1,1,730,1942,3,7,730,0,321500
3,1.75,1260,11224,5,7,1260,0,375000
4,2.5,2390,7115,3,9,2390,0,360000
2,1,1040,5120,3,7,1040,0,412000
4,2.25,2920,6513,4,9,2260,660,1.74E+06
2,0.75,440,8313,4,5,440,0,290000
4,2.5,2620,4469,3,7,2620,0,300000
4,2.25,2510,4090,3,8,1840,670,410000
4,3,4410,5104,3,9,3400,1010,765000
3,2,1060,651,3,7,1060,0,405000
3,3,2600,5238,3,9,1890,710,525000
3,2.5,1930,8254,3,7,1930,0,369950
4,4.25,1960,3565,3,7,1960,0,540000
2,1,2060,8398,3,7,1260,800,270000
5,3.5,2640,6895,3,7,2640,0,459000
2,1,870,6537,3,6,870,0,170000
3,2.5,1630,4534,3,8,1630,0,422120
3,2.75,3230,9576,4,8,3230,0,605000
3,2,1540,3600,3,8,1540,0,850000
2,2.75,1465,972,3,7,1050,415,489000
3,3,2330,10327,3,9,2330,0,612000
5,2,2440,3080,4,8,2440,0,1.01E+06
4,1.75,1580,5340,3,7,1130,450,400000
2,1,1250,8100,4,7,1250,0,365000
3,2.5,1610,2937,3,8,1610,0,290000
4,1.75,1830,5375,2,7,1060,770,260000
3,3.25,3450,15586,3,11,2690,760,755000
3,3.25,1390,1278,3,8,1140,250,469000
4,3.25,4740,76230,3,10,4740,0,970000
3,1.75,1070,6110,4,7,1070,0,195000
3,1.75,2840,16851,3,8,1600,1240,440000
4,1.75,2410,8447,4,8,2060,350,550000
2,1,1070,5000,3,7,1070,0,640000
4,2.5,3560,6786,3,9,2930,630,907687
4,3,3260,4500,3,9,2300,960,1.28E+06
2,3.25,1550,1767,3,8,1550,0,1.08E+06
2,2.25,1360,1336,3,8,1360,0,479950
4,2.5,2450,4247,3,8,2450,0,712198
4,1.75,1230,7890,4,7,1090,140,569000
4,2.75,2170,7140,3,8,1290,880,555000
3,1.75,2430,14607,3,8,1230,1200,762400
1,0.75,370,1801,5,5,370,0,276000
3,1,1020,8437,5,6,1020,0,225000
4,2.25,2570,36465,4,8,2570,0,580000
2,1,770,5185,3,7,770,0,378510
4,2.5,2300,22445,4,8,2300,0,498000
3,1.75,2140,7280,3,7,1070,1070,603500
4,1.75,1840,10528,3,7,1210,630,274900
3,2.5,1090,1139,3,8,960,130,335000
3,1.75,1590,7931,3,7,1190,400,240000
4,2.5,2760,13093,4,9,2760,0,745000
4,2.5,3630,8387,3,10,3630,0,490000
2,2.5,1830,8107,5,7,930,900,460000
4,2.5,2590,6139,3,8,2590,0,479000
2,1.75,1660,4000,3,7,990,670,765000
3,2.5,1790,6191,3,8,1790,0,250000
4,2.5,2420,11481,3,8,1370,1050,345000
4,2.5,2360,7370,3,7,1460,900,362000
4,3.5,6370,205603,3,12,6370,0,1.80E+06
2,1.75,1210,131115,5,7,1210,0,510000
3,2.5,3070,14400,5,9,1720,1350,550000
3,2.75,3070,10739,3,10,2440,630,1.00E+06
3,2.5,1780,2778,3,8,1530,250,443000
3,2.5,2150,4084,3,8,2150,0,465000
3,1.5,1650,9380,5,7,1130,520,320000
4,2.25,2020,8424,4,7,1380,640,464900
3,2.5,2490,24691,4,9,1580,910,1.16E+06
3,1,1010,6000,3,7,1010,0,636100
3,2.5,2120,6602,4,8,2120,0,578550
3,1.75,1530,5000,3,7,1020,510,635000
3,2.75,2216,31215,3,9,2216,0,667000
4,2.5,3030,6813,3,9,3030,0,557865
2,1,960,5000,4,7,960,0,500000
3,1.75,1330,7482,4,7,1330,0,360000
4,2.5,2650,6240,3,8,2650,0,702000
4,2.75,2310,14745,3,7,1410,900,370000
4,2.75,2490,17833,3,9,1490,1000,740000
4,2.5,3320,9380,3,10,3320,0,1.11E+06
3,1,1710,19115,3,6,1710,0,305000
3,1,1270,3600,3,7,1270,0,655000
3,1.75,1070,6315,3,7,1070,0,226750
4,1.75,1660,6200,4,6,830,830,320000
4,1.5,1540,7886,3,7,1540,0,415000
4,2.25,1920,9660,4,8,1920,0,372500
3,1.5,1340,8856,4,7,1340,0,466200
4,3.75,3320,8234,3,10,3320,0,1.70E+06
3,1,1090,2800,3,6,1090,0,149000
4,2.75,2200,9778,4,8,1100,1100,505000
3,3.5,1900,1612,3,8,1430,470,431500
4,1.75,2260,9703,2,8,1660,600,459000
4,2.25,1920,11603,4,7,1920,0,325000
3,2.75,2640,4050,5,8,1750,890,1.10E+06
2,1,1240,5500,3,6,1240,0,319950
3,2.25,2620,10659,3,7,1660,960,469000
2,2.5,1990,1756,3,9,1780,210,690000
2,1,870,4025,3,7,870,0,280000
2,1,1190,3400,4,7,990,200,440000
4,1.75,1700,40973,3,8,1700,0,334950
4,2.25,2680,5439,3,7,2680,0,501000
3,2.5,3080,12476,3,10,3080,0,539500
4,2.5,2120,215186,2,7,2120,0,396400
3,2.5,1520,2550,3,7,1520,0,207000
4,2.5,2620,5060,3,9,2620,0,804000
3,2.5,1650,5683,3,7,1650,0,500000
3,1.75,1920,3300,4,8,960,960,725000
4,2.5,2870,5118,3,9,2870,0,725000
4,2.5,2660,3672,5,8,1800,860,900000
5,1.5,1720,4000,3,7,1520,200,683000
2,1,1810,10360,3,6,1010,800,216000
3,2.5,1232,1130,3,7,1232,0,344000
2,1.5,1084,3427,3,7,1084,0,265000
5,2,1810,4850,3,7,1810,0,530000
3,1.75,1770,2800,3,7,1770,0,712500
3,2.5,2100,6092,3,8,2100,0,554990
4,2.5,2520,9684,3,8,2520,0,470000
7,1,2350,8636,3,7,1550,800,291000
4,2.5,2400,9398,4,7,1310,1090,380000
3,2.5,1930,7214,3,8,1930,0,530000
3,1,1100,5100,4,7,1100,0,400000
3,1,1430,8640,5,7,1430,0,551100
3,2.5,1600,5960,5,8,1600,0,424305
5,1.75,3290,11900,3,8,3290,0,602000
4,1.5,1100,9600,4,6,1100,0,353000
4,2.5,2690,5505,3,8,2690,0,333000
3,1.75,2210,16200,3,8,1390,820,625000
4,2.75,3090,5859,3,9,3090,0,760005
2,1,860,10500,3,6,860,0,235000
4,3.25,3820,15293,3,10,3820,0,950000
3,1,1220,20400,5,6,1220,0,253500
3,1.75,2220,7224,3,8,2040,180,615000
4,3.5,4300,70407,3,10,2710,1590,600000
2,1.5,930,7400,4,7,830,100,550500
3,2,2460,6600,4,8,1370,1090,678500
3,2,2910,6600,4,7,1920,990,718500
3,2,930,11475,3,7,930,0,255000
5,2.5,4870,11800,3,10,3470,1400,722500
4,2.75,2990,4298,3,9,2990,0,779950
4,2.5,1700,6675,3,7,1700,0,315000
4,1,1540,115434,4,7,1540,0,759600
5,1.75,1880,16617,3,7,960,920,585000
3,1,1630,8308,3,7,1630,0,474900
4,3.25,1900,2631,3,9,1250,650,579000
4,2.25,1910,5120,3,8,1300,610,650000
2,1,1230,5000,5,6,1230,0,184900
4,1.75,3720,8448,4,9,1960,1760,1.28E+06
4,1,1080,6095,4,6,1080,0,425000
4,2.5,2030,8100,3,7,1150,880,420000
4,4.5,4020,9656,3,10,4020,0,1.90E+06
3,1.75,1580,7344,5,7,1580,0,575000
4,2.5,2850,5664,3,9,2850,0,679950
2,1,1320,9967,3,6,940,380,255000
4,2.25,2720,8712,4,9,2720,0,840000
3,2.5,2020,5613,3,7,2020,0,528000
3,1,1130,12519,3,7,1130,0,220000
5,2.25,2600,9600,4,8,1810,790,310000
2,1.75,1980,44550,5,7,1280,700,428000
3,2,1080,11856,5,7,1080,0,392800
2,1.5,830,1325,3,7,830,0,271115
4,3.5,4440,10660,3,11,4440,0,1.04E+06
4,1.75,1990,23200,4,7,1990,0,378000
6,3,2400,9373,3,7,2400,0,300000
6,5,6050,230652,3,11,6050,0,1.60E+06
3,1,1610,7680,3,6,900,710,715000
3,1.75,2170,73616,3,7,2170,0,399000
2,1,1630,9255,3,7,1630,0,438000
2,2,1680,4647,3,8,1680,0,560000
4,1.75,2710,11400,4,9,1430,1280,925000
6,2.25,2450,25600,3,7,1340,1110,662500
2,1,1120,45302,4,5,1120,0,240000
2,2,1140,12000,3,6,1140,0,480000
4,2,2340,9716,3,7,2340,0,385000
4,2.75,2070,9300,5,7,1120,950,366500
4,2.5,3570,6054,3,9,3570,0,928990
3,2.25,1860,5028,3,8,1860,0,355000
3,2.25,1490,8722,3,7,1490,0,230000
2,1.5,2730,19877,4,8,1570,1160,460000
2,2,1540,9714,3,8,1540,0,529000
3,2,1260,8092,3,7,1260,0,242000
3,1.75,1140,9800,4,7,1140,0,206000
3,3.5,1370,1540,3,8,1100,270,385000
3,2.25,1820,9766,4,7,1450,370,275000
4,1.75,2950,9025,4,8,1780,1170,630000
4,3.25,3660,5800,3,10,3360,300,1.51E+06
5,3.5,2660,6978,3,8,1980,680,332100
3,2,1390,8250,3,7,1390,0,245000
4,2.75,3130,139392,4,9,3130,0,565000
3,1.5,1750,32500,4,7,1750,0,410000
4,2.5,2650,5600,3,8,2650,0,542525
4,2,2040,8281,3,7,2040,0,565000
3,1.75,1120,5500,4,7,1120,0,464600
2,2.5,2380,6600,3,8,2380,0,699800
3,2.25,1750,15528,3,8,1270,480,382000
4,2.5,2020,4350,5,9,1730,290,554729
3,1.75,1380,3561,4,7,860,520,535000
3,1,1270,12733,3,7,1270,0,240000
4,2.25,2210,11700,4,8,2210,0,336000
5,2.75,2300,7600,4,7,1400,900,294000
3,1,1140,6120,3,7,1140,0,704000
4,2.5,2800,6874,3,9,2170,630,883000
2,1.5,1040,83199,4,7,870,170,310000
3,3.25,3660,66211,3,10,3660,0,920000
2,2.5,2560,2500,5,8,1690,870,780000
4,2.5,2380,4950,3,8,2380,0,590000
3,1,1410,8053,4,7,1410,0,405000
5,3.5,2950,7980,3,9,2350,600,615000
4,1.75,1920,9500,4,7,1470,450,481000
4,4.75,5230,89298,3,11,5230,0,1.35E+06
5,2.25,2100,10726,4,7,1050,1050,342500
4,3.25,2520,3360,4,8,1550,970,618250
3,2,1380,8682,4,7,1380,0,295000
5,2.75,1690,4000,5,7,970,720,399990
3,1.75,1150,9600,3,7,1150,0,309212
4,2.5,3210,14910,3,10,3210,0,770000
3,1.5,720,7450,1,5,720,0,295000
4,2.5,3450,35100,3,10,3450,0,832500
3,2.5,2080,2625,3,8,2080,0,550000
5,3.25,3930,12719,4,10,2540,1390,1.25E+06
4,2.5,3280,16575,3,9,2190,1090,706000
3,2.5,2170,4905,3,8,2170,0,329900
4,3,2250,7245,4,7,1250,1000,735000
3,3,2090,7634,3,8,1450,640,400000
2,1.75,1270,7500,4,7,1270,0,365000
4,2.25,1910,8005,3,8,1280,630,528000
4,2,1650,7200,3,7,1650,0,295000
4,2.5,2600,9935,3,8,2600,0,540000
1,1,1120,17332,3,7,1120,0,166000
4,2.5,4200,35267,3,11,4200,0,1.08E+06
4,2.25,1880,9727,3,7,1100,780,419000
4,2.25,2380,17199,3,8,1530,850,470000
4,2.5,3230,12100,3,9,1870,1360,827000
5,2.25,3410,35536,3,10,2530,880,815000
3,2.25,1620,7150,4,7,1280,340,330000
4,3.5,3450,7832,3,10,3450,0,1.05E+06
6,1.5,1680,5202,2,7,1680,0,619500
5,4.5,3810,8019,3,10,3810,0,966000
3,1.5,1290,7100,3,6,1290,0,265000
3,3.25,3060,9055,3,10,2460,600,715000
3,1,1330,20562,3,5,1330,0,280000
3,2.25,2160,8114,3,8,1460,700,530000
3,1.5,1510,8000,4,7,1510,0,470000
2,1,860,3300,5,6,860,0,311000
2,2,1360,3300,3,6,1360,0,222000
3,1,1420,7420,3,6,1420,0,264250
4,2.5,2080,5650,3,7,1680,400,315000
4,2.25,2110,16200,3,8,1630,480,490000
3,1.5,1952,8613,4,7,1652,300,270500
2,1,870,5750,4,7,870,0,406500
3,2.5,1750,4200,3,7,1750,0,300000
3,1.5,1240,8528,4,7,1240,0,255000
2,1,970,5500,3,7,970,0,210000
3,2.75,2600,5875,5,8,1600,1000,805000
2,2,1300,4659,3,8,1300,0,344000
3,2,2110,9199,3,10,2110,0,677100
3,1.75,2030,13700,3,8,1630,400,435000
3,2,1470,8000,4,8,1470,0,245000
3,1,1830,6453,4,7,1830,0,467500
3,2.25,1347,1292,3,7,1347,0,321000
2,1,960,5508,3,6,770,190,175000
5,3.5,2960,12527,3,9,1940,1020,389500
2,2.5,2270,1763,3,7,1820,450,656000
3,2.5,1940,7415,3,8,1940,0,423800
3,2.75,3290,22649,4,8,3290,0,595000
3,1.5,1280,7742,3,7,1280,0,165000
3,1,1120,10701,3,7,1120,0,285000
3,3.25,1370,1194,3,8,1370,0,469000
3,1,940,7380,3,6,940,0,242500
4,3.5,4080,14450,3,12,3210,870,1.29E+06
3,2.5,2300,7398,3,8,2300,0,567500
3,1.75,1260,10164,4,6,1260,0,230000
3,2,1790,7879,3,7,1790,0,258000
5,3.75,3290,6480,5,10,2190,1100,1.39E+06
5,3.5,3840,8279,3,9,3840,0,875000
2,1,1620,3880,4,7,920,700,481000
2,3.25,2070,3128,3,9,1760,310,1.45E+06
4,2.5,2100,8400,4,7,1240,860,468000
3,1.5,1060,5750,2,7,1060,0,317000
3,2.5,1280,1889,3,8,1280,0,540000
3,2.5,2690,7000,5,7,1840,850,925000
3,1.75,1890,13860,5,7,1890,0,307000
3,2,2460,53882,3,7,2460,0,357000
3,2.5,1680,7385,3,8,1680,0,485000
2,1,1150,6835,3,7,1010,140,425000
4,2.5,1820,7912,3,7,1820,0,329500
3,1,1790,6120,3,6,1790,0,225000
5,2,1220,4200,4,6,1090,130,469950
3,3.25,3400,5979,4,9,2290,1110,1.30E+06
4,3,3520,4895,3,8,1980,1540,800000
4,1.75,2410,8447,4,8,2060,350,550000
4,2.5,2430,42646,3,7,1450,980,490000
3,1.75,1810,7950,4,7,1810,0,443000
2,1,1330,28270,3,6,1330,0,175000
3,2.25,2920,6300,3,8,1710,1210,680000
3,2.5,2588,5701,3,8,2588,0,335000
3,1,1140,8800,3,7,1140,0,172500
4,2.5,2120,3220,3,9,2120,0,637250
3,2.25,1530,1245,3,9,1050,480,465000
3,2.5,1530,3464,3,8,1530,0,546000
3,2.5,2490,5928,3,8,2490,0,527900
3,1.75,1340,7210,4,7,1340,0,255000
4,2.5,3150,5979,3,9,3150,0,762500
4,2.5,2260,9686,4,7,1520,740,224950
4,1.75,1720,7200,3,7,1220,500,161700
3,2.5,1700,7210,5,7,1700,0,565000
5,2.5,3780,20000,4,9,1890,1890,725000
4,2.25,1900,8272,4,9,1460,440,715000
4,2,2990,102366,4,8,2990,0,510000
4,2.25,2070,7200,5,8,1390,680,625000
4,3,3470,4750,3,9,2370,1100,1.22E+06
2,1,870,5700,4,6,870,0,150000
3,2.5,2393,4788,3,8,2393,0,400000
3,2.5,2320,2267,3,8,2320,0,425000
3,2.25,2790,13791,3,8,2790,0,1.13E+06
4,3.5,3400,234352,3,8,2500,900,475000
3,1.5,1000,18568,3,6,1000,0,196000
5,2.5,2360,11375,4,7,1180,1180,317000
3,2,1760,5400,5,7,1160,600,715000
3,1.75,1480,8009,3,7,980,500,268000
3,1,880,6664,3,6,880,0,550000
4,1.75,2520,10890,3,7,1260,1260,272000
3,1,1350,4800,3,7,1350,0,585000
3,3,1790,13350,3,7,1190,600,336000
4,1.5,1610,6923,3,6,1010,600,275000
3,1,1060,9600,4,6,1060,0,206000
5,3.5,3610,52595,4,7,3610,0,587000
2,1,1000,7228,4,7,1000,0,311300
3,2,1990,3000,5,8,1430,560,619000
5,2.5,1900,9460,3,7,1190,710,450000
3,1.75,1380,3402,3,7,1380,0,550000
4,2.5,2480,4504,3,7,2480,0,425000
5,2.75,2390,6282,4,7,1290,1100,330000
3,1,1120,6625,3,6,1120,0,228950
3,2.5,2440,18674,4,8,2440,0,350000
3,1.75,980,6002,4,6,980,0,657500
4,1,1150,6000,3,6,1150,0,225000
3,2.5,2010,3200,3,9,2010,0,625000
2,1.75,2080,4800,5,7,1080,1000,740000
3,2.75,2660,223027,3,8,1330,1330,579000
4,2.25,2410,16650,4,8,2410,0,711800
5,2.5,2740,12413,3,7,2740,0,386000
3,1.75,1260,3328,5,6,700,560,570000
2,1.75,1110,1773,3,8,1110,0,229800
3,2.25,1760,9621,3,7,1760,0,350000
3,2.5,2100,7600,4,7,1450,650,509250
3,2.5,1910,1501,3,8,1530,380,585000
3,1.75,1460,7700,3,7,1460,0,424500
2,2.25,1550,1827,3,8,1550,0,320000
2,1,1080,4725,3,7,1080,0,390000
2,1,1210,5600,3,7,1210,0,402000
2,2,1080,5000,5,6,1080,0,460000
2,2,1550,2400,4,7,1550,0,526000
4,1.75,2160,39430,4,8,1660,500,753000
2,1.5,1008,26487,4,6,1008,0,480000
2,2.25,1530,981,3,8,1480,50,520000
3,2.5,2180,9722,3,8,2180,0,515700
3,1.75,1550,10050,5,7,1550,0,537000
4,1.75,2040,9322,3,8,1440,600,540000
3,2.5,1790,4065,3,8,1790,0,366000
2,1,1520,3360,4,7,830,690,535000
3,1.75,1440,4025,4,6,720,720,430000
4,2.5,2430,6325,4,8,2020,410,990000
2,2.5,1650,2710,3,8,1650,0,382000
4,2.5,3460,9699,3,10,3460,0,746500
3,1,2150,8480,3,8,1610,540,370000
2,2.25,1260,1240,3,8,1260,0,485000
4,3,2163,5883,3,7,2163,0,248000
3,2.5,1540,7739,4,7,1540,0,270000
5,2.5,2760,11340,4,9,2760,0,380000
4,2.5,3020,13122,3,9,2540,480,750000
3,1,970,5000,3,6,970,0,226000
3,2,1830,3500,5,7,1290,540,554000
3,2.25,2680,10440,3,8,1540,1140,721000
3,1,1380,7282,5,6,1380,0,189000
3,1.5,1180,8353,3,7,1180,0,347500
2,1.75,1250,7680,3,7,1250,0,400000
6,1.5,1810,4838,4,5,1050,760,230000
3,1,1080,5250,4,7,1080,0,329500
3,2.25,2120,3400,3,7,2120,0,289500
3,2.75,1840,68479,3,8,1340,500,406500
2,1,950,15996,4,7,950,0,193500
3,1,1640,12855,5,6,1500,140,1.01E+06
2,1.75,1810,7523,3,8,1170,640,501000
3,2.5,1981,5700,3,8,1981,0,303700
3,1.75,1450,5858,4,7,1450,0,265000
3,2.25,1480,1026,3,8,1480,0,580000
4,2.5,1600,6765,3,7,830,770,329000
3,1,1240,18000,2,7,1240,0,235000
5,2.5,2200,4080,5,7,1420,780,547000
3,1.75,1720,7587,4,7,1140,580,220000
3,3,1330,1379,4,8,1120,210,552100
5,2.5,2890,5110,3,9,2890,0,825000
4,1.75,1860,9750,3,7,1460,400,528000
2,2,1260,10200,3,7,1020,240,230000
4,2,2290,11137,4,8,2290,0,1.06E+06
4,2,2630,9663,4,8,1330,1300,435000
2,1,880,6413,3,7,880,0,425000
3,2.75,2620,17919,4,9,2620,0,1.88E+06
3,2,1750,9750,3,7,1350,400,279950
4,2.5,2700,8810,3,9,2700,0,690000
3,1,1180,8474,3,7,1180,0,310000
3,2.5,3460,6590,3,7,3460,0,467000
4,3.5,2980,6349,3,9,2980,0,1.34E+06
2,1,1420,16400,4,6,1420,0,306500
3,1.75,1750,11180,3,8,1750,0,260000
2,2.5,1770,1853,3,8,1770,0,369900
4,1,1560,4080,3,7,1560,0,627500
4,2,2280,10319,4,8,1270,1010,420000
3,2.5,1310,1254,3,7,850,460,390000
3,2.5,2510,5186,3,7,2510,0,571000
4,3.5,2210,7597,4,9,1550,660,1.10E+06
3,2.5,2655,5080,3,8,2655,0,409950
5,3.5,4890,12039,3,9,3590,1300,865950
3,1.5,1250,8710,4,7,1250,0,888000
4,2,1700,12048,3,7,1700,0,277500
3,2,1470,12096,4,6,1470,0,250000
3,1.75,1540,12446,5,8,1540,0,396450
3,2.5,2580,7500,3,9,2580,0,640000
3,1.75,1760,5355,3,7,1160,600,405000
4,1.5,1430,6380,4,9,1430,0,574500
3,2.5,2440,7419,3,7,1520,920,925000
4,4.5,3890,5906,3,11,3060,830,970000
3,1,1500,13500,4,7,1500,0,270000
1,2.5,1820,3008,3,7,1090,730,680000
5,3.25,4240,9588,3,9,4240,0,1.05E+06
4,3.5,3200,7605,3,9,2500,700,735000
3,2.25,3000,11665,3,11,3000,0,2.40E+06
4,2.75,2090,9240,4,6,2090,0,325000
3,1.5,1030,6969,4,6,1030,0,345000
2,0.75,720,5040,3,4,720,0,151000
4,2.5,2820,6666,3,9,2820,0,398500
4,1.5,1500,3075,5,7,1420,80,651500
2,1,580,7500,3,5,580,0,220000
4,2.5,2080,9846,3,7,1240,840,286950
3,2.5,1780,4050,3,7,1780,0,370000
3,1,1350,9680,4,7,820,530,172000
4,2.5,2480,8626,3,10,2480,0,420000
3,2.5,2530,16102,3,9,2530,0,435000
4,1,1860,4736,1,7,1860,0,427000
4,2.25,3180,6105,3,10,3180,0,1.32E+06
4,1,1780,4000,3,7,1780,0,440000
3,2.25,1400,1320,3,8,1400,0,367000
2,1.75,1430,7921,3,7,1430,0,350000
4,3,2720,3800,5,8,1800,920,739000
3,1,1360,8968,3,7,1360,0,355000
3,1.5,1870,7853,3,7,1300,570,485000
2,1,800,8775,3,6,800,0,353500
4,2.75,2910,7712,3,7,1600,1310,292000
3,1,1680,8010,3,7,840,840,350000
4,1.75,1690,4080,4,7,870,820,385000
3,2.75,1950,12240,3,7,1250,700,390000
4,2.5,2320,4524,3,8,2320,0,429950
3,1,1660,7440,3,7,1270,390,210000
3,2.5,3100,45738,3,10,3100,0,894400
3,2.5,1950,3825,3,7,1950,0,309000
3,3,1560,2091,3,8,1560,0,598500
4,1.75,2200,7475,5,7,1100,1100,375000
3,3.25,4720,32467,3,10,3190,1530,860000
5,2,1600,4168,3,7,1600,0,365000
3,1,990,10752,4,7,990,0,402500
3,2.5,2050,15035,3,9,2050,0,465000
4,2.75,2950,49658,4,8,2950,0,424900
4,2.75,2670,6780,5,8,1630,1040,675000
5,2.5,2570,9600,3,8,1620,950,710000
4,2.5,1740,6000,4,7,1740,0,339000
4,1.75,1950,4200,5,7,1040,910,601000
3,2,2680,8429,4,9,1880,800,653000
5,3,2080,6150,3,7,1040,1040,345000
3,2,1680,5036,4,7,1680,0,370000
4,2.5,2550,6382,3,7,2550,0,492000
3,2.5,1860,21876,3,8,1860,0,350000
4,2.5,2380,4913,3,8,2380,0,384950
3,1.5,1240,15867,3,7,1240,0,355000
4,1.75,2390,12000,3,8,1470,920,650000
2,1,800,5100,3,7,800,0,439000
3,2.25,1820,9670,3,8,1820,0,557500
3,2,1110,7231,4,7,1110,0,223000
3,2.25,1680,57063,4,8,1680,0,440000
4,2.25,2300,7700,3,7,1380,920,417000
3,2.5,2290,6328,3,8,2290,0,550000
3,1.5,1740,21980,4,7,1740,0,339000
4,2.75,3040,13559,3,11,3040,0,840000
3,2.5,1770,3451,3,7,1770,0,183750
3,1,1560,7800,3,7,1560,0,273000
3,1.75,1520,7350,4,7,1140,380,386500
3,1.5,2560,4000,5,8,1660,900,1.09E+06
4,2.5,2040,8076,3,7,2040,0,279000
3,2.5,1020,2217,3,7,720,300,280000
5,3,2520,13001,3,8,2010,510,670000
3,2.5,2430,7857,5,8,1730,700,359000
2,2.5,2390,7489,3,8,2390,0,699950
3,1.5,1010,10000,4,7,1010,0,212000
3,2.5,1820,1866,3,8,1570,250,327500
4,2.5,3180,5438,3,9,3180,0,650000
3,1.75,1630,11475,4,7,1330,300,308000
3,2.5,3570,35271,3,9,3570,0,725000
3,2.5,1440,3840,3,7,1440,0,476000
2,1,890,6350,3,6,890,0,314963
3,1.5,1250,7194,4,7,1250,0,358000
3,2,1290,7372,5,7,1290,0,253000
4,1.75,2660,11315,4,8,2660,0,557000
4,3,4370,217882,3,10,4370,0,897500
4,2.5,2300,7989,3,9,2300,0,560000
3,2.75,2090,9620,3,8,1340,750,300000
5,3,3655,51836,5,8,2174,1481,740000
3,2.25,1710,21485,3,7,1710,0,482000
3,2,1370,9760,4,7,1110,260,232500
5,1,1740,27350,4,5,1740,0,320000
8,6,4340,9415,3,8,4340,0,2.15E+06
4,2.5,2460,4200,3,8,2460,0,611000
3,2,1380,5000,4,7,1380,0,563000
3,2.5,2150,11672,3,8,2150,0,378000
3,1.5,1750,5400,4,7,1050,700,716528
5,2.75,2400,15781,4,7,1200,1200,406550
2,1.75,1860,5940,5,8,1020,840,672500
4,1.75,1880,3880,4,7,1090,790,560000
3,2.5,2450,4400,4,9,1800,650,952000
3,1,1020,5410,4,7,880,140,505000
3,2.5,1820,4910,3,8,1820,0,532000
2,1,1320,8865,4,6,1320,0,215000
3,2,1520,4000,5,6,800,720,369950
3,2.5,1960,4709,3,7,1960,0,425000
4,3.5,4390,11600,3,11,3060,1330,1.61E+06
4,2.5,3110,11422,3,9,3110,0,925000
3,2,1340,9764,3,7,1340,0,275000
3,3,1260,1634,3,8,1260,0,342000
4,1.75,1680,9244,3,8,1680,0,359000
3,2.25,1220,2980,3,7,1220,0,319000
3,1.5,1440,7875,4,8,1440,0,330000
4,2.75,3280,6845,3,10,3280,0,734500
1,1,550,5700,2,6,550,0,290000
4,2.25,2120,3794,4,7,1420,700,720168
3,1,1050,9206,3,7,1050,0,360000
2,1.75,1990,4000,5,7,1090,900,625000
3,1.75,2130,9775,4,8,1430,700,454900
4,2.25,2480,9780,4,8,1900,580,716000
4,3.5,3220,5741,3,9,3220,0,640000
5,2.5,3220,10572,3,8,3220,0,534950
2,1,930,3150,5,6,930,0,445000
4,2.5,2830,5932,3,9,2830,0,1.04E+06
3,1,1160,10881,2,7,920,240,280000
3,2.5,2605,2216,3,9,2090,515,789800
3,1.5,1380,4290,3,7,1080,300,650000
3,1.5,1580,10100,4,7,1580,0,296500
4,2.5,1910,10221,3,8,1910,0,369950
2,1.5,1240,3873,4,6,860,380,412000
5,3.25,3250,14342,4,8,3250,0,951000
4,1,1220,8500,5,6,1220,0,258000
3,1.75,1830,9425,3,8,1590,240,350000
3,1.75,1970,7100,3,7,1590,380,408000
4,2,1770,6000,5,7,1770,0,630000
4,3.25,3490,7024,3,10,3490,0,745000
4,2.5,2350,3800,3,8,2350,0,469995
2,1,1070,5000,3,7,1070,0,660000
3,1,1430,12420,3,7,1430,0,255000
3,3,2340,5002,3,8,2340,0,427874
5,3.75,5350,15360,3,11,3040,2310,3.35E+06
4,2.25,1990,7350,4,8,1180,810,280000
3,1,1460,10914,4,7,1460,0,250000
2,1,880,10950,4,7,880,0,372500
4,2.25,2360,7490,3,8,2360,0,577000
3,1.75,2310,11200,4,8,1630,680,385000
3,1.75,2190,12626,4,8,2190,0,340000
3,3.25,5290,224442,4,11,4540,750,1.80E+06
3,1.75,1220,8817,3,7,1220,0,231000
4,2.5,2550,8824,3,9,2550,0,422500
3,2.5,1270,1062,3,8,1060,210,433000
3,1,1320,5750,3,7,1320,0,279000
4,1,1310,5200,3,6,1160,150,200000
3,1,1170,3348,4,7,1170,0,457000
3,1,1000,4171,3,7,1000,0,352500
3,1.5,2440,7200,3,7,2440,0,550000
3,1,1440,7107,4,7,1000,440,478000
5,2.5,2750,5589,5,9,1840,910,915000
4,2.25,1530,7845,4,7,1030,500,620000
4,5.25,5240,320917,3,10,5240,0,1.86E+06
3,1.5,2390,4000,3,9,1690,700,978000
4,1,1610,24000,3,6,1610,0,235000
4,1,1610,8401,3,7,1610,0,269000
3,1.5,1460,15000,3,7,1460,0,232000
3,1,1110,4800,3,7,1110,0,532000
4,2.5,2720,7350,3,9,2720,0,368000
4,3.5,3190,5040,3,10,2160,1030,1.34E+06
3,1.75,1560,7500,4,8,1560,0,306000
6,2.75,2630,16411,4,8,1650,980,583000
3,1.5,1320,8114,3,8,1320,0,650000
3,2,1460,3000,4,7,940,520,499922
4,2.5,2040,6300,3,8,2040,0,315000
4,1.75,1940,7500,4,7,1720,220,274000
4,1.75,2250,8458,3,8,1450,800,559000
3,1.75,1590,7620,4,7,1090,500,274000
4,2.25,2020,10260,4,7,2020,0,599500
3,2,1440,4859,2,6,1440,0,509990
3,2.5,1800,2700,3,8,1800,0,362500
3,2.25,2220,15757,3,8,1280,940,558000
4,2.75,3120,5000,3,9,3120,0,800000
3,2.25,2060,9552,4,9,1610,450,885000
2,3,2020,5000,3,8,1350,670,742500
3,2.5,1776,1248,3,8,1604,172,620000
5,6,6880,279968,3,12,4070,2810,1.49E+06
2,1,790,5800,3,6,790,0,418500
4,2.25,3320,20100,4,8,1810,1510,962000
3,1,1350,8700,3,6,1350,0,160000
4,2.25,2420,10200,4,9,2420,0,998000
3,2.5,1440,7320,5,7,1440,0,430000
3,1.5,1500,10227,4,7,1000,500,257100
4,2.25,2090,7400,3,9,1670,420,274000
3,2.75,2610,11290,3,7,1630,980,757000
3,2,1460,4350,3,7,1460,0,362764
3,2.5,1920,7779,3,7,1920,0,279000
2,1.75,1180,55321,3,8,1180,0,311000
3,2.75,1320,15236,3,7,880,440,210000
3,1.5,1470,17577,5,7,1470,0,352500
4,3.5,3170,4000,3,10,2340,830,1.13E+06
3,2,1320,5665,3,7,1320,0,225000
2,1,990,4802,3,7,990,0,430000
3,2.25,2820,11625,3,8,2820,0,336000
4,1.75,1980,7350,3,7,1430,550,450000
3,2.25,2440,9200,4,8,2440,0,1.29E+06
3,2.25,2510,10418,3,8,1810,700,825000
3,2.5,1800,3933,3,8,1800,0,517500
3,1.75,1390,10905,3,6,860,530,270000
4,2.75,2660,7754,3,8,1590,1070,280500
3,1.5,1430,8960,4,6,1430,0,270000
4,2.25,1650,7200,3,8,1650,0,550000
4,2.5,3350,4501,3,9,2640,710,925000
3,1.75,1530,8800,4,7,1040,490,279950
1,1.5,810,3211,4,7,810,0,285000
2,2,1350,3926,3,8,1350,0,410000
4,2.75,2490,3840,4,7,1610,880,749500
3,1.75,1780,5850,5,7,980,800,565500
3,1,1480,5670,3,6,780,700,170000
3,1,920,7314,3,6,920,0,125000
2,1,2410,5930,3,9,1930,480,725000
4,2.75,2500,11659,3,9,1490,1010,350000
3,1.75,1340,6250,4,7,1090,250,499950
5,3,3720,25474,3,9,2090,1630,500000
5,3.5,2760,3846,3,8,2760,0,424950
2,2,1040,5796,4,6,1040,0,325000
6,2.5,2000,7650,4,7,1790,210,265000
3,2.25,2580,6000,3,8,1780,800,665000
3,2.75,2590,223027,3,9,2590,0,920000
5,3.5,4350,6218,3,10,3520,830,1.15E+06
2,1,880,3000,3,6,880,0,406000
4,3.25,3230,5000,4,7,1750,1480,826600
3,1.75,1570,15500,4,7,1570,0,555000
1,1,1110,5421,3,6,1110,0,293000
4,2.5,3700,21755,3,11,2620,1080,1.25E+06
3,1.5,1890,7650,5,7,1890,0,325000
4,2.75,2750,17789,3,8,1980,770,1.45E+06
3,1.75,1610,3210,5,7,910,700,626500
5,2.75,1510,5700,4,7,1510,0,1.00E+06
3,2.5,1810,4332,3,8,1810,0,517500
5,4.25,4010,8252,3,10,4010,0,1.15E+06
3,3.5,3500,9473,3,10,3500,0,797000
5,3.25,4390,11250,3,10,4390,0,1.51E+06
2,1,700,4350,3,6,700,0,328000
3,1,1020,8100,3,7,1020,0,229000
2,1,1680,6500,4,7,1140,540,515000
3,2.5,1950,7481,3,8,1950,0,622000
3,2,1290,9312,3,7,1290,0,215000
5,2.25,3510,13843,3,8,1850,1660,1.37E+06
3,2.5,2750,35440,3,9,2750,0,556000
3,1.75,1950,10633,3,7,1250,700,580000
3,2,1960,6450,4,7,1000,960,422500
3,1,1340,10035,3,7,1340,0,227000
3,2.75,1910,7280,3,7,1160,750,441000
4,2.5,2250,14440,3,7,1550,700,496500
3,2.5,2220,2873,3,10,2010,210,654000
3,1,1260,8280,3,6,1260,0,300000
2,1,930,5760,3,6,730,200,479500
2,2.5,1000,1092,3,7,990,10,163800
3,2.5,2070,4944,3,9,2070,0,1.25E+06
3,1.5,1380,7200,3,7,1080,300,426000
4,1.5,2230,11536,4,7,1220,1010,355000
3,1.75,1260,3604,3,7,1260,0,259000
3,2,1230,1340,3,7,1020,210,209000
3,1.5,1060,6954,4,6,1060,0,275000
4,2.5,3370,35150,5,8,1770,1600,592500
3,1,1090,6712,4,7,1090,0,344950
2,2.5,1770,7155,3,8,1770,0,1.18E+06
4,2.5,3320,38032,4,10,3320,0,805000
3,2.25,1840,6214,4,7,1270,570,285000
4,3.5,3210,5000,3,9,3210,0,889000
4,2.25,2200,6967,3,8,2200,0,515000
4,3.25,3960,7012,3,10,3960,0,860000
2,1.5,1088,1360,3,7,1088,0,250000
1,0.75,520,2885,4,6,520,0,310000
3,3.25,1530,1786,3,8,1200,330,560000
3,2.25,2070,14196,3,7,2070,0,379500
4,3.5,2780,9550,5,10,2530,250,995000
3,2,1730,9030,4,7,1730,0,575000
2,1,1070,2196,4,7,880,190,346000
4,1.5,2150,11026,4,7,2150,0,400000
4,3.5,3730,15029,3,10,2440,1290,599950
2,1,760,3800,3,6,760,0,135900
4,2.5,2350,3904,3,7,2350,0,400000
4,2.25,2190,6906,4,7,1040,1150,289950
4,3.5,3350,19487,3,11,2460,890,845000
5,4,4460,269345,3,9,3330,1130,833450
2,1,1120,9912,4,6,1120,0,256500
3,2.5,1920,3867,3,8,1920,0,571000
5,2.5,2740,5460,3,8,2740,0,370000
4,2.5,2420,10285,3,8,1700,720,760000
3,2.5,2720,13124,3,9,2720,0,835000
4,2.5,2950,43560,4,9,2550,400,1.87E+06
7,4,3150,34830,3,9,3150,0,999000
4,1.5,2010,7561,4,7,1890,120,245000
4,2.5,1940,4875,4,9,1940,0,1.15E+06
2,1,710,9900,3,6,710,0,129888
3,1.75,1870,25157,3,7,1870,0,475000
3,1.5,1240,9196,3,8,1240,0,357823
3,1.5,1200,7800,4,7,1200,0,195000
2,1.5,1480,43645,3,8,1480,0,525000
3,1.5,1840,10125,4,8,1220,620,830000
3,2.5,1480,1171,3,8,1480,0,500000
4,2,2090,4000,3,6,1060,1030,417000
2,2,1510,4908,3,8,1510,0,450000
3,2.25,1580,1487,3,9,1580,0,542300
3,2.5,2530,8820,3,8,2530,0,429000
2,1,1320,8830,3,7,1020,300,425000
3,1.5,2210,6300,5,8,2210,0,799000
2,1,800,5220,3,6,800,0,250000
2,1,1070,7386,3,6,1070,0,212000
4,2.5,4080,10295,3,10,4080,0,899000
4,2.75,2790,7803,3,8,2790,0,485000
5,3,3010,7357,3,9,3010,0,659950
4,3.25,4290,12103,3,11,2690,1600,1.38E+06
5,3,2970,10335,3,9,2970,0,726000
2,1,960,87991,3,5,960,0,180000
2,1,890,2100,4,6,760,130,460000
3,2.25,1190,1200,3,8,1190,0,475000
5,2.75,3100,9825,4,8,3100,0,700000
3,1,1150,4800,4,6,1150,0,200000
3,2.5,4560,17622,4,9,3800,760,695000
3,2.5,2540,4760,3,8,2540,0,347500
4,3.25,3640,3604,5,9,1960,1680,1.27E+06
3,1,1640,12384,4,7,1090,550,253500
2,1,930,5400,3,7,930,0,379000
3,1.75,1570,7775,3,7,1570,0,263000
3,2.5,2380,5269,3,8,2380,0,445000
5,4.75,7880,24250,3,13,7880,0,2.42E+06
3,1.75,2110,19600,4,8,2110,0,400000
3,1.75,1600,10280,3,7,1050,550,442500
3,2.5,2680,87117,3,7,1340,1340,475000
4,2.75,2150,9915,5,8,1240,910,411000
4,1.75,2000,6000,5,7,1000,1000,710000
4,2.25,3133,16197,3,9,2533,600,685000
3,1.75,1460,2800,3,7,1460,0,580000
2,1,1270,7440,4,7,910,360,400000
3,2.25,1590,11745,3,7,1090,500,190000
2,2,1130,5500,4,6,1130,0,250000
5,2.25,3470,28212,4,8,2790,680,455000
4,2,3090,41147,3,7,3090,0,870000
4,2.75,1760,9222,3,7,1140,620,255000
3,2.5,3170,7187,3,9,3170,0,720000
3,1.5,1310,2996,3,7,1310,0,398000
2,1,1120,4000,3,7,1120,0,465000
3,2.5,2140,7715,3,7,2140,0,349950
3,3.5,2620,10137,3,8,1970,650,538000
5,3,2510,4125,5,8,1590,920,881000
3,1.5,2240,3750,3,7,1220,1020,608000
3,2.5,1830,8022,3,8,1830,0,532000
3,2.5,1350,874,3,8,1270,80,389000
3,1.75,2140,6000,3,7,1070,1070,481500
4,2.5,1750,11400,4,7,1750,0,242000
4,2.25,2200,8292,3,7,2200,0,410000
5,2.75,2510,28185,4,7,1600,910,569950
4,2.5,2230,7200,4,7,1220,1010,556000
4,2,1770,8890,5,6,1770,0,355000
2,1,1240,7200,3,7,1240,0,215000
3,1,902,10464,3,7,902,0,152000
4,1.75,2050,10920,3,8,1450,600,790000
3,1.75,2390,11242,3,7,1290,1100,420000
4,2.5,1530,8375,3,7,1020,510,446000
4,2.5,1830,4500,3,7,1830,0,335000
4,1.75,1850,8580,3,7,1140,710,315000
4,2.5,3220,18618,3,10,3220,0,710000
3,2.5,1850,10109,3,8,1850,0,535000
2,1,1150,4000,3,7,1150,0,376000
4,2,1750,8116,4,5,1750,0,199500
4,2.5,2560,7210,3,9,2560,0,838000
3,2.25,1110,979,3,7,960,150,365000
4,2.25,2520,4200,4,7,1510,1010,415000
4,1.5,1580,6360,3,7,1290,290,525000
2,1.5,800,2119,3,7,800,0,265050
3,2.25,2000,7225,4,7,2000,0,334000
3,1.75,1710,7210,4,7,1240,470,273148
3,1.75,1780,8033,2,7,1210,570,475000
3,1,920,4800,4,6,780,140,490000
3,2.75,1960,6390,5,8,1960,0,759000
2,1,820,6366,5,6,820,0,294000
4,1,1390,3708,4,7,1390,0,610000
3,2.5,2410,17424,3,7,1630,780,330000
3,1.75,1770,10080,3,8,1770,0,495000
4,2.5,2960,6219,3,9,2960,0,367000
3,1,1250,7700,4,7,1250,0,463000
3,1,1240,4842,4,6,1240,0,210000
5,1.5,3360,5402,3,9,3360,0,804995
3,1.5,1630,11662,3,7,1630,0,185850
4,1.75,1820,6930,4,7,1320,500,350000
3,2.5,2210,8622,3,8,2210,0,590000
3,2.5,3870,46609,3,9,3870,0,1.28E+06
3,2.75,1800,9550,4,7,1320,480,665000
6,3.75,3810,6663,4,8,3810,0,752000
3,1.5,1350,7620,5,6,1350,0,211000
5,3,2230,6551,3,7,1330,900,347500
4,2.5,1770,9239,3,7,1770,0,353500
3,2.5,1780,1487,3,8,1600,180,586500
3,1.75,1430,7210,3,7,1430,0,257000
3,1,1200,7280,4,7,1200,0,215000
3,1,1140,8366,5,6,1140,0,239950
6,3.25,2820,4536,4,8,1930,890,875000
4,2.75,2910,6308,3,8,1640,1270,525000
4,2,1910,4225,4,6,910,1000,189950
3,2,1850,9600,3,7,1850,0,510000
3,2.5,1480,8381,4,7,1480,0,547000
2,1,940,3800,3,7,940,0,481203
3,2,2870,95396,4,9,1350,1520,560000
3,1.75,1700,17355,3,7,1200,500,314500
3,1,1010,7500,4,7,1010,0,340000
4,2,1800,2970,4,7,1000,800,415000
3,2,1890,6620,4,8,1890,0,690000
2,2.5,1450,1281,3,8,1220,230,590000
3,2.25,2510,12013,3,8,2510,0,358000
2,3,1270,1175,3,8,1110,160,531000
3,1.5,1810,8232,3,8,1810,0,300000
4,2.75,2460,9520,3,8,1680,780,704111
3,1,1390,4814,3,6,1390,0,341000
4,2,1510,3240,5,7,870,640,410000
4,2.5,2910,6555,3,9,2910,0,810000
3,2,1720,7704,4,7,1160,560,402000
2,2.5,2410,7500,3,7,1550,860,287000
2,2.5,1330,1249,3,8,1330,0,515000
4,2.25,2140,9377,4,8,2140,0,322500
3,2.5,3136,54450,5,8,3136,0,665000
1,1,420,3298,4,4,420,0,229050
4,3.75,3830,41263,4,11,3830,0,1.25E+06
4,1.75,1790,12000,5,6,1790,0,199900
2,1,870,4000,3,7,870,0,435000
4,2,1590,6750,3,7,1590,0,670500
3,1,1640,4000,5,7,1640,0,716100
7,3.5,2830,8625,4,8,1830,1000,450000
3,2,2110,6900,5,6,1220,890,285000
4,1,1700,7689,3,7,1080,620,456000
3,1,1120,10032,3,7,1120,0,355500
3,1.75,2320,55847,4,8,2320,0,541500
4,2.75,2060,8100,4,7,1310,750,310000
3,2.5,2400,6975,3,9,2400,0,570000
3,2.25,1340,7202,4,7,1340,0,279950
3,1.5,2390,23522,2,7,1890,500,250000
3,2.25,1730,10030,4,8,1730,0,300000
3,1.75,2420,65501,3,8,2420,0,500000
4,2.75,2420,8438,3,8,2420,0,307999
2,1,970,13700,3,6,970,0,300000
5,4.75,6240,47480,3,11,4610,1630,2.95E+06
3,2.25,2680,41250,3,7,2680,0,590000
3,1.75,1000,14061,4,7,1000,0,410988
2,1,1070,5280,3,6,1070,0,510000
3,1.75,1550,8134,4,7,1550,0,432000
3,3,2410,7479,3,7,2410,0,537000
3,1,1690,7700,4,7,1690,0,215000
4,2.5,2850,11000,3,8,2850,0,760000
1,2,1150,9812,4,7,1150,0,227000
4,2.5,2740,9959,3,9,2740,0,648000
4,2.75,3170,7634,3,10,3170,0,750000
3,2.5,1940,9874,3,7,1940,0,285000
3,1,840,6500,5,6,840,0,178000
4,2.5,1970,5190,3,7,1970,0,315000
3,1.5,1310,7236,4,7,1170,140,526500
2,2.5,1170,1811,3,8,1170,0,400000
4,2.25,2210,9371,4,8,2210,0,305000
3,3.75,2380,3600,3,7,1690,690,695000
4,2.5,3030,8507,3,9,3030,0,902000
3,2.5,2250,5692,3,8,2250,0,445838
4,2.5,2382,5899,3,8,2382,0,345000
3,1,1240,5000,5,7,1240,0,529950
3,2.25,1620,7772,4,8,1620,0,290000
4,2.5,1960,7875,3,7,1220,740,234500
3,2,1940,4500,3,7,1090,850,700000
3,2,1990,203861,3,7,1990,0,246000
4,2.25,2530,5200,4,8,1530,1000,720000
3,1.75,1540,1044,3,8,1540,0,549000
3,2,2360,6149,3,8,1560,800,690000
4,2.5,2350,10655,3,8,2350,0,339100
3,2.75,2660,32757,4,8,2660,0,580000
3,1.75,1800,9000,3,7,1200,600,257000
4,4,4320,8709,3,11,3190,1130,1.05E+06
3,1.5,1120,6900,5,7,1120,0,439800
4,2,3380,90968,4,9,1690,1690,850000
4,1.5,1490,7560,3,7,1490,0,259000
4,2.5,2000,5390,3,7,2000,0,284000
7,4,2960,2665,3,9,1950,1010,853800
3,2.5,2300,5500,4,8,2000,300,635000
4,2.25,2430,4748,3,8,1630,800,723000
4,2.5,2250,4119,3,8,2250,0,585000
4,2.25,2050,8372,4,8,2050,0,595000
3,1.5,1270,2356,3,7,1270,0,160797
5,2.75,3260,9253,3,8,3260,0,365000
2,1,1760,5250,4,7,1000,760,490000
3,3.5,3460,15745,3,10,3460,0,845000
4,2.5,3350,6605,3,8,2670,680,550000
6,2.5,2680,11250,5,7,1340,1340,698000
4,2.5,2052,3723,3,8,2052,0,349900
3,2.25,2140,7200,4,7,2140,0,280000
4,2.75,3500,6226,3,9,3500,0,775000
3,1.5,1500,6332,3,7,1500,0,332500
3,1.75,1530,7245,4,7,1530,0,440000
3,4,3370,8252,3,10,3370,0,1.07E+06
4,3.5,3900,8391,3,10,3900,0,1.04E+06
4,2.75,3530,6844,3,10,3530,0,908990
4,2,1340,8190,4,7,1340,0,287000
3,3,4560,16339,3,10,4040,520,1.22E+06
2,1,790,7275,4,6,790,0,150000
2,1,770,11084,4,6,770,0,257000
4,3,2350,5627,5,8,1490,860,625000
4,2.25,2190,3850,3,7,2190,0,391000
4,2.75,2720,4000,5,8,1840,880,1.06E+06
3,2,1170,7258,3,7,1170,0,250000
3,2.5,1640,3804,3,8,1640,0,602000
3,2.25,1950,8661,4,8,1950,0,269000
2,1,1080,4000,3,7,1080,0,874950
3,2,2005,7000,3,7,1605,400,491000
4,2,2240,9240,3,7,1120,1120,309000
4,1,1100,5000,5,6,1100,0,330000
5,2.75,2410,5003,3,7,1410,1000,365000
3,1.75,1520,12282,3,8,1220,300,360000
4,2.5,2095,4569,3,9,2095,0,670000
3,2.25,1500,15334,4,7,1500,0,240000
3,1,1480,8415,3,7,1080,400,175000
3,1.5,1090,7200,4,7,1090,0,698000
3,2,1260,2500,4,7,750,510,503000
2,1,900,13531,3,6,900,0,174000
2,2.25,2460,16940,4,9,1930,530,1.37E+06
4,2.5,2380,5000,3,8,2380,0,360000
3,3.5,1450,1091,3,8,1200,250,550000
4,3,3370,100681,5,8,1920,1450,785000
3,1.5,1650,9936,3,7,1090,560,219950
4,3.5,2970,14486,3,9,2340,630,905000
5,2.5,3750,91681,3,10,3750,0,2.90E+06
3,1.75,1700,9840,4,8,1200,500,502775
3,1.75,1800,7199,3,7,1300,500,500000
3,1,1150,6800,3,7,1150,0,410500
3,2.5,2290,9158,4,8,2290,0,822000
4,1.5,1810,9000,3,7,1810,0,259000
4,2,3740,32417,3,9,3740,0,860000
4,2.5,3170,5100,3,9,3170,0,745000
3,2.25,2060,31400,3,8,2060,0,560000
3,2.5,2340,59058,3,8,2340,0,485000
3,2.25,2400,5300,4,7,1250,1150,672500
4,2.25,2360,4000,3,9,2360,0,1.30E+06
3,2.25,1880,100623,3,8,1880,0,530000
3,1.75,1330,8136,4,7,1330,0,525000
3,2.25,2510,12013,3,8,2510,0,225000
3,2.5,1860,1290,3,9,1240,620,730000
2,1.5,2130,35679,4,7,2130,0,830000
4,4,6330,13296,3,13,4900,1430,2.39E+06
3,1,1270,4268,3,7,1270,0,475000
5,1.75,1910,9720,4,7,1390,520,565000
4,3.5,3090,4060,3,8,2420,670,760000
4,2,2460,5921,4,7,1230,1230,247500
5,2.5,2350,4000,3,9,2350,0,1.02E+06
3,1.75,2250,26337,3,8,2250,0,325000
4,3.5,3950,6240,3,11,3950,0,1.70E+06
3,1.75,1660,5750,4,7,1080,580,680000
4,2.25,2000,10679,3,7,1350,650,330000
3,2.5,2160,4000,3,8,1960,200,640000
5,2.5,2840,6010,3,8,2840,0,372000
3,1,1140,4200,4,7,1140,0,345000
4,2.5,1750,9000,3,8,1410,340,625000
2,1,1270,9182,3,6,1270,0,235000
2,1,1010,10057,3,6,1010,0,199950
4,2.5,2120,3640,3,8,2120,0,599000
4,1,1530,3900,4,7,1530,0,583500
5,1.75,3690,36036,3,9,1890,1800,440000
4,1.75,1920,7500,4,7,1920,0,170000
4,2.75,4280,12668,3,9,3900,380,1.90E+06
4,2.5,2540,12843,3,9,2540,0,350900
3,1.75,1970,8540,4,8,1130,840,606000
3,1,1160,9525,4,7,1160,0,325000
3,2.5,1530,2913,4,7,1530,0,379000
3,2,1480,2502,3,7,1480,0,355000
4,2.75,3000,6222,3,9,3000,0,705000
3,3.25,3790,19000,3,10,3790,0,1.60E+06
3,2.5,1930,5080,4,8,1930,0,533600
4,4.5,5550,16065,3,9,3880,1670,1.65E+06
4,1.5,2310,13300,3,7,1890,420,1.11E+06
3,2.5,1520,3593,3,7,1520,0,288000
3,1.75,1560,242629,3,7,1560,0,590000
3,2.5,2320,36847,3,9,2320,0,437500
3,1,980,9135,3,7,980,0,185000
3,1.5,1950,4473,4,6,1530,420,400000
5,3.25,4150,7100,3,10,4150,0,929000
4,1,1120,2685,3,5,860,260,100000
5,2,2960,10960,4,7,1500,1460,800000
4,3,2570,8022,4,8,1370,1200,655000
2,1,800,5040,3,6,800,0,350000
2,1,760,4000,3,6,760,0,380000
3,2.5,3630,11019,4,9,2150,1480,1.09E+06
3,1,1190,5280,4,7,1190,0,410000
4,2.5,2270,11500,3,8,1540,730,624900
3,2.5,3010,74390,3,10,3010,0,775000
4,1.75,2260,12238,3,9,2260,0,833000
2,1,1370,8400,3,7,1370,0,296000
3,2.5,3110,217800,3,9,3110,0,559000
5,2.5,3370,8113,3,9,3370,0,1.25E+06
4,1,1480,6500,4,7,1480,0,335000
5,1.75,2140,8580,3,7,1200,940,528000
4,2.75,3660,150282,3,10,3660,0,730000
3,1,1230,4600,3,7,1230,0,522000
3,3.25,2760,6420,3,9,2110,650,375000
4,2.5,2755,4831,3,7,2755,0,625250
2,1.5,2440,6900,3,7,1590,850,662700
3,1,1160,8950,3,7,1160,0,294950
4,3,2720,4800,5,8,1790,930,1.02E+06
3,2.5,1690,1553,3,8,1690,0,640000
2,1.75,1220,15600,3,6,1220,0,215500
3,2.5,2060,4399,3,7,2060,0,418500
2,1.75,1210,9750,3,7,1210,0,156601
3,1.75,1270,6017,4,7,1030,240,406000
4,2.5,2350,7203,3,8,2350,0,440000
4,2.5,2130,9139,3,9,2130,0,620000
4,2.5,3870,50965,3,10,3870,0,600000
3,2.5,2450,5760,3,9,2450,0,672500
4,2.5,2260,13755,4,9,2260,0,350000
3,1,1580,6300,3,7,1180,400,535000
3,1.75,1890,11875,3,7,1230,660,271900
4,3,2840,13554,4,9,1990,850,760000
3,1.75,2120,56192,3,9,1720,400,892500
4,1.75,1890,9623,4,7,1290,600,314950
4,3.5,3510,9263,3,10,3510,0,723000
3,2.25,1560,11997,3,7,1260,300,399950
3,1.75,1670,12075,3,7,1370,300,418000
3,2,1970,79714,3,7,1070,900,360000
4,2.5,2007,4968,3,9,2007,0,305950
3,2.5,1610,3755,3,7,1610,0,395000
3,2.25,1700,12615,4,7,1300,400,660000
3,1,2480,8906,3,7,1240,1240,350000
4,3.5,3420,4751,3,10,3420,0,549900
3,2.5,1850,4957,3,8,1850,0,303000
3,2,1490,9000,4,8,1490,0,391000
4,3,2720,7570,3,9,2720,0,560000
3,3.5,3760,5634,3,11,2830,930,2.23E+06
3,1.75,2440,10179,4,7,1220,1220,280500
5,2,2020,67953,4,7,1620,400,287500
4,2,1980,10051,3,7,1980,0,279000
5,2,2330,10750,4,7,1190,1140,389000
4,3,1670,2642,3,8,1350,320,710200
4,3.5,4970,16582,4,11,3930,1040,1.44E+06
4,3.5,2690,6164,3,9,2690,0,699850
4,2.5,2550,56628,3,9,2550,0,575000
2,1,890,8100,3,6,890,0,150000
2,1,1100,3500,5,7,1100,0,474000
3,2,2440,23512,3,6,1640,800,338000
5,1.75,2330,6450,3,8,1330,1000,465000
3,1.75,1510,6000,3,7,1060,450,360000
3,2.5,2520,10175,3,8,1630,890,685000
3,2.75,1840,2060,3,10,1700,140,599000
4,2.5,2580,5476,3,8,2580,0,354000
3,2.5,1760,1755,3,8,1760,0,544000
3,1.75,2490,7210,3,7,1290,1200,475000
3,2.5,2560,16420,4,8,2560,0,470950
4,1.75,2520,15205,4,7,2040,480,387846
6,2.5,3370,15625,3,8,1770,1600,570000
3,1,1550,8778,3,7,1250,300,299000
4,3,1920,4000,4,8,1540,380,667500
5,2.25,2240,9652,3,7,2240,0,238000
5,3,2420,11250,3,8,2420,0,445000
3,1.75,2050,11856,3,7,1460,590,655275
4,2.5,3510,17400,4,9,1930,1580,931088
6,4.25,6980,15682,4,12,5330,1650,3.10E+06
4,2.5,2210,8465,3,8,1490,720,294000
3,2.5,2060,5750,3,7,1330,730,577000
3,2.5,2540,4260,3,7,2540,0,325000
3,1,1210,103237,2,6,1210,0,160000
3,1.5,1380,4500,5,7,1380,0,650000
3,1.75,1360,10742,5,7,960,400,296000
3,1.75,2760,9137,3,7,1380,1380,465000
2,1.75,1240,2493,4,8,1240,0,188500
2,1.5,1670,6000,3,7,1090,580,612125
3,1,910,8450,4,6,910,0,274250
3,2,1280,13356,3,7,1280,0,232000
4,2.5,2170,19785,3,8,2170,0,340000
3,2.25,1470,1578,3,8,1090,380,432000
3,1.5,1170,1174,3,7,840,330,275000
4,1,1360,5814,2,6,1360,0,560000
4,1.75,1640,10500,4,7,1010,630,402000
4,3.25,3600,38016,3,11,3310,290,1.42E+06
4,2.75,2660,7389,3,9,2660,0,695000
4,2.25,2590,13894,4,9,2590,0,925000
4,2.5,2700,6998,3,8,2700,0,383962
3,1,1440,5000,3,7,1440,0,560000
4,2.5,2650,11108,3,10,2650,0,672500
3,2.25,1740,9672,4,7,1110,630,269900
2,1,750,5120,4,6,750,0,300000
5,2.25,2240,5500,3,7,1490,750,480000
4,3.5,4660,17398,3,11,4660,0,1.28E+06
2,1,940,3864,4,8,940,0,543000
4,2.5,4660,7157,3,9,3020,1640,760000
3,1,1200,6628,4,7,1200,0,345000
3,2.5,2440,4244,3,8,2440,0,729000
3,2.5,2110,4549,4,8,2110,0,336000
1,1,580,1799,3,7,580,0,330600
3,2.5,2100,5060,3,7,2100,0,477000
4,2.5,2860,6600,3,9,2860,0,666500
4,2.5,3490,5000,3,8,3490,0,320000
3,2.75,1750,9166,4,7,1170,580,370000
5,3.5,2880,5000,3,8,2260,620,419900
4,3,4480,42717,3,9,4480,0,835000
3,1,840,9480,3,6,840,0,199950
3,1.75,1660,7350,2,8,1660,0,188000
4,2.75,1970,37026,4,8,1970,0,395000
3,2,1590,9912,3,8,1590,0,385000
4,2.5,2330,4606,3,8,2330,0,308000
6,3.25,3750,14150,5,9,2750,1000,1.25E+06
4,3.25,2630,7770,3,9,2630,0,715000
3,1.75,1380,3225,4,7,940,440,539000
3,1,1050,5000,4,6,1050,0,200000
4,2.25,2160,8817,3,7,1460,700,499950
3,2.5,1830,7585,4,8,1830,0,325000
3,2,1460,5715,3,7,1460,0,340000
4,2.5,2200,5893,3,7,2200,0,280000
3,2.5,1390,4997,3,7,1390,0,440000
4,1.5,1120,5427,3,6,1120,0,219900
3,1.75,1100,7373,4,7,1100,0,240000
3,2.5,1626,1583,3,8,1419,207,526000
4,2.5,2390,10000,3,9,1590,800,800000
4,2.5,2500,8215,3,8,2500,0,372000
3,1,1700,6356,3,7,1700,0,681000
4,2.5,3230,4290,3,9,3230,0,765000
4,2.25,2110,12653,4,8,2110,0,825000
4,3.75,3520,3944,5,8,2200,1320,1.22E+06
3,2.5,1680,4075,3,7,1680,0,394000
2,1,610,4560,3,5,610,0,400000
4,1,1980,10350,4,7,1430,550,395000
3,2,1630,8702,3,9,1630,0,445000
3,2,1700,5100,4,7,1500,200,712000
4,1,1820,5500,3,6,1820,0,367000
3,2.5,2090,6045,3,8,2090,0,415000
6,3.5,4310,7760,3,10,3260,1050,1.17E+06
4,2.5,2070,6180,3,8,2070,0,410000
2,3,1790,1709,3,7,1400,390,450000
4,2.5,2160,8005,3,7,2160,0,220000
2,1,670,1675,5,6,670,0,245000
3,2.5,1850,1330,3,9,1560,290,827000
4,1,1940,9533,3,7,1080,860,265000
4,2,1650,6000,5,7,1000,650,445000
3,2.5,1450,3850,3,7,1450,0,359000
2,1,1110,3943,5,6,740,370,410500
2,1,1760,27332,4,7,1300,460,500000
3,2.25,2180,11100,5,8,1700,480,415000
5,2,1890,6050,4,7,1890,0,339950
3,2.5,1540,1564,3,7,1300,240,384000
2,2,990,5416,3,6,990,0,600000
4,2.5,2230,8560,3,8,2230,0,500000
2,1,1420,81892,3,7,1180,240,360000
1,0.75,420,6720,3,5,420,0,280000
4,2.5,2050,6705,4,7,1230,820,479000
2,1,1130,8081,4,7,1130,0,345000
3,3.25,3780,10623,3,11,2650,1130,1.15E+06
2,1.5,1430,9782,3,7,1430,0,245500
2,1,950,6350,3,7,950,0,287000
3,2.5,2420,4725,3,8,2420,0,367899
3,2.5,1730,4102,3,8,1730,0,960000
3,2,1650,11256,4,7,1250,400,294000
3,1,1220,7585,4,7,1220,0,765000
4,1,1340,7920,4,7,1340,0,205000
5,2.75,3240,6863,3,10,3240,0,719950
2,1.75,1160,8625,4,6,1160,0,312000
3,1.75,2040,4005,4,8,1740,300,620000
2,1.75,910,2693,3,6,910,0,200000
2,1.5,820,1270,3,7,820,0,365000
6,4.5,2940,7500,4,8,2940,0,482500
5,3,2660,7700,4,7,1670,990,335000
3,2,1470,2781,3,6,1470,0,250000
3,1.5,1340,7912,3,7,1340,0,313000
3,1.75,2519,8690,5,8,2519,0,505000
5,4.75,3830,35000,3,8,2130,1700,480000
3,1,1280,5100,3,7,880,400,190000
4,2.5,2200,6400,3,8,2200,0,460000
3,2.5,3160,286181,3,9,3160,0,579000
4,2.5,2540,8706,3,9,2540,0,630000
2,1.75,1050,9800,4,6,1050,0,175000
2,1,1260,4800,3,6,1100,160,280000
3,1.75,1320,7840,3,8,1320,0,475000
4,2.5,2900,18303,4,10,2900,0,800000
3,2.5,2320,15024,3,8,2320,0,447500
4,1,1550,15239,3,6,1370,180,685000
5,3.25,4020,40341,5,8,2170,1850,590000
3,2.75,2190,11060,4,7,1610,580,700000
2,1.5,980,1296,3,7,840,140,260000
4,2.75,1910,7210,4,7,1430,480,200000
4,2.25,2510,9963,4,9,2200,310,800000
3,1.75,2010,3800,2,7,2010,0,575000
4,2.75,1680,9545,4,7,1080,600,425000
3,2.5,1330,1064,3,8,1330,0,375000
3,2.5,1560,5259,3,8,1560,0,566000
2,1.75,1070,9750,3,7,1070,0,241000
5,2.5,3150,5150,5,8,1870,1280,614000
3,1.75,1450,8378,4,8,1450,0,230000
6,4,3020,13237,3,8,2840,180,1.90E+06
2,1,1620,5400,3,6,920,700,290000
2,1,820,4206,3,5,820,0,510000
3,2,1650,7352,3,7,1160,490,252350
5,2.5,2770,8100,3,9,2770,0,1.31E+06
2,2,1300,3850,3,7,800,500,378000
4,2.25,2030,2222,3,9,1610,420,765000
3,1.75,1510,9720,3,7,1510,0,335000
3,2,1750,2640,3,8,1010,740,808250
3,2,1860,42800,4,7,930,930,615000
3,1.75,2790,36585,4,8,1410,1380,478000
2,1,770,9715,4,6,770,0,217000
4,2.5,3250,4650,3,8,3250,0,353500
4,2,2000,46902,3,8,2000,0,570000
3,2.5,1560,10608,3,7,1560,0,254000
4,2.25,2020,4960,3,7,1710,310,490000
1,1,1160,64469,3,7,1160,0,440000
2,2.5,1240,3649,3,7,1240,0,153503
2,1,790,5240,4,6,790,0,299800
3,1.75,1100,5525,5,6,1100,0,209950
3,1,1360,3737,4,6,1360,0,450000
3,2.25,2330,4000,5,7,1520,810,680000
4,2.25,1740,8449,4,7,1170,570,455000
4,1.75,1700,7800,5,7,1120,580,349000
4,2.5,3500,7519,3,9,3500,0,790000
4,2.25,4070,23321,4,10,4070,0,993500
2,1,1040,9100,4,7,1040,0,227000
5,2.75,3080,6600,3,9,3080,0,475000
3,1.75,2350,20820,4,8,1800,550,615000
4,2.5,2000,5006,3,7,2000,0,349950
4,2.25,1800,7200,3,7,1230,570,475000
3,1,1180,3400,3,8,1180,0,610000
3,1,920,6750,4,7,920,0,650000
4,3.5,4670,6000,3,11,3820,850,1.24E+06
2,1.75,1330,7200,3,7,1330,0,240000
3,1,1450,7930,4,6,1150,300,394000
4,2.5,3130,7582,3,8,3130,0,665000
3,1.5,1110,10296,5,7,1110,0,255000
5,3.25,3860,9387,3,9,3860,0,820875
2,1,1210,3090,3,6,860,350,366000
2,2.5,1310,1500,3,8,1160,150,500000
5,3.5,2420,4670,3,7,2420,0,380000
4,1.75,1290,3060,4,7,1290,0,549000
3,2.5,2090,10834,4,8,1360,730,285000
3,1,880,7648,4,6,880,0,215000
3,2.5,1950,9618,3,7,1950,0,315000
3,1.75,1420,8250,3,7,1420,0,265000
4,2.5,3440,6332,3,10,3440,0,781500
3,3.75,2050,6000,5,7,1550,500,645000
4,3.25,3730,7071,3,11,3730,0,1.78E+06
3,1,1600,3200,3,7,1600,0,488000
2,1,990,4313,4,6,990,0,442000
4,3.75,4520,9240,3,10,3270,1250,1.25E+06
2,1,1390,3600,4,7,1010,380,608000
5,2,2120,137565,3,7,2120,0,437000
3,2.5,2500,4203,3,8,2500,0,539900
4,2.5,2220,5338,3,7,2220,0,370000
4,1,1450,8960,3,6,1450,0,244000
4,2.5,3290,5951,3,9,3290,0,728000
4,2.5,2220,7210,3,7,1270,950,467000
2,1,780,6250,3,6,780,0,270950
3,2,2060,4040,4,8,1120,940,605000
3,1,1010,12705,4,7,1010,0,229000
5,4.75,3940,7067,3,10,3230,710,1.70E+06
3,1.75,1160,8774,3,7,1160,0,370000
3,1,1280,9656,4,6,920,360,309000
3,2,2540,237402,3,9,2540,0,600000
5,1.75,2290,4320,3,7,1980,310,848000
3,1.75,1560,82328,3,7,1560,0,310000
3,1.75,1260,8614,4,7,1260,0,245000
3,2.5,1780,5015,3,7,1780,0,270000
4,3.5,2600,5100,3,8,1820,780,722500
5,2,2040,6180,4,7,2040,0,475000
2,1,1088,8453,3,6,1088,0,238000
2,1.5,2010,7755,3,7,2010,0,218000
3,2.5,2070,3986,3,8,2070,0,423700
4,2.75,3150,6343,3,8,1810,1340,750000
3,2,1270,1320,3,8,1270,0,369950
4,1.5,1860,7808,3,7,1080,780,450000
3,1,940,8512,4,7,940,0,355000
4,2.5,3330,7399,3,9,3330,0,760000
3,3,1530,2132,3,8,1530,0,199950
3,2.5,2490,8582,3,9,2490,0,654300
4,2.5,1980,6568,3,8,1980,0,638500
4,3.25,4750,62365,3,11,4750,0,1.12E+06
4,2.5,4070,7800,4,8,3390,680,1.40E+06
3,2.75,2470,3600,3,9,2470,0,773000
5,2.25,2530,8250,4,7,2530,0,527500
3,2.75,2720,31314,3,8,2720,0,455000
5,2.5,3020,9648,4,9,1980,1040,975000
3,2,2570,10078,3,8,2570,0,670000
4,2.5,3040,35201,4,10,3040,0,725000
4,2.5,3140,16200,3,9,2570,570,765000
2,1.5,1300,4000,4,6,1300,0,431000
3,1,900,8100,4,6,900,0,179500
4,4.25,4850,12445,5,10,3850,1000,3.00E+06
3,1.75,1430,39160,3,7,900,530,279000
3,2.5,1990,3984,3,8,1990,0,560200
3,1.75,2060,3300,4,9,1500,560,810000
3,1.75,1800,8000,3,8,1800,0,665000
2,1,790,6555,2,6,790,0,285000
4,2.5,2160,10987,4,8,1440,720,555000
4,4,4430,31353,3,12,4430,0,1.96E+06
4,2.5,1930,14196,4,7,1330,600,425000
4,2.5,2230,8500,3,8,2230,0,325000
3,2,1690,9087,3,8,1690,0,337000
4,1.5,1700,8400,3,7,1700,0,502000
3,1.5,1400,6527,3,7,1110,290,265000
3,2.5,2270,9600,3,9,2270,0,575000
4,2,3160,11193,5,6,2410,750,368000
3,2.5,1830,6162,3,8,1830,0,298900
4,3,2590,6250,3,9,2240,350,855000
4,1.5,3050,82764,3,8,1650,1400,555000
3,2,1450,9333,4,7,1450,0,245000
5,1.75,2300,6720,3,7,2300,0,400000
4,2.5,2470,5015,3,8,2470,0,352000
4,1.5,2820,4000,3,7,2820,0,635000
4,1,1030,6621,4,6,1030,0,205000
3,1.75,1620,5000,3,7,920,700,514000
2,1,700,6000,4,6,700,0,267800
3,2.25,1850,37264,3,8,1850,0,550000
4,2.25,2580,7344,3,8,2580,0,588000
3,2,1230,3405,3,7,1230,0,295000
3,1.75,1760,8025,4,7,1230,530,440000
3,1.5,1800,10050,3,7,1800,0,583000
3,1.5,1500,5000,4,7,1140,360,470000
3,2.5,2030,4867,3,7,2030,0,295000
3,2.5,2540,11562,3,8,1290,1250,374950
3,1.75,1930,7200,3,6,1930,0,285000
4,2.75,3250,5500,3,9,3250,0,800000
4,2.5,2490,34947,3,9,2150,340,520000
4,2.25,2150,27345,5,8,2150,0,410000
3,1.75,2390,7149,3,8,1350,1040,396500
4,2.25,1800,8623,4,8,1360,440,522000
2,2,2930,14057,4,8,1680,1250,545000
3,1.75,1080,9262,3,7,1080,0,185000
4,2,1530,6375,3,7,1530,0,231000
3,2.5,1810,3192,3,7,1070,740,355000
3,1,1640,7187,3,7,1640,0,230000
4,2.25,1310,8400,4,7,1310,0,421000
4,2.5,1677,7209,3,7,1677,0,295000
4,3.5,3720,213073,3,10,3720,0,780000
4,3,2350,9952,3,9,1650,700,397500
5,2.25,2070,10488,4,7,1080,990,400000
3,2.5,2460,12028,3,9,2460,0,693000
3,2.5,2420,7423,3,8,2420,0,339900
4,2.25,3440,35025,3,10,3440,0,853000
3,1,1040,8892,4,6,800,240,183500
4,2.5,1810,13000,4,8,1470,340,279000
3,2.5,1590,7819,3,7,1590,0,338000
3,2.5,2630,10100,4,9,1580,1050,852500
3,1.75,1770,8571,3,8,1270,500,240000
3,1,1200,7200,3,6,1200,0,210000
4,3.75,5850,35070,4,12,4410,1440,1.53E+06
2,1,960,13438,3,7,960,0,208000
2,1,1030,8576,5,6,1030,0,315000
4,2.5,2140,7095,3,8,2140,0,350000
3,1.75,1160,6134,3,7,1160,0,250000
3,1,1090,6771,3,7,1090,0,180000
5,1.75,1930,501376,3,7,1930,0,800000
4,2.5,2430,5000,3,7,2430,0,480000
4,2.25,2170,8050,3,7,1220,950,466000
3,2.5,1210,2046,3,9,920,290,299900
3,1.75,1750,10870,5,7,1750,0,380000
3,3,2240,11536,3,7,2240,0,323500
3,1.75,1650,12349,3,7,1650,0,259500
4,3.5,3150,5500,3,9,3150,0,1.21E+06
3,2.5,3050,7410,5,8,1950,1100,975000
4,3.5,5550,28078,4,12,3350,2200,3.71E+06
4,2,2000,5000,5,7,2000,0,630000
2,1,830,2699,3,7,830,0,175000
3,2.5,2110,4118,3,8,2110,0,345950
2,1,1040,13100,5,6,1040,0,160000
3,1,1010,8800,4,7,1010,0,205000
5,1.75,2000,3750,4,7,2000,0,585000
3,3.75,1580,1303,3,8,1340,240,550000
2,1,840,7414,4,6,840,0,360000
2,1,880,5111,3,6,880,0,400000
3,1,860,33664,4,6,860,0,199129
4,1,1440,8250,3,7,1440,0,220000
3,2.75,2190,7258,3,8,2190,0,345000
2,1.5,920,1598,3,7,920,0,255000
3,2.25,1250,952,3,8,1250,0,205000
4,1.5,1430,7232,3,7,1430,0,375000
3,1,1250,7157,3,7,1250,0,400000
4,1.75,1920,7455,4,7,960,960,571500
2,1,1640,14100,4,7,1140,500,500000
4,3,1790,3600,3,8,1790,0,546000
3,2.5,4570,10615,3,12,4570,0,1.04E+06
2,1,800,6380,3,7,800,0,379000
4,3,2540,8800,3,9,1620,920,374950
4,1.75,2160,7700,2,8,2160,0,429000
2,2,1350,2560,4,8,1350,0,382000
2,1.75,1610,6300,3,7,1010,600,346500
4,3,3130,5700,3,7,1750,1380,671000
4,3,2170,2500,3,8,1710,460,767250
4,2.5,2600,6536,3,9,2600,0,600000
4,2.5,2760,5564,3,7,2760,0,424950
5,3.75,2380,7268,3,8,1430,950,545000
3,2.5,1720,3951,3,7,1720,0,256900
4,2.25,2090,35040,3,8,1490,600,610000
5,1.75,2140,43124,4,7,1220,920,485000
3,1.5,2160,9000,4,8,1400,760,650000
4,2.5,1850,7850,3,8,1850,0,540000
3,2.25,1590,9960,3,7,1060,530,434975
4,2.75,1860,7500,5,8,1220,640,529950
3,2.25,1940,9560,3,7,1940,0,283748
3,2.25,1990,8501,3,8,1990,0,564800
4,4.25,6410,43838,4,12,5610,800,2.73E+06
3,2,1170,10051,4,7,1170,0,200000
3,2,1540,6250,3,7,1540,0,272500
4,2,2080,6360,3,7,1330,750,352800
4,2.5,2780,35000,4,9,2780,0,674250
4,2.5,2250,3916,3,8,2250,0,333490
4,2.25,2140,6355,3,7,2140,0,435000
2,1,820,5400,3,6,820,0,320000
3,1.75,2340,12443,4,8,2340,0,560000
4,3.75,2220,3797,4,6,1330,890,392000
2,2.5,1760,3710,3,8,1130,630,385000
3,3,2790,12523,4,8,1600,1190,835000
3,1.75,1780,11096,3,7,1210,570,325000
3,2.5,1490,8628,3,7,1490,0,289000
4,2.5,2240,6944,3,7,1310,930,287500
2,1.75,1610,158558,2,6,1610,0,280000
3,1,990,10125,3,7,990,0,222500
4,3.5,3400,3850,3,10,2790,610,1.20E+06
4,1.5,1910,5000,3,7,1610,300,657500
3,1,2040,7936,5,8,1680,360,1.30E+06
4,1,1430,3600,3,6,980,450,285000
3,2,2290,5001,4,7,1490,800,745000
4,3.5,3310,4850,3,9,3310,0,785000
4,2,2250,7500,5,7,1200,1050,550000
3,2.25,1660,7003,3,7,1660,0,269950
2,1.5,960,1808,3,7,960,0,358000
3,2.5,3400,5119,3,8,2300,1100,1.05E+06
3,2.5,1940,8196,3,8,1940,0,661000
4,1.5,2190,8296,3,7,2190,0,565000
5,2,2500,7860,3,7,1040,1460,455000
5,2.5,3990,3839,4,8,1990,2000,610000
3,1.75,1880,12821,3,7,1880,0,389800
3,0.75,1270,10092,5,7,1270,0,316000
4,2.75,2330,6703,3,7,1710,620,580000
3,1.75,1360,16000,3,7,1360,0,250000
4,1.75,1820,14319,4,7,1820,0,331500
3,1,1520,9030,3,7,1520,0,522500
2,1.75,1280,4000,4,7,730,550,495000
2,1,1060,3325,4,6,770,290,344000
3,3.25,1600,1289,3,8,1600,0,392500
4,2.5,2590,9354,4,9,2590,0,500000
3,1.75,1460,4692,3,7,1460,0,244000
2,1,1170,4750,3,6,1170,0,540000
3,2,1810,10530,3,8,1810,0,295000
3,1.75,2310,36665,3,8,1580,730,520000
3,2,1750,2550,3,7,1750,0,410000
5,1.5,1990,18200,3,7,1990,0,178000
5,2.75,3100,5298,3,7,3100,0,475000
3,2,1090,6090,3,7,940,150,158000
3,2.5,1420,2581,3,7,1420,0,435000
4,2.25,2590,12600,3,9,2590,0,760000
3,2,1260,7346,3,7,1260,0,290000
4,2.5,2270,13449,4,9,1310,960,780000
5,3,2560,12480,3,8,1590,970,565000
5,1.75,2110,5000,4,7,1250,860,674000
3,3.75,2930,150945,3,8,2930,0,838000
4,2,1520,19672,3,6,1020,500,171000
4,2.75,2720,51396,4,8,2720,0,485000
4,1,1200,7200,3,6,1200,0,227000
3,2,1720,2000,3,8,1060,660,935000
3,1.5,1290,8366,3,7,1020,270,240000
2,1,1400,4500,3,7,900,500,180000
4,1.75,1760,7300,3,7,880,880,380000
5,2.75,2900,5155,3,8,2900,0,670000
3,2.5,2590,35640,3,9,2590,0,660000
4,4.5,3720,7746,3,10,3720,0,960000
2,1,1360,9367,4,6,680,680,255000
4,2.5,2520,11240,3,8,1440,1080,560000
2,1,790,6000,3,7,790,0,325000
4,3.5,3790,90169,3,11,3790,0,1.30E+06
3,3.25,3890,3452,3,12,2890,1000,2.25E+06
3,2,2050,13303,3,8,2050,0,314500
3,1,1440,4300,3,8,1440,0,600000
1,1,720,5100,3,6,720,0,335000
3,2,1220,1186,3,8,1220,0,355000
4,1.75,1940,4800,5,7,1030,910,505000
3,1.5,1460,78408,4,7,1460,0,700000
3,2.5,2940,4799,3,9,1710,1230,589000
4,2,1350,7255,4,7,1350,0,400000
4,1.75,1540,8311,4,7,1540,0,512500
2,1,1360,22508,3,7,1360,0,520000
3,1,1780,5236,5,6,1050,730,375000
3,1,960,6634,3,6,960,0,315000
4,1,1440,6678,3,7,1040,400,440000
2,1.5,1310,12196,3,6,1310,0,455000
5,3.5,4380,14925,3,11,4380,0,945000
4,1.75,1660,8160,3,8,1660,0,374950
4,2.25,2230,11200,4,7,1300,930,480000
4,2.5,2310,6200,3,8,2310,0,334000
2,1.75,1450,4000,4,7,1350,100,650000
4,2.5,1960,14242,4,8,1290,670,600000
5,2.5,2710,14989,3,8,1720,990,1.19E+06
3,2.5,1870,5333,3,8,1870,0,377000
4,2.5,1820,3905,3,7,1820,0,330000
4,3.5,3830,8963,3,10,3120,710,1.70E+06
3,1,1230,171190,3,7,1230,0,275000
4,2.5,2770,9532,4,9,2770,0,711000
4,2.5,3010,11393,3,8,3010,0,695000
4,2,2160,4800,4,7,1290,870,324950
4,2.75,3560,8975,3,10,3560,0,1.75E+06
3,1,1140,10320,4,7,1140,0,379000
4,2.5,2600,17388,3,9,2600,0,665000
3,2.5,1610,2527,3,9,1080,530,460000
4,3.25,3276,10801,3,9,3276,0,720000
3,2.25,1830,4744,3,7,1830,0,182500
4,3.25,3730,7200,3,10,2810,920,1.49E+06
3,2.5,1420,1438,3,9,1280,140,670000
4,3,1890,13140,4,7,1270,620,450000
3,1.75,1600,20873,3,8,1600,0,515000
4,2.75,3190,14904,4,9,1940,1250,1.65E+06
3,2.5,3070,223463,3,9,3070,0,753000
4,1.5,1470,70800,3,7,1470,0,325000
1,1,800,16306,2,6,680,120,250000
5,2.25,3740,14913,4,9,3740,0,660000
4,3.25,3890,422096,3,9,3150,740,1.13E+06
2,1,840,11600,3,6,840,0,187000
3,1,1480,13280,3,6,1480,0,455000
4,3.5,5270,53428,3,10,3440,1830,782000
4,2.5,3170,10688,3,9,3170,0,455000
4,1.75,1740,7700,5,7,1740,0,600000
3,2.5,1650,6675,3,8,1290,360,246000
4,2.5,3860,10361,4,10,2940,920,1.16E+06
4,1.75,2510,7440,4,8,1290,1220,285000
4,2.75,4120,12500,4,8,2060,2060,1.25E+06
4,2.5,2060,13500,3,7,1260,800,269950
4,2.5,2320,7800,3,8,2320,0,470101
5,3.5,5430,10327,3,10,4010,1420,1.24E+06
5,3.5,5230,8960,3,11,4450,780,1.99E+06
3,2.5,1740,3043,3,7,1740,0,447000
3,1.5,1380,11760,4,7,1380,0,272000
3,1,1840,8100,4,7,920,920,185000
5,3.25,3740,11536,4,9,2540,1200,915557
4,1.75,2710,9216,3,8,1440,1270,624000
4,2.25,1770,7799,3,7,1770,0,325000
3,2.5,2550,8170,3,8,2550,0,316000
3,2.5,3240,33661,3,8,3240,0,575000
3,3,2700,47050,4,9,1570,1130,420000
4,2.5,2440,6581,3,8,2440,0,680000
2,1,600,6120,3,5,600,0,110000
3,2,1540,8011,3,7,1540,0,425000
6,4.5,4800,9097,3,10,3580,1220,1.98E+06
3,1.75,1610,10796,3,7,1070,540,925000
4,4.25,5020,26319,3,12,5020,0,1.50E+06
3,1,1200,8470,5,7,1200,0,178500
5,2.5,3650,9050,5,10,3370,280,2.38E+06
3,2,1460,2800,4,7,730,730,600000
3,2.25,1580,47916,3,7,1580,0,350000
3,3.5,3190,29982,4,8,2630,560,1.05E+06
2,2,1560,4823,3,8,1560,0,519000
3,1.5,1710,17707,4,7,1180,530,690000
3,3,2790,13295,4,10,2370,420,1.80E+06
4,2.5,2730,4962,3,8,2730,0,319500
2,1,2034,13392,5,7,1159,875,549000
4,2.5,2300,10843,5,8,2300,0,610000
3,2,2010,251341,3,8,1510,500,439000
4,1.75,2050,94525,4,7,1250,800,455000
4,2.5,2290,11072,3,9,2290,0,590000
2,1,1300,6617,3,7,1300,0,324500
3,1.5,1640,7222,4,7,1640,0,295000
3,1.5,1650,8676,4,8,1130,520,390000
5,1.75,3700,9140,3,8,1850,1850,415000
3,1,1320,5000,3,7,1320,0,459000
4,1.5,1790,10200,4,8,1210,580,302000
3,1.75,1690,48096,3,7,1690,0,500000
2,2.5,1230,1391,3,8,870,360,490000
4,3,3080,10757,5,8,3080,0,1.05E+06
3,2.25,1740,10378,5,7,1740,0,255000
3,2.5,3160,4270,3,8,2650,510,555000
3,1.75,1180,6260,4,8,1180,0,275000
4,1.75,2350,18800,3,8,2350,0,620000
4,2.25,2860,5658,3,10,2130,730,1.30E+06
6,2.5,3820,53173,4,9,2040,1780,611000
3,2.5,2099,4275,3,7,2099,0,289950
5,2.75,2380,7500,3,7,1300,1080,361000
4,2.5,2700,9700,3,8,1670,1030,480000
3,2.5,1630,11592,3,8,1630,0,360400
4,3,2120,5520,3,8,1420,700,518500
3,2.5,1350,886,3,8,1270,80,377500
4,3.25,3620,5131,4,11,2350,1270,1.53E+06
4,2,1440,5911,5,5,1440,0,232000
4,3.25,4130,112521,3,11,4130,0,1.90E+06
1,1,1020,6871,3,6,1020,0,152275
4,2.5,2330,7050,3,8,2330,0,335000
3,2.5,2550,7709,3,9,2550,0,349000
2,1,1170,5000,4,7,1030,140,425000
4,2.5,2980,210395,3,9,2980,0,620000
4,2,1330,5926,4,5,1330,0,235867
4,2.5,2630,15000,5,8,2630,0,589000
2,2,1250,3360,3,7,1250,0,500000
4,2.75,2140,10316,3,8,2140,0,359500
2,1,860,3874,4,6,860,0,290300
3,1.75,1390,18200,4,7,1390,0,261350
4,2.75,3550,13938,5,8,2100,1450,469000
3,2.5,1710,1904,3,8,1140,570,579000
3,1.5,1370,9800,5,7,1370,0,246900
3,1.75,1940,7306,3,8,1470,470,630000
2,1.75,1660,5581,3,8,1660,0,545000
5,2.5,3150,35283,3,10,1800,1350,935000
4,2.25,1660,7350,3,8,1660,0,610000
3,2.75,1560,7392,5,7,1030,530,440000
3,1.5,1680,13751,4,7,1680,0,572000
3,3,1320,1012,3,8,1320,0,510000
3,2.5,2980,18935,3,11,2980,0,820000
4,2.5,1930,6228,3,8,1930,0,321500
3,1.75,1150,13278,5,7,1150,0,339000
3,1,1010,9576,4,7,1010,0,201700
6,2.75,3400,5000,3,8,2860,540,715000
4,2,1620,5200,4,7,1620,0,220000
3,1.75,1580,19998,4,7,1580,0,350000
3,1.75,1720,8867,3,8,1320,400,348000
8,2.75,2790,6695,3,7,1470,1320,340000
2,1,1050,60113,4,7,1050,0,415000
3,1.75,2180,14135,5,8,1300,880,860000
4,2.5,2150,27540,3,8,2150,0,550000
4,2.75,2440,7042,4,7,1640,800,725000
5,3,2260,6508,3,7,1330,930,451000
3,1.5,1140,8340,3,7,1140,0,200000
4,2,1440,10920,3,5,1440,0,275000
2,1,1280,5250,4,7,1140,140,350000
4,3.5,3080,5974,3,9,3080,0,733000
4,2.5,2510,5436,3,8,2510,0,706000
4,3.75,3820,53574,3,10,3820,0,1.22E+06
3,1,2000,21780,3,8,1480,520,500000
2,1,1040,7538,4,7,1040,0,436000
3,2.5,1780,47480,3,7,1780,0,495000
4,1,1900,9000,4,7,1290,610,327000
3,1,1260,6826,3,6,720,540,342000
3,2.5,1800,3074,3,7,1800,0,447000
4,2.5,2370,10631,3,8,2370,0,338000
5,3,3800,42316,4,9,3800,0,549900
3,1,1660,8800,4,7,960,700,209950
3,2.5,2020,1159,3,8,2020,0,720000
4,1.75,2190,125452,3,9,2190,0,491500
3,1,1660,6582,5,7,1000,660,467000
5,2.5,2340,5670,3,7,2340,0,392000
3,1.75,1480,8165,4,7,1480,0,280000
4,2.75,2420,10200,3,8,1220,1200,440000
7,4,3150,7800,3,8,3150,0,450000
3,2,1590,8100,3,7,1060,530,250000
3,3.5,3380,3333,3,10,2800,580,1.19E+06
3,2.5,2310,4930,4,8,2310,0,395000
6,3,2960,5000,3,8,1790,1170,650000
4,2.75,1720,6270,3,8,1720,0,477000
4,1,1320,5000,3,7,1320,0,229000
4,3.5,3650,38546,3,9,2550,1100,696000
6,2,2570,4240,4,7,1970,600,705000
3,2.5,1810,7350,3,8,1310,500,327000
2,1,950,4560,3,7,950,0,450000
4,2.75,2700,7992,3,9,2700,0,572000
5,1.5,1940,4800,3,8,1940,0,780000
4,1.75,2440,8100,4,9,1620,820,575000
4,1.75,2260,11000,3,8,1620,640,555000
4,2.5,1860,8709,3,8,1860,0,292500
4,1.75,1630,8410,5,7,1630,0,249000
2,1,880,7575,4,7,880,0,204750
4,3,3380,16133,3,8,2330,1050,350000
4,1.75,2160,8000,4,9,1660,500,355000
2,2.5,1780,2067,5,9,1780,0,935000
3,1,1280,9898,3,7,1280,0,368000
4,1,1660,34848,1,5,930,730,550000
3,2.25,2080,12134,4,8,1530,550,605000
3,1.75,1680,2400,3,7,1170,510,469000
4,2.5,3920,41206,4,10,3920,0,965000
5,2.25,2290,7420,3,7,1290,1000,359900
3,1.75,1250,10122,3,7,1250,0,253000
3,3,2290,1407,3,8,1890,400,635000
3,2.5,2605,2216,4,9,2090,515,1.02E+06
3,1,1400,10425,4,7,1400,0,241500
4,2.5,3270,8223,3,10,3270,0,797500
4,1,1600,4500,4,7,1600,0,725000
3,1.5,1490,7800,3,7,1010,480,256400
3,1.5,1330,7600,4,7,1330,0,218000
3,3,3610,17483,4,8,3610,0,950000
3,2.75,2770,3809,5,7,1770,1000,317625
4,2.25,2820,16770,4,8,1920,900,321027
3,1,1300,9300,4,7,1300,0,325000
4,1.75,1730,8320,3,7,1230,500,258000
4,4.25,4960,6000,3,11,3680,1280,1.43E+06
5,3.25,2710,2356,3,8,2230,480,715000
2,1,820,16030,4,5,820,0,185000
2,1,770,3008,4,5,770,0,345000
3,1,1310,15022,3,7,1310,0,235000
3,2.5,1320,4320,3,6,660,660,366000
6,3,2180,7220,3,7,2180,0,230000
5,2,1910,7200,4,6,1110,800,230000
4,2.5,3020,36893,3,9,3020,0,790000
3,2.25,2520,26943,3,7,1760,760,420000
4,2.5,1850,1836,3,7,1600,250,476100
3,2.5,1860,3658,3,8,1860,0,510000
4,2.5,4070,129808,3,10,4070,0,710000
2,1,700,20130,3,6,700,0,84000
4,3.25,2880,35315,3,11,2270,610,845000
3,1.5,1380,11130,3,7,1380,0,209950
5,1.75,1260,4500,3,7,1260,0,650000
3,2.5,3370,19585,3,7,3200,170,515000
5,2.75,2910,13332,4,8,2910,0,605000
3,1.5,1610,8375,3,7,1610,0,270000
3,1.75,1670,7210,5,8,1670,0,678000
4,2.5,2520,2600,5,8,1670,850,1.13E+06
2,1,750,5379,3,6,750,0,310000
3,1.5,1550,4980,3,7,1080,470,359000
3,1.5,1310,1266,3,8,1120,190,445000
3,2.5,1350,941,3,9,1350,0,874000
3,2.5,2060,9715,3,8,2060,0,840000
3,2.5,2510,47044,4,7,1910,600,624000
4,2,1590,942,3,7,1590,0,293467
2,1.75,1740,4736,4,7,1040,700,565000
3,1.75,1070,7200,3,7,1070,0,224400
3,1,1200,8316,4,6,1200,0,214000
3,1.75,1720,4050,5,7,860,860,575000
3,1.5,1220,9000,4,7,1220,0,237200
4,3.5,3440,3800,3,9,3440,0,1.29E+06
3,1,1250,9775,3,7,1250,0,175000
5,1,2170,65340,4,7,1670,500,435000
4,3,2110,5000,4,7,1640,470,610000
4,2.5,2870,9292,3,8,2540,330,399000
3,1.5,1150,8686,4,7,1150,0,213400
3,2.25,1670,7881,4,7,1190,480,252000
4,3.5,2820,7809,3,10,2820,0,1.45E+06
3,2,1780,11342,3,7,1780,0,280000
3,1,1530,15975,3,7,970,560,279000
4,2,2730,12000,4,8,1410,1320,505000
3,1.75,1255,1113,3,8,1255,0,360000
3,1,1120,8342,4,7,1120,0,205000
2,1,2020,7540,3,7,1010,1010,410000
4,2.5,2340,11784,3,9,2340,0,330000
3,2.5,2130,3545,5,9,2130,0,1.07E+06
4,3.5,4640,13404,3,10,4640,0,1.27E+06
4,2.25,2240,45738,3,7,2240,0,610000
2,1,890,6380,3,6,890,0,250000
4,2.5,2570,10155,3,9,2570,0,379000
3,1.75,1620,8438,4,8,1620,0,549500
2,1.75,1150,2723,4,7,770,380,390000
4,1.75,2140,49658,5,7,2140,0,360000
3,2,2080,12972,4,7,1250,830,389000
4,2.5,3680,7236,3,10,3680,0,679000
3,2.5,1440,4394,5,8,1440,0,515000
4,2.5,2070,8127,3,9,1590,480,600000
5,4,4390,6656,3,9,2930,1460,1.23E+06
4,2.5,2760,6000,5,7,2230,530,760000
4,2.5,2150,7944,3,8,2150,0,300499
5,1.75,1730,10368,5,7,1010,720,268000
3,2.25,1950,1968,4,7,1160,790,359000
4,2.5,1850,11250,3,7,1210,640,470000
3,1.75,1510,6360,4,7,1510,0,420000
2,2.25,1860,2670,4,8,1860,0,462370
3,1,990,8840,3,6,990,0,222000
2,1,920,5889,4,6,920,0,156000
3,1.75,1550,3680,3,7,1050,500,530000
3,1.5,1180,10277,3,6,1180,0,275000
2,1,1230,7560,3,7,1230,0,343000
5,2.5,2840,15598,4,8,1470,1370,375000
3,2.5,2120,9307,4,9,2120,0,719000
3,1.75,2570,39634,3,8,2570,0,621500
5,3.5,3270,4080,3,9,2180,1090,1.31E+06
8,5,2800,2580,3,8,1880,920,490000
3,2,1680,5246,3,7,1680,0,412500
3,2,1400,6200,3,6,700,700,240000
4,2.5,2770,63118,3,9,2770,0,641000
3,2.5,2340,2155,3,10,2120,220,716500
4,2.5,2610,3500,5,7,1610,1000,824500
3,2,1480,800,3,8,1000,480,459000
3,2.25,1350,3582,3,8,1350,0,299000
3,3.5,2876,5086,3,8,2360,516,525000
4,2.25,2940,48788,5,7,1520,1420,605000
3,1.75,1310,7811,3,7,1310,0,373000
2,1.5,1140,7800,4,6,1140,0,903000
5,2.75,2920,11880,5,8,1660,1260,850000
4,2.5,2440,5350,3,7,2440,0,435000
4,2.5,2400,7270,3,8,2400,0,333000
3,1,1120,10125,3,6,1120,0,305000
3,1.75,2200,8036,3,7,1270,930,390000
2,2.5,2130,5001,5,8,1330,800,707000
3,2.25,1130,4445,4,8,1130,0,672000
4,2.25,2550,7650,4,9,2550,0,465000
4,2,1630,1724,3,6,1030,600,509000
3,2.5,2000,1950,3,8,2000,0,755000
3,2.5,2560,9182,3,9,2560,0,750000
4,1.75,2970,14880,5,9,1560,1410,815000
4,2.5,2590,9341,3,8,2590,0,790100
4,2.5,2760,8558,3,7,2760,0,445000
5,2.75,3360,9200,3,9,3360,0,738515
3,1,860,5200,5,6,860,0,189000
2,1.75,1570,1207,3,9,1570,0,695000
4,2.5,2670,4410,3,8,2670,0,668000
4,3,2290,8250,3,9,2290,0,328500
4,3.25,3090,6744,3,9,3090,0,850000
2,2,1190,7570,3,6,1190,0,210000
3,2,1830,4992,3,7,1230,600,210000
3,1,1020,6000,3,7,1020,0,337500
4,2.25,2670,10050,4,8,1420,1250,275000
3,1,1240,10800,5,7,1240,0,350000
3,2.5,2030,5100,3,7,2030,0,595000
3,1.5,1390,2153,3,7,1390,0,267500
4,2.5,2370,9601,3,8,1570,800,530000
3,3.5,1810,1846,4,8,1440,370,625000
4,2.75,3460,11350,4,9,1780,1680,1.09E+06
2,2,2260,9604,3,9,2260,0,551000
3,2.5,3240,12625,3,11,3240,0,1.29E+06
3,1.75,2140,40098,5,8,1490,650,507000
2,1,780,9750,3,6,780,0,146000
2,1.5,830,920,3,7,830,0,345000
3,2,1730,6007,3,8,1730,0,299000
4,2.5,2810,11897,3,8,2810,0,386000
5,1.75,1830,16650,3,7,1610,220,336800
4,2.25,3320,53392,4,8,2000,1320,508000
4,1.75,1360,4840,4,7,1360,0,399500
2,2.5,1320,1329,3,8,1180,140,425000
3,1,1640,9750,3,7,1640,0,207500
3,2.5,2970,21907,3,9,2970,0,499500
4,1.75,1910,8117,3,7,1460,450,395000
1,1,620,8261,3,5,620,0,244900
4,2.25,2620,10536,3,8,1520,1100,705000
3,2.25,1710,4561,4,8,1710,0,500000
3,2.25,1420,6600,3,7,1160,260,364000
3,1,980,7560,3,7,980,0,237502
3,1.75,1250,17493,3,7,1250,0,357000
3,2,1850,9550,3,8,1850,0,289000
4,2.5,3180,15358,3,9,3180,0,775000
3,2.75,1670,3330,4,7,1670,0,485000
4,3.5,3930,39098,3,12,3930,0,1.80E+06
2,2.5,1770,4950,3,7,1770,0,350500
4,3.5,2440,3052,3,8,1940,500,475000
5,3.5,3880,13885,4,9,2540,1340,1.13E+06
4,2,1990,29078,3,9,1990,0,540000
4,2.75,2980,13260,4,8,1800,1180,450000
3,1.75,1970,10800,4,7,1300,670,350000
2,1,760,5500,3,5,760,0,92000
4,2.25,2590,10002,4,8,1340,1250,452000
4,2.25,2330,19436,3,8,2330,0,527000
4,2.5,2547,4800,3,9,2547,0,392440
2,1,710,4800,2,6,710,0,480000
3,3,2780,6000,3,9,2780,0,625000
4,2.25,2270,9100,3,7,2270,0,420000
3,1,1030,60720,3,5,1030,0,209900
4,2.25,1740,10875,3,8,1740,0,429950
3,2,2610,12180,3,7,1670,940,310000
4,5.5,7080,16573,3,12,5760,1320,4.00E+06
4,3.5,3770,47480,3,9,3770,0,665000
4,2.5,3280,5876,3,7,3280,0,702000
3,2.25,2980,86636,3,9,2230,750,825000
3,2,1300,9334,5,7,1300,0,257500
2,1,740,6300,3,6,740,0,299500
3,1.75,1840,16679,3,8,1840,0,274950
2,1.75,1560,4141,4,7,880,680,549010
2,1.75,2320,6250,3,7,1400,920,400950
4,1.5,1460,8760,3,7,1460,0,300000
4,2.5,2290,4539,3,7,2290,0,295000
3,2,1750,7000,3,8,1750,0,363000
4,3,2020,4300,3,6,2020,0,565000
3,1,1050,16050,4,7,1050,0,287653
3,2,1320,4000,4,6,1020,300,462600
3,2.5,1600,7000,4,8,1600,0,275000
4,2,1570,9415,4,7,1570,0,235000
3,2.5,2060,7184,3,8,2060,0,545000
2,1.75,2870,102366,4,8,1770,1100,570000
3,1.75,1440,11325,4,8,1440,0,246000
2,2.25,1300,1314,3,8,1300,0,562000
3,2,1270,1333,3,8,1270,0,401000
4,3.5,3640,4983,3,9,2790,850,895900
4,2.25,2240,8300,3,8,2240,0,439000
5,3.5,2690,4800,3,8,1930,760,690000
2,1,720,4592,4,6,720,0,419000
3,2,2510,35255,3,9,2510,0,557500
3,2.25,3340,13805,3,8,3340,0,670000
4,2.5,3320,52707,3,10,3320,0,813000
3,2.5,2370,4200,3,8,2370,0,387865
3,2.5,1680,2000,3,9,1680,0,670000
3,2.5,1180,932,3,8,1180,0,455000
3,2,1800,12440,3,8,1220,580,418500
3,1.75,1870,7189,3,7,1270,600,433000
4,2.75,2656,21195,3,9,2656,0,495000
3,1.5,1810,5080,3,7,1030,780,615500
4,3.25,4250,8570,3,9,4250,0,2.30E+06
2,1,1890,5202,4,7,1890,0,645500
4,2.25,2010,7200,4,8,1010,1000,800000
2,1,1050,2570,5,7,850,200,430000
3,2.75,3150,219978,4,9,3000,150,685000
4,2.25,2430,32496,3,9,2430,0,590000
5,2.25,2610,4080,5,7,1750,860,678940
3,2.25,2120,14915,3,9,1720,400,332000
2,1,1190,6967,3,7,1190,0,587100
5,4,3366,7800,3,8,2966,400,1.30E+06
4,2.25,2050,26000,4,8,2050,0,299000
2,0.75,1260,4800,4,6,1080,180,785000
5,2.5,2200,8500,4,7,1400,800,320900
2,1,1020,8442,4,7,920,100,680000
2,1,900,6400,2,6,900,0,140000
2,1,710,1164794,2,5,710,0,190000
3,2.25,2580,7434,3,7,1630,950,340000
3,2.5,1800,8697,3,8,1800,0,280000
4,1,1440,3600,4,7,1440,0,550000
2,1.5,880,2400,3,7,880,0,615000
3,2.5,1680,2229,3,7,1680,0,345000
3,2.5,2500,7394,3,9,2500,0,565000
4,1.75,1790,8372,4,8,1340,450,809000
3,1.75,1370,6700,3,8,1370,0,510000
2,1,1802,11225,3,7,1802,0,320000
5,3.5,7350,12231,3,11,4750,2600,1.11E+06
6,4,3120,4240,4,7,2090,1030,315000
5,3.5,3740,11340,3,10,3740,0,1.08E+06
5,3,3950,9520,3,9,2250,1700,1.27E+06
4,1.75,1920,7986,3,7,960,960,440000
2,1,900,423838,5,6,900,0,302000
6,4.5,3300,7561,3,8,3300,0,510000
3,2.5,3360,218235,3,8,3360,0,590000
3,1.75,3000,5413,4,8,1900,1100,523000
4,3.5,3160,4200,3,8,2180,980,1.14E+06
3,2.75,2700,22343,4,10,2700,0,1.06E+06
3,2,2230,4800,4,7,1290,940,736500
3,2,1770,2150,3,8,1770,0,660000
3,2,1820,4480,5,7,1120,700,655000
2,0.75,890,19703,3,6,890,0,230000
3,2.5,1322,6006,3,7,1322,0,215000
3,1.75,1580,9187,3,8,1180,400,263000
3,2.25,1450,4050,3,7,1450,0,274500
3,1.5,1140,4800,3,7,1140,0,716000
3,2,1590,10229,3,7,1590,0,395000
3,2,1730,38884,3,8,1730,0,470000
4,2.5,3250,48037,3,8,2030,1220,1.05E+06
4,2,1850,9126,5,7,1850,0,329000
4,2.5,2590,6394,3,8,2590,0,533000
3,3.5,3250,6000,3,10,2500,750,875000
2,2,1860,10856,3,8,1260,600,265000
2,1,1050,2542,3,7,880,170,650000
3,1.5,1430,9600,4,7,1430,0,266200
4,2.5,2320,9264,3,8,2320,0,370000
4,2.25,2360,15860,3,9,2360,0,615000
3,1,1300,6710,4,6,1300,0,571500
4,2.5,2460,5091,3,9,2460,0,427500
4,2.5,3700,63991,3,10,3700,0,898000
4,2.25,2450,11960,3,10,2450,0,712000
4,2.25,1890,4300,3,7,1350,540,620000
3,1,1450,9586,3,7,1450,0,340000
3,2.25,1920,7840,4,8,1920,0,299000
4,2.75,3150,7379,4,7,2430,720,640000
3,1.5,1250,8004,3,7,1250,0,455000
3,2.25,1450,4706,3,7,1450,0,400000
3,1.75,1580,6099,5,7,790,790,242000
3,2.5,2510,5544,3,7,2510,0,535000
4,2.75,2220,8450,4,7,1260,960,410000
3,1.75,1740,8800,3,7,1140,600,255000
4,2.5,2150,8173,3,8,2150,0,415000
4,2.5,3080,8451,3,7,1540,1540,679000
5,3.5,3690,11928,3,9,2540,1150,640000
3,3,3410,16015,4,10,2220,1190,2.60E+06
3,2,1770,8141,5,8,1770,0,660000
4,4,3970,7314,3,9,3970,0,949990
3,1,980,5600,2,6,980,0,215000
4,2,2480,3680,4,7,1470,1010,630000
4,2.5,3180,9603,3,9,3180,0,780000
4,1.75,1820,4500,3,8,1820,0,815000
4,2.75,1930,13041,4,8,1180,750,469500
3,2.5,1260,2767,3,8,1260,0,315000
4,1.75,1930,10210,3,8,1670,260,630000
4,2.25,2130,8499,4,7,1600,530,325000
7,2.25,3170,36384,3,8,3170,0,600000
3,1,1040,8410,3,7,1040,0,245990
4,1.75,1720,10137,3,7,1720,0,235000
2,1,790,2640,3,7,790,0,90000
3,2.5,2580,14603,4,9,2580,0,1.77E+06
2,1,1370,5000,3,7,1370,0,600000
3,1.75,2100,9066,3,8,1440,660,375000
2,1,1370,9460,3,6,1370,0,720000
6,6,7390,24829,4,12,5000,2390,5.30E+06
3,2.5,2650,7286,3,8,2650,0,446500
4,2.75,2820,5000,3,8,2170,650,810000
4,2,1610,9600,5,7,1610,0,415000
3,1,980,7200,4,7,980,0,430000
4,2.5,1811,4381,3,8,1811,0,260000
3,2.25,1380,7226,4,7,1140,240,265000
3,2.5,1680,10455,3,8,1680,0,550000
4,2.5,1920,8562,4,7,1920,0,308950
4,1.75,1880,7632,4,7,1180,700,266500
4,2.75,2260,4440,3,7,2260,0,341780
3,2.25,2250,8000,3,8,1460,790,459900
3,1,1370,10708,3,7,1370,0,205000
2,1,1550,3200,3,8,1550,0,605000
3,1,1590,6240,3,7,1060,530,229000
3,2.5,1630,2844,3,7,1630,0,330950
4,2.5,3140,28037,4,10,3140,0,680000
4,3,2690,28300,3,8,2690,0,675000
3,1.5,1640,8301,3,7,1290,350,365000
2,1,910,4000,3,7,910,0,400000
4,2.25,2130,7200,3,7,2130,0,445000
4,1,2210,4366,3,8,2210,0,589000
4,3.5,2960,6000,3,9,2960,0,633634
3,1.5,1470,4480,4,7,1130,340,613000
2,1,1160,32251,3,6,580,580,330000
3,1,1140,4600,3,7,1140,0,460000
3,2.75,3370,13929,3,9,2650,720,425000
4,2.5,1810,6509,3,7,1810,0,270000
2,1.75,1510,4980,3,8,1510,0,419000
3,2.5,1640,5097,3,7,1640,0,475000
3,1.5,1900,43186,4,7,1300,600,427500
3,2.5,2030,8000,3,7,2030,0,305000
3,2,1210,9097,4,7,1210,0,173250
4,2.25,1770,7000,5,7,1770,0,480000
3,2.5,2100,4440,3,7,2100,0,800000
3,1,1340,306848,3,5,1340,0,210000
5,2.5,2530,10190,4,7,1290,1240,657000
4,2.25,2470,17008,4,8,2470,0,625000
4,4.5,4040,8400,3,9,3220,820,860000
3,1,1060,8625,4,7,1060,0,476500
2,1,790,5985,3,6,790,0,200000
4,3.25,1790,2460,4,7,1100,690,385000
3,2.5,2080,4307,3,7,2080,0,368000
4,2.5,2990,6383,3,7,2990,0,445000
1,1,670,7957,4,6,670,0,118000
3,2.25,1370,5000,3,7,1370,0,299950
3,1,1330,5412,5,7,1330,0,197500
4,1.75,1400,6650,4,6,1400,0,276500
3,2.5,1630,3425,3,8,1630,0,350000
4,3.25,4360,6000,3,11,3400,960,1.26E+06
4,4.25,4590,17621,3,10,3160,1430,1.14E+06
1,1,720,7140,3,6,720,0,199900
3,2,1730,6784,4,7,1730,0,676000
3,3.5,2320,3174,3,9,2060,260,530000
2,2.25,850,1656,3,8,850,0,233000
2,1,1170,8254,2,6,1170,0,104950
4,2,1490,5300,3,7,1110,380,425000
4,2.75,2450,5376,4,7,1550,900,696950
3,1,1190,10350,4,7,1190,0,306000
3,2.25,1280,1520,3,8,1080,200,490000
2,2,1680,5756,4,7,1680,0,210000
3,1.75,2060,5721,3,9,1140,920,746300
3,1,1260,8378,4,6,840,420,195000
3,1.75,1310,7314,5,6,1310,0,237950
4,2.75,2250,14149,3,9,2250,0,499000
3,1,1580,4000,3,8,1580,0,690000
4,2.5,2370,30378,3,8,2370,0,479000
4,2.25,4230,37769,3,11,4230,0,985000
3,1,860,11900,4,6,860,0,160000
3,2.75,2950,6667,3,9,2950,0,739000
3,2.25,1370,7087,3,7,1370,0,264500
2,1,820,6250,4,5,820,0,375000
3,2.5,1670,7740,3,7,1130,540,375000
2,2,1370,5756,3,8,1370,0,380000
4,2.25,2270,11997,4,7,1540,730,287000
4,2.5,2650,9990,3,10,2650,0,695000
4,2,1530,7816,3,7,1530,0,500000
4,2.75,2340,11034,3,8,1720,620,440000
5,4,6300,16065,3,12,4360,1940,2.75E+06
3,2.5,2060,7658,3,8,2060,0,323800
6,3,2300,3404,3,7,1600,700,464000
3,2.5,2120,7401,3,8,2120,0,612000
3,3.25,1470,1235,3,7,1180,290,300000
3,1,890,4810,3,6,890,0,153500
4,2.5,2170,4587,3,7,2170,0,489000
4,3.75,3600,16101,3,9,3600,0,1.93E+06
3,3,2850,9375,3,8,2240,610,300000
4,2.5,2100,8800,5,8,1250,850,610000
3,3.25,1400,1343,3,7,1160,240,367500
3,1.75,1750,12325,4,7,1470,280,499000
4,4.5,4060,10800,3,10,4060,0,530000
5,3.5,2450,8193,3,9,2450,0,559950
3,1,1510,17040,4,6,1510,0,185000
4,1.75,1860,9112,4,7,1110,750,265000
3,2,2350,209088,3,7,2350,0,539000
3,2.25,1552,3677,3,7,1552,0,264000
4,2.5,2300,8100,4,8,1360,940,299000
2,1,1390,7740,4,6,1390,0,354000
3,2,3085,7280,4,7,1560,1525,359000
3,1,1330,5850,3,7,930,400,320000
3,2.5,2650,9380,5,8,1680,970,590000
3,2.25,1620,10850,3,7,1620,0,250000
3,1.75,1510,4800,3,7,860,650,465000
5,2.75,1940,5000,5,7,1940,0,577000
3,1,1630,6009,4,8,1630,0,550000
3,1.75,1710,7320,3,7,1710,0,463000
4,1.5,1390,7200,3,7,1140,250,400000
4,2,1810,8750,2,7,1110,700,304000
3,2.25,1950,8868,3,7,1350,600,415000
3,1.5,1420,7520,4,7,1420,0,413107
4,2.5,2370,15336,3,8,2370,0,495000
2,1,820,288367,3,6,820,0,295000
3,1.5,1590,8911,3,7,1590,0,300000
4,2.25,2270,12000,4,7,1290,980,311750
3,1.75,1270,7350,4,7,1270,0,599380
4,2.5,1847,8000,3,7,1847,0,216000
3,2.5,1310,1294,3,8,1180,130,475000
3,4,2550,3900,3,8,2050,500,990000
4,1.75,2060,7900,4,7,1070,990,395000
3,1.75,1860,7191,4,7,1260,600,345000
4,2.75,2500,5257,3,8,2500,0,411000
4,2.5,2440,34290,3,9,2440,0,720000
3,1,1620,4774,3,7,1620,0,842000
4,2,2750,7807,5,7,2250,500,571000
2,1,1800,8900,3,6,900,900,335000
3,1.75,1780,5175,4,7,990,790,615000
3,2.5,2020,6564,3,7,1310,710,253000
3,1,660,6600,4,5,660,0,225000
3,2.75,2650,9752,3,9,2650,0,580000
3,1.75,1480,9375,4,7,1480,0,350000
3,2.5,1810,3930,3,8,1810,0,540000
3,1.75,1230,10725,3,7,1230,0,329000
3,2.5,2060,5115,3,9,2060,0,356250
3,1,1150,5000,3,8,1150,0,717000
4,2.5,2770,7800,3,10,2770,0,1.20E+06
3,2.5,3660,39478,4,9,3260,400,530000
4,2.5,1560,7800,3,7,1560,0,262000
4,2.5,2010,12085,3,8,2010,0,299500
3,2.75,2830,3496,3,8,2830,0,673000
4,2.5,2610,7254,2,8,1610,1000,547500
5,2.5,3600,20001,4,9,3600,0,484000
5,2.75,3010,5398,3,9,3010,0,769995
2,1,720,5913,3,6,720,0,230000
4,2.5,2700,10160,3,9,2700,0,674725
4,2.5,2310,4079,3,8,2310,0,646000
3,2.5,1790,2375,3,8,1790,0,670950
3,2.5,1570,4926,3,8,1570,0,417000
5,3.5,4050,20925,3,10,3020,1030,1.60E+06
3,2.5,1660,2890,3,7,1660,0,330000
4,3.5,4300,8406,3,11,3580,720,1.13E+06
4,3.5,5990,111078,3,11,5990,0,1.53E+06
3,3.25,1450,1468,3,8,1100,350,380000
3,1,940,11055,4,7,940,0,180000
2,1.75,1330,6000,4,7,960,370,565000
3,1.75,1540,9450,4,6,1040,500,433500
2,1,1010,5408,4,6,1010,0,225000
4,2.5,1810,39639,3,7,1230,580,235000
3,2.25,1810,6750,3,7,1280,530,162000
3,2.5,1760,1472,3,8,1640,120,608000
3,1.75,1880,5752,4,7,940,940,412000
3,2.25,2470,11603,3,8,1540,930,736000
3,1.75,1620,10000,5,6,1620,0,399000
4,2.75,2700,5150,3,9,2700,0,515000
2,1.75,1210,1032,3,8,1210,0,357562
3,2.5,2300,27566,3,9,2300,0,510000
3,2.5,2456,7566,3,8,2456,0,329950
3,2.5,1770,1714,3,8,1770,0,671500
5,2,1940,7642,3,7,1940,0,465250
5,1.5,1310,4800,3,6,1110,200,307000
4,2.5,2223,5780,3,8,2223,0,320000
4,1,1580,8475,4,7,1580,0,406000
4,2,2410,4680,3,9,2410,0,470000
4,2.5,2540,6365,3,8,1870,670,380000
3,1.5,1610,6132,4,7,1090,520,238000
3,1.5,1310,3880,3,7,1090,220,717000
2,1,940,6804,3,7,940,0,443500
3,2.5,1560,9600,3,7,1210,350,324950
3,2.5,1500,5412,5,7,900,600,485000
3,1,1570,9136,3,7,1570,0,330000
3,2.25,1750,12408,5,7,1150,600,456150
3,1.75,1640,8529,5,7,1640,0,440000
3,2,1270,10713,4,7,1270,0,435000
3,1.75,1990,5650,3,7,1320,670,345000
3,1,900,7576,4,6,900,0,201000
3,2.5,1820,7500,3,8,1820,0,424000
4,1,1370,5339,4,6,1370,0,219000
1,1,790,4590,3,6,790,0,350000
3,2.5,1450,11480,3,7,1450,0,309000
3,2,1900,9513,3,8,1900,0,315000
4,2.75,2500,20000,4,8,1700,800,950000
3,2.5,2850,7130,3,10,1990,860,783500
3,2.5,2100,2200,4,7,1500,600,720000
4,3,2720,11740,5,9,2720,0,940000
4,2.5,3940,4407,4,8,2620,1320,1.20E+06
4,2.5,3200,6691,3,7,3200,0,422000
4,3,3580,35261,3,10,3580,0,925000
3,1,1420,10980,4,7,1200,220,385000
3,1.75,2140,4800,3,8,1690,450,998500
4,3.25,3410,10125,3,10,3410,0,1.58E+06
4,1.75,1770,9848,3,8,1370,400,606150
3,2.5,1528,7616,3,7,1528,0,272000
5,4,4440,9270,5,10,2220,2220,1.30E+06
2,1,850,2700,5,6,850,0,447000
4,2.5,2730,4526,3,7,2730,0,440000
4,3.5,4220,196817,3,10,4220,0,799950
4,3.5,3740,41458,3,11,3740,0,1.08E+06
4,2.25,2120,8267,3,8,2120,0,450000
3,1.75,1930,6533,3,7,1230,700,285000
3,2.5,2270,5654,3,8,2270,0,500000
3,2.25,2200,16921,3,8,2200,0,410000
3,2.5,1260,889,3,8,1260,0,479000
4,3.75,3490,9170,3,9,3490,0,1.26E+06
3,1.75,1260,8487,3,7,1260,0,335500
3,2.25,1570,7475,4,7,1200,370,425000
2,1.5,1840,3825,3,8,1040,800,520000
5,3.5,4210,17258,3,12,4210,0,1.37E+06
2,1,1430,365904,3,7,1010,420,356000
0,2.5,2290,8319,3,8,2290,0,339950
4,2.5,2050,8683,3,8,2050,0,550000
4,3,2570,4000,3,8,1750,820,1.18E+06
4,3.5,2770,3330,3,8,1970,800,748000
3,1.75,1300,4000,3,7,900,400,460000
3,1.75,1600,7711,3,7,1600,0,268000
3,2.25,1640,7350,3,7,1140,500,221000
3,2.25,2100,7335,3,8,2100,0,492000
3,1.75,1970,5100,3,7,1130,840,580000
3,1.5,1520,7200,4,7,1160,360,279950
3,1.5,1540,11858,4,7,1540,0,357500
3,2.5,1440,3800,3,7,1440,0,269000
4,2.75,2980,9825,3,8,1910,1070,505000
3,2.75,1400,7880,3,7,1000,400,311000
3,1.75,1800,4429,4,7,1800,0,579000
3,1,1280,11625,4,7,1280,0,405000
3,2.25,1780,10395,3,8,1780,0,300000
4,1.5,1920,7973,3,8,1920,0,240000
3,1.5,1300,7287,4,7,1300,0,570000
4,2.25,2200,6900,4,8,2200,0,512500
3,2.5,1720,5940,4,8,1000,720,499000
5,1.75,2110,8500,3,7,1100,1010,496000
3,1,960,3960,3,7,960,0,405000
3,1,1430,3840,3,7,950,480,466500
3,2.5,2570,9487,3,9,2570,0,605000
3,2.25,2100,8276,4,8,2100,0,600000
4,2.75,2170,9743,3,7,2170,0,366000
4,1,1220,8075,2,7,890,330,240000
2,1,1180,4900,5,6,1180,0,313000
4,2.5,2570,4557,3,7,2570,0,360000
3,2.5,2480,5647,3,7,2480,0,450000
1,1.25,1810,5070,4,8,1230,580,1.25E+06
3,1.75,1530,7238,3,7,1530,0,418000
3,2.25,1790,7700,4,7,1340,450,437500
2,2.5,2600,5000,5,8,1300,1300,665000
3,1.75,1880,108900,3,7,1880,0,735000
2,1,820,681,3,8,820,0,339950
3,3,2470,11900,3,9,2290,180,660000
4,2.5,3110,6930,3,9,3110,0,755000
3,3.5,2070,11658,4,8,1370,700,470000
3,1.75,1820,6038,4,7,1040,780,423000
3,1,1840,10178,3,7,1040,800,210500
3,2.25,2090,10733,3,7,1440,650,491950
4,3.5,2980,2147,3,10,2490,490,690000
3,2,2360,12744,5,7,2360,0,435000
4,2.75,2110,6838,4,8,2110,0,325000
4,2.25,2030,12000,3,7,2030,0,420000
4,1.75,1810,7480,3,7,1230,580,260000
3,2.25,1358,1204,3,7,1358,0,317000
2,1,700,5200,5,6,700,0,155000
4,1.75,1680,7800,3,7,1330,350,451000
4,1.75,2320,12000,4,8,2270,50,318888
3,2.25,1980,40887,4,8,1980,0,550000
4,3.5,4610,11676,3,10,4610,0,960000
4,2.25,1880,9163,3,8,1880,0,315000
3,2.25,2070,9957,3,8,1440,630,469000
3,2.5,1020,1570,3,7,720,300,300000
3,1.5,1255,1374,3,7,1255,0,312000
3,2.5,3020,5868,3,7,3020,0,275000
2,1,950,7954,4,7,950,0,339000
3,2.5,2080,167270,3,7,2080,0,610000
3,2.5,2510,4600,3,10,2510,0,1.19E+06
3,1.5,1070,6601,3,6,1070,0,219950
3,2.5,1650,4929,3,7,1520,130,440000
3,2.25,1270,1213,3,8,1040,230,467000
3,1,820,7680,3,6,820,0,150000
4,2.5,2120,6497,3,7,2120,0,414000
3,1.75,1650,7700,4,8,1650,0,275000
4,3,2860,5724,3,7,1730,1130,390000
4,2.5,3480,38985,3,10,3480,0,895000
4,2.5,2520,7731,3,9,2520,0,525000
3,2,1680,4886,3,7,1180,500,450000
4,2,2060,3060,3,7,2060,0,400000
3,1,990,8255,3,7,990,0,191000
1,2.5,1980,7521,4,7,1180,800,299000
3,2.5,1210,1420,3,8,1210,0,345000
3,2.25,3650,5353,4,7,2200,1450,920000
4,2.5,3530,49222,4,9,3530,0,910000
2,1,1250,3708,3,7,1250,0,520000
4,3.5,3560,6098,3,10,3560,0,790000
4,3.5,4370,10860,3,11,4370,0,1.03E+06
3,1,1160,9375,3,7,1160,0,380000
3,1,1520,8320,3,6,1520,0,299000
2,2,1040,4750,2,6,850,190,160000
2,1,1180,10720,4,7,1180,0,450000
3,1,1270,7400,4,7,1270,0,320000
3,1,1250,21303,3,6,1250,0,259875
3,1.5,2200,2880,5,7,1440,760,885000
4,2.75,1830,7315,5,7,1250,580,263000
3,2,1880,4000,3,8,1280,600,625000
3,1.75,1560,9247,3,7,1160,400,490000
3,1,1570,11752,5,8,1570,0,415000
3,1,1380,30940,3,8,1380,0,365000
3,1,1050,8583,5,6,1050,0,350000
2,1.75,1890,9466,3,8,1890,0,1.07E+06
4,2.5,1930,9653,4,9,1930,0,465000
4,2,2130,9579,4,7,1250,880,233000
4,1.75,2270,9830,4,8,2270,0,615000
3,1.5,1010,1546,3,8,1010,0,356999
4,2.5,2650,9065,3,7,2650,0,435000
3,3.5,1550,1233,3,8,1160,390,530000
3,2.5,2730,11380,3,10,2730,0,770000
3,2.5,1550,3402,3,7,1550,0,273500
4,1.75,1910,77574,4,8,1910,0,390000
3,2.5,1690,1479,3,8,1420,270,492000
3,1.75,2110,15400,3,7,1380,730,288250
3,1,1200,10800,4,7,1200,0,390000
4,2,1610,8000,3,7,1190,420,526000
3,1,1270,7500,3,7,1270,0,281500
3,2.5,3470,12076,3,10,2560,910,1.05E+06
5,3,2420,7740,5,7,1360,1060,411500
3,1.75,1840,8086,4,8,1840,0,550000
5,3.25,3660,11995,3,10,3660,0,785000
4,2.5,2790,10289,3,9,2790,0,982000
2,1,860,5000,3,6,860,0,256000
4,1.75,3080,32997,4,7,3080,0,365000
4,2.5,3070,7830,3,11,1970,1100,1.90E+06
3,2.5,1540,7773,4,8,1540,0,439950
6,2.5,2560,8320,3,7,1370,1190,632000
3,1.5,1140,7500,3,7,1140,0,356000
3,2.25,1410,1287,3,7,1290,120,379500
5,3.75,4570,10194,3,11,4570,0,1.04E+06
4,2,1720,6413,4,7,860,860,537000
4,2.5,2500,206474,3,10,2500,0,806000
4,2.5,3230,7766,3,9,3230,0,714000
3,1,1060,7419,4,6,1060,0,370000
3,2,2020,8118,3,7,1020,1000,507500
3,1,1300,3550,3,7,1300,0,455000
4,3.25,2510,7686,3,9,2510,0,290500
3,2,1670,7056,4,7,1670,0,180000
3,1.75,1570,6975,3,7,1040,530,359950
1,1.75,750,20339,4,4,550,200,355000
4,2.25,2920,46355,4,9,2920,0,740000
4,2.5,3170,32430,3,10,3170,0,910000
3,2.5,1400,1312,3,8,1400,0,563500
4,2,1570,11200,3,7,1120,450,342000
5,3,3190,7081,3,9,1890,1300,664950
3,2.5,1670,3565,3,7,1670,0,373000
3,2.5,1720,3600,3,7,1720,0,386380
3,2.25,1800,11200,3,8,1270,530,445000
3,2.5,1600,2375,3,7,1600,0,435000
3,1.75,1790,66250,3,7,1790,0,320000
4,2.25,2490,23478,3,8,2490,0,500000
3,2,1610,6911,3,7,1260,350,435000
3,2.5,1090,7700,4,7,1090,0,394950
3,1,1050,5500,3,6,930,120,435000
4,2.5,2260,5172,3,9,2260,0,640000
5,2.5,2500,9583,3,7,1300,1200,235000
4,3,3150,9318,3,9,3150,0,705000
4,2.25,1780,10260,3,8,1780,0,615000
2,2.5,2160,5581,3,8,2160,0,715000
2,1,710,5100,5,7,710,0,402000
3,1.75,1360,13320,4,7,1360,0,329950
3,2,1680,19978,3,6,880,800,258000
3,1,810,7000,3,7,810,0,367000
3,2.5,1180,1262,3,8,1180,0,472000
4,2.5,3300,165528,3,8,3300,0,760000
3,2,1870,5909,3,7,1270,600,259000
3,2.25,1640,7630,4,8,1180,460,247000
3,1.75,2700,5040,3,8,1560,1140,665000
3,1,950,8450,3,7,950,0,365000
5,3,4350,37169,3,10,2950,1400,900000
4,3.25,3830,6765,3,9,3830,0,963990
4,2.5,4010,37076,4,12,4010,0,1.33E+06
5,1,2340,4730,3,8,1810,530,677500
4,1,1320,4440,3,7,1320,0,387500
4,2.75,2420,5773,3,8,2420,0,376000
3,1.5,1130,5413,3,7,940,190,420000
2,1.75,1210,1161,3,8,1210,0,395000
3,1.75,1180,4080,4,6,760,420,450000
4,2,1870,8750,3,7,1870,0,245000
3,2.25,1760,4539,3,8,1760,0,500000
4,1.75,1760,94525,3,7,1760,0,555000
3,2,1670,8800,4,7,1150,520,520000
4,1.75,1970,9389,5,7,1140,830,379950
4,2.75,3080,7242,3,9,3080,0,889950
4,3,2430,7242,3,8,2430,0,412000
3,2,1200,6074,3,7,1200,0,222000
2,1,560,7560,3,6,560,0,249900
3,1,1790,5250,3,7,1400,390,603000
3,2.5,2120,6840,3,7,1220,900,248000
2,1.5,1010,1309,3,7,860,150,289000
3,1.5,1540,7506,5,7,1540,0,420000
4,1,1940,5753,3,7,1940,0,401000
3,1.5,1050,4590,3,7,850,200,438924
4,2.5,1954,4805,3,8,1954,0,340000
3,2.5,1560,4200,3,7,1560,0,269000
3,1.75,1480,7475,3,8,1480,0,656000
3,2.5,2490,4244,3,9,2490,0,370000
3,2.5,2540,5050,3,7,2540,0,300000
3,1,930,9900,4,5,930,0,176500
3,2.25,1970,3716,3,7,1970,0,340000
4,1,1460,3840,3,8,1340,120,360000
3,2.5,1680,4226,3,8,1680,0,286000
3,1.75,2020,9718,3,8,2020,0,677500
3,2.5,2280,5000,4,9,2280,0,1.33E+06
3,2.5,1590,4242,3,7,1590,0,355000
4,2.75,2100,7350,5,7,1240,860,503000
3,1.75,2610,6360,3,8,2130,480,1.00E+06
3,2,1540,1827,3,8,1540,0,376000
3,1,1250,7560,3,6,1250,0,263000
5,2.25,1780,7245,4,8,1330,450,472000
3,1.5,2210,11111,3,7,2210,0,250000
3,2.5,2440,7632,3,8,2440,0,335000
4,2.5,2470,7539,3,9,2470,0,550000
3,2.5,2080,4931,3,8,2080,0,506950
4,2.25,2890,18226,3,10,2890,0,1.57E+06
4,2.5,2660,4000,3,8,2660,0,583000
3,2.5,2217,8019,3,7,2217,0,275000
3,2.5,1930,5344,3,7,1930,0,531800
4,2,3210,8400,5,7,2040,1170,756450
2,1,1060,6000,4,5,1060,0,111300
3,1.5,1280,3640,3,6,1280,0,184500
4,1,1150,2560,3,7,1150,0,485000
8,3.5,4440,6480,5,10,3140,1300,1.97E+06
4,3,3010,6139,5,8,2560,450,1.24E+06
3,2.25,2370,38639,3,8,1930,440,510000
4,3.5,3280,3800,3,11,2880,400,2.58E+06
5,3,2730,9519,3,8,1670,1060,559950
4,2.5,2163,5882,3,7,2163,0,255000
2,1,910,7200,4,7,830,80,445000
4,2.5,2683,40386,4,9,2683,0,822000
4,3.5,3850,8100,3,11,2430,1420,1.06E+06
3,1,1580,8206,3,7,1100,480,255000
4,2.5,2650,5000,3,8,2650,0,790000
2,1,790,7450,4,6,790,0,169500
4,1.75,2210,6375,3,8,1640,570,263500
3,1.75,1680,8725,3,8,1240,440,260000
5,3.25,3500,10457,3,11,3500,0,972800
3,1.75,1510,44000,3,7,1240,270,425000
2,1,700,7303,5,5,700,0,209995
2,1,1000,7664,3,7,1000,0,397000
5,2,2060,6000,3,7,2060,0,580000
3,2.5,1810,914,3,8,1380,430,450000
3,1,1770,12458,3,7,1770,0,340500
4,2.5,2480,176418,5,8,2480,0,468000
3,2,3620,14250,3,8,3220,400,1.58E+06
4,2.5,1320,7000,4,7,1320,0,455000
4,1.75,2480,14782,3,8,1460,1020,550000
4,1.5,1920,10403,3,7,1370,550,210000
2,1,750,5026,4,6,750,0,292500
4,3.5,3065,5440,3,9,3065,0,729000
3,1,1480,5600,4,6,940,540,200000
3,2.5,1676,18778,3,7,1676,0,330000
3,2.25,1489,2800,3,7,1489,0,260000
4,2.5,3480,6262,3,9,3480,0,808000
5,3.5,3390,7950,3,7,3390,0,439900
3,1.75,1660,5987,3,7,960,700,410000
3,1.75,2100,29735,4,7,1080,1020,440000
3,1.75,1480,383328,3,8,1480,0,560000
3,2.25,2206,82031,3,6,866,1340,780000
4,0.75,1960,8277,4,7,1320,640,520000
5,1,1870,7800,3,7,1580,290,262000
3,2.25,1510,9600,1,7,1090,420,196000
3,1.5,1250,219978,4,6,1250,0,350000
5,1,1600,7350,5,7,1600,0,260000
3,1,920,3863,3,6,920,0,356000
5,2.25,2060,8632,3,7,1030,1030,255000
2,2.25,1910,108900,4,7,1010,900,411000
4,2.5,1770,13168,3,7,1770,0,455000
4,2.75,2900,6400,3,7,2040,860,450000
4,3,2230,108900,3,7,1410,820,460000
3,1.75,3520,12350,4,8,1530,1990,775000
3,2.25,1250,7500,5,7,1250,0,390000
5,1.75,2740,9600,4,7,1370,1370,470000
5,2.75,3050,7500,4,8,1800,1250,517850
4,1.75,1300,21000,4,7,1300,0,229950
2,1,800,8960,4,6,800,0,162248
3,2.5,2140,8925,3,8,2140,0,640000
3,1.75,1430,6818,5,7,1430,0,424000
3,1.75,1730,7807,3,7,1260,470,459000
4,1.5,1920,11595,4,7,1920,0,235000
2,2,1320,3060,4,6,1320,0,404500
3,1,1160,9750,3,7,1160,0,322500
4,2,1810,4400,3,8,1700,110,575000
4,2.5,1940,7040,3,8,1940,0,320000
4,2.5,3160,8281,4,9,3160,0,1.13E+06
5,3,3320,5354,3,9,3320,0,1.70E+06
2,1.5,900,5750,3,7,900,0,550000
4,2.5,2090,8325,4,7,1470,620,375000
3,1,1520,9507,3,7,1520,0,362500
4,2.75,3160,8429,4,7,1620,1540,552000
3,2.25,2950,15207,4,10,2070,880,992000
2,1,700,10540,3,6,700,0,192000
4,1.75,1440,4300,4,8,1290,150,656000
3,2.5,1840,3035,3,7,920,920,550000
3,1.75,1480,6985,4,7,1200,280,635000
3,2.5,1990,20466,4,8,1410,580,345000
4,2.5,2090,4400,3,8,2090,0,455000
3,1.75,1770,29004,3,8,1770,0,215000
3,2.5,1950,3000,3,7,1950,0,315000
3,2.5,2970,11985,3,9,1770,1200,525000
4,2.5,2070,7800,3,8,2070,0,255000
3,2.25,1530,1840,3,8,1240,290,460000
4,3.5,3030,5494,3,9,3030,0,799950
3,2.5,2440,4587,3,8,2440,0,677900
3,1.5,1200,890,3,8,1030,170,464950
3,1,1600,1950,2,7,1600,0,302000
3,1.5,1630,7475,3,7,1160,470,650000
4,2.5,2090,4196,3,8,2090,0,489900
6,2,2150,4505,3,7,1270,880,755000
4,2.5,3230,19193,4,8,2000,1230,795000
3,2,3110,44967,3,9,3020,90,379900
3,1,1250,9126,3,7,1250,0,330000
5,2.25,2780,10192,4,9,2780,0,830000
3,1.75,1940,219527,3,7,1940,0,520000
3,2.25,2520,78408,3,9,2520,0,449888
3,3.5,4070,26000,3,11,4070,0,1.48E+06
3,1.75,1810,7200,5,7,1030,780,360000
3,1,1570,10050,3,7,1570,0,367500
5,3,2560,5445,4,7,1760,800,442000
5,3.5,2720,7598,3,8,1860,860,690000
2,2,1700,7992,4,7,950,750,274000
3,1.75,1580,6127,5,7,1580,0,402000
3,1.5,1220,8400,4,7,1220,0,271950
3,1.5,1240,9500,4,7,1240,0,259950
5,3.5,2800,7350,3,7,2800,0,379900
3,2.25,2240,9542,3,7,1190,1050,418200
3,1,1660,11783,4,7,1160,500,367500
4,2.5,2900,9972,3,9,2900,0,850000
3,1,980,7296,3,7,980,0,375000
4,2,1540,7575,4,7,1040,500,215000
5,2.75,3220,5934,3,9,3220,0,798000
3,1,1550,12670,4,7,1550,0,240000
4,2.5,1850,6663,3,7,1850,0,295000
3,1.75,1610,8613,5,7,1610,0,725000
5,1.75,2980,53578,4,9,2230,750,575000
3,1,1480,4200,3,7,1480,0,427500
4,2.25,2190,3850,3,7,2190,0,350000
3,1,1240,5700,5,6,1240,0,238000
3,1,1800,5750,3,7,1040,760,610000
3,2.5,1690,1310,3,8,1140,550,430000
3,2.25,1810,11800,3,7,1240,570,251700
4,2,2120,11479,4,7,1060,1060,489000
3,1,1190,3600,3,6,1190,0,350000
3,1,1480,7830,3,7,1480,0,310000
3,1,1030,5350,3,7,1030,0,305000
4,3.25,2850,4800,5,10,2700,150,1.33E+06
5,2.5,2690,11745,3,8,1790,900,469000
6,3.25,4750,248600,4,8,4750,0,487000
4,2.5,1660,2500,3,7,1660,0,350000
4,1.75,1740,9344,3,7,1180,560,204950
4,1.75,1270,6825,3,7,1270,0,256000
5,4,4660,9900,4,9,2600,2060,739000
2,1,910,4725,3,7,910,0,515000
3,2.75,2000,7204,5,7,1250,750,538000
3,2,1540,7800,3,8,1540,0,525000
3,1.75,1690,9826,4,7,1690,0,281000
3,2,2290,9450,3,9,1670,620,565000
3,1,1240,9198,4,7,1240,0,185000
3,1,1450,7200,3,7,1010,440,306000
3,1.75,1900,7076,3,7,1130,770,315000
3,2,1270,10227,4,6,1270,0,410000
2,1,990,2446,3,7,990,0,285000
3,1,1400,13975,4,6,1400,0,280000
3,1,1250,7300,4,7,1250,0,385000
3,2.5,4090,16972,3,11,3590,500,1.68E+06
3,1,1160,3700,3,7,1160,0,315000
3,1,1080,8100,4,7,1080,0,339000
3,2.25,1610,8296,3,8,1610,0,450000
3,1.75,1800,18000,3,8,1200,600,385000
3,2,1470,10052,4,8,1470,0,480000
4,2.5,2150,37981,3,9,2150,0,609000
4,2.5,2130,10375,4,8,2130,0,435000
2,1,780,3475,4,5,780,0,286000
3,2.25,2110,7279,4,9,2110,0,716125
4,4.75,4790,25412,3,12,4790,0,1.68E+06
3,1.75,2570,13000,4,7,2570,0,634000
2,1,1310,4000,3,7,950,360,181000
3,3.25,3680,7650,3,9,2340,1340,722080
3,1.75,1520,7700,3,7,820,700,460000
3,2.5,1920,4803,3,7,1920,0,266950
3,3.25,2090,51212,3,8,1510,580,380000
2,2.25,1610,1968,5,7,1610,0,305000
5,2.75,2910,85377,4,8,1510,1400,625000
3,2.25,1390,1407,3,7,1390,0,328500
4,2.5,1830,9601,3,7,1830,0,321000
3,2.5,2130,3500,4,8,1210,920,534640
4,2,2430,199940,3,8,1310,1120,449500
3,2,1470,10125,4,7,1470,0,395000
3,2.5,2430,4203,3,8,2430,0,515000
4,1.75,1340,8400,5,7,1340,0,420000
3,2.5,1810,1658,3,8,1810,0,449000
4,2.5,3230,16171,3,9,2520,710,480000
2,1,1010,43056,3,5,1010,0,155000
3,3.25,3620,4000,3,10,2730,890,1.02E+06
4,2.5,2910,9000,3,9,2910,0,805000
2,1,790,7153,4,6,790,0,212000
3,1.5,1280,9600,4,7,1280,0,405000
4,1.75,2100,6613,3,8,2100,0,750000
4,2.5,2530,9933,3,8,2010,520,331950
4,2.5,2320,4000,5,8,1510,810,518000
3,1.75,1420,5170,4,7,1420,0,461000
3,2.5,2720,11937,3,9,2720,0,372400
4,2.25,2290,9546,4,8,1780,510,668500
3,1,1060,20040,3,6,1060,0,330000
3,1,1070,3713,4,6,1070,0,550000
7,1.5,2660,15111,4,7,2660,0,310000
3,1,910,8000,4,6,740,170,299950
2,1,1040,11500,5,7,1040,0,225000
4,3,2590,6160,3,8,2590,0,519995
4,2.5,2680,8778,4,8,2680,0,788000
4,2.5,2320,10079,3,7,2320,0,380000
4,2.5,2990,5400,3,8,2990,0,675000
4,3.5,4460,16271,3,11,4460,0,1.06E+06
4,3.25,4240,25639,3,10,3550,690,625000
3,1.75,1800,9314,3,8,1800,0,270000
3,2.5,3370,167706,3,10,3370,0,713900
4,2.5,3750,218506,3,10,3750,0,725000
3,2.25,1400,6970,3,8,1400,0,425000
4,3.25,3570,14408,3,10,3570,0,942500
4,2.5,2240,4800,3,8,2240,0,331210
4,1.75,1860,7700,4,8,1860,0,570000
3,1,1300,8284,3,7,1300,0,250000
2,1.75,1320,7540,3,7,1320,0,269950
3,2,1300,9644,3,7,1300,0,267000
3,2.75,2080,9600,3,7,2080,0,415000
4,2.75,2910,7467,3,8,2910,0,504058
3,1,1600,5000,3,7,1110,490,550000
3,3,3420,7826,4,8,2430,990,908800
1,1,560,5700,3,5,560,0,106000
3,2.5,2990,32239,4,8,2990,0,632925
4,1.75,1260,7250,3,6,1260,0,451000
4,2.5,2220,3561,3,8,2220,0,349990
3,2,1700,10000,3,8,1700,0,454000
2,1.75,2050,11900,4,8,2050,0,1.10E+06
3,1.5,1280,4031,4,6,1280,0,185000
2,2.5,3010,16050,4,9,1260,1750,998160
2,1,1500,3420,3,7,1500,0,480000
3,1.75,1050,7854,4,7,1050,0,237500
4,2.5,2980,12764,3,10,2980,0,649000
3,1.75,2050,4080,3,8,2050,0,790000
2,1.75,1210,3000,5,7,910,300,439950
2,1,1060,3588,4,7,960,100,506000
3,1.75,1510,8400,2,7,980,530,322000
5,2.5,4600,19831,3,9,2300,2300,805000
7,1.5,2670,11250,4,8,2320,350,575000
4,1.75,3550,19865,3,9,3550,0,2.10E+06
5,2.75,2400,7904,3,7,1450,950,325000
2,1,1190,27007,4,5,1190,0,195000
0,1,390,5900,2,4,390,0,228000
4,2.5,2170,5257,3,7,2170,0,445000
4,2.75,2290,21486,5,7,2290,0,625000
4,3.5,5860,7200,5,10,3690,2170,2.40E+06
5,2.5,3220,4759,3,8,3220,0,640000
3,2.5,2424,5931,3,9,2424,0,375000
4,2.5,1820,7575,3,7,1220,600,299000
4,2.5,2413,5701,3,8,2413,0,454950
4,2.25,2180,11056,3,8,1370,810,830000
2,2.25,1160,954,3,8,960,200,555000
3,2.5,2480,53250,3,9,2480,0,390000
3,1,1340,7000,4,7,1340,0,240000
4,2.75,4010,87555,3,10,4010,0,849000
3,1,1830,8004,3,8,1200,630,403500
4,1,1820,4000,3,8,1820,0,825000
2,1.5,690,1058,3,7,690,0,245000
6,4.25,6900,244716,4,9,4820,2080,1.14E+06
2,1.5,800,2142,3,7,800,0,305000
4,2.5,2830,7350,3,8,1690,1140,295500
2,2,1320,2040,3,7,1320,0,296000
3,3,1970,20978,4,9,1770,200,705000
5,3,3880,13000,3,10,3880,0,1.82E+06
3,2,1450,11204,3,7,1450,0,230000
4,2.5,2220,4720,3,7,2220,0,332500
3,2.25,1790,9580,3,8,1790,0,578000
2,1,1250,9270,4,7,1250,0,370037
4,1,1180,13500,3,7,1180,0,517000
5,2.75,3710,8674,3,9,3710,0,641000
3,2.5,3480,7800,4,7,1750,1730,950000
3,2,1430,7905,4,7,1430,0,200000
5,3.75,4220,15959,3,11,4220,0,1.17E+06
2,1.75,1840,4076,3,8,1140,700,575000
3,2,2010,16736,4,6,2010,0,380000
3,1.75,1890,6557,3,8,1890,0,495000
2,1,980,3080,3,7,980,0,550000
5,3.25,3950,44431,3,10,2100,1850,1.25E+06
3,1.75,2180,10230,4,7,1090,1090,325000
3,2.5,2200,4240,3,7,2200,0,290000
3,1,2270,4182,4,7,1170,1100,645000
3,2.5,1040,1032,3,7,1040,0,440000
3,1.75,1360,4998,3,8,1360,0,445000
3,2.5,2870,5163,3,9,2870,0,880000
4,2.5,2240,8664,5,8,1470,770,790000
3,2,2010,33090,5,8,2010,0,415000
2,2.5,1380,1073,3,7,1140,240,285000
3,1.75,1860,7881,3,7,1160,700,352500
4,2,1960,10559,4,7,1960,0,415000
3,2.5,1810,1750,3,7,1350,460,503500
6,4.5,3300,7480,3,8,3300,0,510000
2,1,760,3000,3,6,760,0,530000
4,2.5,2380,7792,3,8,2380,0,342000
3,3.25,3786,38038,3,9,1934,1852,1.38E+06
3,2.5,1770,9450,3,8,1770,0,289950
3,3.25,2260,7701,3,8,1760,500,477590
3,2,2710,4500,4,8,1880,830,805000
3,2.5,2740,22499,3,9,2740,0,568000
5,3.5,5850,22885,4,11,4670,1180,1.70E+06
4,2.75,3190,9023,3,9,3190,0,750000
4,2.5,2560,5102,3,8,2560,0,379500
4,2.5,3700,4500,3,9,3700,0,650000
3,1,860,7467,3,6,860,0,205000
2,1,1060,4960,3,7,1060,0,515000
3,2.25,1620,997,3,8,1540,80,450000
4,1.75,1840,10720,3,7,960,880,404000
3,1,1660,7650,3,7,1350,310,570000
3,2.5,2080,8690,3,8,1430,650,549950
4,2.5,3120,49456,4,9,2590,530,1.23E+06
5,1.5,1980,7958,3,7,1980,0,215000
3,2,2330,26571,3,8,2330,0,530000
3,2.5,2700,6037,3,8,2700,0,565000
4,3,2480,9238,5,7,2050,430,455000
4,1.75,2130,11097,3,7,1370,760,292000
3,2.5,2678,6607,3,9,2678,0,546200
4,1.5,1580,10230,3,6,790,790,299980
4,1.75,2030,18295,4,7,2030,0,493000
3,2,1600,9638,5,7,1600,0,785000
3,2.25,3130,65775,4,8,3130,0,710000
5,4,3870,5929,3,10,3870,0,1.30E+06
2,1,1630,7680,3,7,830,800,426000
3,1,1040,6250,3,7,1040,0,400000
3,3,1730,1755,3,8,1730,0,577450
6,1,1370,5080,3,6,1120,250,175000
2,1,1150,3775,3,7,1150,0,599950
4,2.5,2740,33158,3,9,2740,0,476000
2,1.5,960,1829,3,7,960,0,386180
2,1,910,22000,3,6,910,0,100000
3,1.75,1430,7700,4,7,980,450,252000
3,1.5,1660,6000,3,7,1660,0,578000
3,1.5,2480,5280,5,7,1620,860,475000
3,1.75,1770,6000,3,7,1130,640,420000
3,1.5,1240,4080,3,8,1240,0,530000
3,1.5,1210,7560,3,7,1210,0,324950
3,1.5,1540,20281,3,7,1540,0,480000
3,2,1160,13747,5,5,580,580,775000
2,1.5,1080,6760,3,6,1080,0,440000
2,1.75,1350,4003,3,8,1350,0,430000
3,2.5,1460,1614,3,8,1180,280,499000
3,1.5,1540,5040,3,8,1540,0,659000
4,2.5,1950,3000,3,7,1550,400,497950
3,1.5,1110,1150,3,8,940,170,190500
4,3.5,3380,11270,3,9,2160,1220,865000
4,2.25,2380,122038,4,8,2380,0,330000
3,1,1010,9360,3,6,1010,0,350000
2,1,1070,5080,5,6,1070,0,325000
3,1.5,2240,28750,3,8,1620,620,497000
4,2.5,2010,7226,3,8,2010,0,316000
3,2,1550,18958,3,7,1550,0,290000
3,2.5,3320,11875,5,10,3320,0,959000
3,1.75,3330,12566,4,8,1940,1390,1.96E+06
3,2.5,2437,5136,3,7,2437,0,285000
3,2,1200,5700,5,7,1200,0,272000
4,2,1610,8976,4,8,1610,0,650000
3,2,1810,2738,4,9,1810,0,515000
3,2,1740,18000,3,7,1230,510,405000
3,2.5,1800,3980,3,7,1800,0,286000
2,1.75,1350,2653,3,7,1350,0,405000
5,2.75,3650,13297,5,9,2750,900,1.20E+06
3,2,1920,8075,4,7,1510,410,260000
5,1.75,1880,18295,4,7,1880,0,618000
5,4.25,4150,12015,3,10,4150,0,1.21E+06
3,1,1770,5720,4,7,1140,630,373000
4,1.5,1970,14490,4,7,1970,0,374950
6,2.75,2980,5000,3,7,2480,500,775000
3,2.25,2240,8800,5,8,2240,0,831000
3,2.5,1860,11122,3,8,1860,0,429000
2,2.25,2550,6000,5,7,1860,690,660000
5,2.5,2650,54380,3,9,2650,0,549950
4,2.5,2560,36601,4,9,2560,0,675000
4,1.75,1700,7800,4,8,1700,0,600000
3,3,1670,4440,3,7,1670,0,246950
3,2.25,1760,2122,3,9,1760,0,643950
3,3.25,2220,8227,5,8,1770,450,569000
4,2.5,2610,4781,3,8,2610,0,335000
3,1,1720,9605,3,7,860,860,280000
2,1,820,4880,4,6,820,0,363000
2,1,900,2910,5,7,900,0,381500
4,3,2750,7500,5,8,1630,1120,710000
4,2.5,3080,10646,3,9,3080,0,440000
3,2,1920,33630,3,8,1920,0,352500
2,1,1730,9610,3,7,1380,350,200000
3,3.5,3390,10078,3,10,3040,350,750000
3,2.5,1670,4020,3,7,1670,0,252000
4,1.5,1950,6300,3,7,1650,300,750000
4,1.75,2120,8520,3,7,1600,520,278100
4,3.5,3560,4951,3,9,3560,0,922755
3,1.75,2200,11520,4,7,2200,0,359000
3,2.5,2390,3903,3,8,1970,420,420000
4,1.75,2140,8162,3,7,1420,720,292500
3,2.5,2170,5000,3,9,2170,0,619500
3,3.5,2800,7694,3,9,2800,0,920000
2,1.5,1370,159865,3,7,1370,0,385000
3,2.5,2360,11254,3,9,2360,0,515000
4,2.25,3740,18000,4,9,1870,1870,1.15E+06
4,2.75,2540,4400,5,7,1630,910,696500
3,2,1360,5980,3,8,1360,0,703000
2,1,790,6969,3,6,790,0,315000
4,1,1910,16320,3,6,1910,0,240000
2,1,810,4800,3,6,810,0,367500
3,2.25,2130,8801,3,8,1370,760,482975
3,2.25,2280,6150,3,8,2280,0,660000
3,2.5,2170,4912,3,7,2170,0,449950
3,1,1350,7085,5,7,1350,0,427500
3,2.25,1190,1022,3,8,1190,0,350000
3,2.5,1610,1356,3,8,1240,370,320000
3,2.75,1890,2614,4,9,1890,0,462000
4,3.5,3720,8301,3,10,2880,840,1.45E+06
4,2.75,2310,5000,3,7,2310,0,309950
4,2.5,2890,7306,3,7,2890,0,515000
3,1.5,1460,6480,4,7,980,480,675000
4,2.25,2210,8101,3,9,2210,0,620000
3,1.5,1320,7980,3,7,1320,0,255000
4,1.75,1490,9112,3,6,970,520,271000
5,2.25,2340,7494,3,7,1170,1170,242000
3,2.5,2530,8669,3,9,2530,0,299250
3,2,1760,4046,3,7,960,800,554000
4,3.25,3030,5164,5,9,2700,330,1.35E+06
4,2.5,2201,9542,3,8,2201,0,397000
3,1.75,2160,7140,4,7,1670,490,272000
3,2,1410,7622,4,7,1410,0,272500
2,2.5,1050,1029,3,8,950,100,332888
3,1,1900,14400,4,7,1300,600,315000
3,1.75,1480,7000,3,8,1480,0,685000
3,1.5,990,1343,3,8,840,150,490000
3,2.5,2280,58712,3,9,2280,0,520000
3,2.5,1530,5032,3,7,1530,0,452000
3,2.5,2360,4638,3,9,2360,0,580050
4,2.5,2940,9172,3,9,2940,0,480000
3,1.5,1540,8400,5,7,1540,0,380000
3,1,1480,7284,3,7,970,510,336500
4,1.75,1840,9600,3,7,1220,620,538000
2,0.75,760,33801,4,4,760,0,352000
3,2,1410,6030,4,7,1410,0,418000
2,2.25,2320,9300,5,9,1920,400,1.15E+06
3,2.5,1670,2575,3,8,1670,0,500000
3,1.5,2400,8215,3,7,1200,1200,338000
4,2.5,2880,12349,3,10,2880,0,710000
4,4.25,4250,6552,4,10,2870,1380,2.45E+06
4,2,2070,7980,4,7,2070,0,565000
4,2.25,2420,36680,4,8,2420,0,500000
3,2.5,3110,123710,3,8,2430,680,700000
4,1.75,2250,4750,4,7,1420,830,637800
3,1.5,1300,1435,3,8,1120,180,552500
5,2.75,3750,12077,3,10,3750,0,775000
4,1.75,2030,15400,3,9,1130,900,474950
3,4.5,5230,17826,3,10,3740,1490,3.40E+06
4,2.5,2770,9751,3,8,2770,0,347000
4,2.5,2480,8563,3,8,2480,0,424950
3,1.75,1980,11274,4,7,1480,500,299950
3,1,1450,8100,3,6,1450,0,357500
4,1,1540,5000,4,7,1090,450,542000
2,1,600,4000,3,5,600,0,156000
3,2,1980,3525,4,8,1590,390,703300
4,2.25,1930,7925,3,8,1300,630,367500
3,2,3010,5000,5,9,1890,1120,1.10E+06
4,2.5,2612,5850,3,8,2612,0,379950
3,1,860,7030,3,7,860,0,350000
3,2.25,2120,9804,3,7,2120,0,278000
4,3.25,3780,11200,3,11,3780,0,1.03E+06
3,1.5,1130,7223,4,7,1130,0,341500
3,2.5,2870,13695,3,10,2870,0,872750
3,2.5,3090,7708,3,10,3090,0,822500
4,2.5,2990,29170,3,9,2990,0,725000
4,2.5,1870,5692,3,7,1870,0,272000
3,2.25,2260,17114,3,7,2260,0,605000
2,1,1060,7193,3,7,1060,0,461000
4,2.5,2510,35020,4,8,1610,900,630000
3,3.5,2630,4713,3,9,2030,600,695000
5,3.5,2920,3000,3,9,2260,660,1.07E+06
3,2.75,2780,4000,5,8,1960,820,1.03E+06
4,3.5,3050,7020,3,9,2050,1000,750000
5,3,2876,13927,4,9,1970,906,895000
3,2.5,1990,3644,3,7,1990,0,318200
4,2,2970,52567,3,8,2970,0,665000
3,1.5,2080,5244,3,7,1190,890,399950
4,1.75,1890,4500,5,7,1490,400,860000
4,2.75,2730,4683,3,7,2730,0,374950
3,1.5,1730,40250,4,8,1730,0,535500
4,2.5,3430,7508,3,10,3430,0,813000
3,1,1460,5000,4,7,1460,0,395000
2,1,720,3255,4,6,720,0,403000
4,1.75,2740,8520,3,8,1370,1370,657000
3,1,1040,16986,4,7,1040,0,314950
3,1.75,1120,15210,5,7,1120,0,249950
3,2.25,1970,11088,4,8,1180,790,465000
5,2.25,2480,12070,3,9,2480,0,615000
4,4,3330,24354,4,10,3330,0,2.50E+06
3,3.5,2500,4270,3,8,2500,0,538500
3,2.5,1990,12793,3,8,1990,0,450000
5,2.75,2460,7830,5,9,1490,970,835000
2,1,1770,8640,3,6,1520,250,585000
3,1,1240,8000,4,6,1040,200,140000
3,1.5,1400,1022,3,8,1400,0,425000
4,1.75,1800,28650,4,7,1800,0,295000
3,2.5,2630,10131,3,9,2630,0,609000
3,1,1800,4005,4,7,1160,640,556000
2,1,960,7000,3,4,960,0,95000
2,2.5,2110,114127,4,8,1590,520,380000
4,2.5,2500,12090,3,9,2500,0,565000
2,1,1450,3090,3,7,1450,0,499000
3,2.25,1860,15559,4,7,1860,0,380000
5,3.5,4230,16526,3,10,4230,0,1.94E+06
3,1.75,1390,8700,4,7,840,550,280950
3,1.5,1220,8345,3,7,1220,0,225000
2,1.75,1200,2622,5,7,800,400,306000
3,1.75,2450,8603,5,8,1340,1110,850000
4,2.5,1980,5020,3,7,1980,0,405000
4,3.25,3820,8114,3,10,3820,0,1.62E+06
4,4.5,4510,12873,3,12,4510,0,1.82E+06
3,2.5,1960,9535,3,8,1960,0,575000
4,2.75,2610,9426,3,7,1360,1250,368000
3,2.5,2990,10711,3,9,1560,1430,820000
2,1.75,1530,5000,4,7,1260,270,576250
4,2.75,1820,5400,4,7,1220,600,430000
2,1,820,3700,5,7,820,0,554000
3,2.25,3060,12095,3,10,3060,0,860000
3,2.75,2540,4694,3,9,2540,0,695000
2,2.5,1400,2958,3,8,1400,0,372500
3,1.75,1830,5120,5,8,1830,0,682000
4,4,4360,8175,3,10,3940,420,2.30E+06
3,2.5,1400,2036,3,7,1400,0,346100
4,2.25,2090,10869,3,8,2090,0,490000
5,2.25,3700,7207,5,8,1850,1850,722500
3,1.75,1380,10529,3,7,1380,0,345000
4,1.5,2150,23568,4,7,2150,0,419000
4,3.5,3910,59863,4,10,2490,1420,780000
3,2.5,1720,7950,4,7,1720,0,525000
2,2,1580,5203,3,8,1580,0,495000
3,2.25,2280,8765,3,8,2280,0,356000
3,2.25,2280,5750,4,7,1150,1130,475000
3,2.5,1980,1873,3,7,1470,510,580000
3,1,1140,9779,3,7,1140,0,234300
2,1,940,4800,4,6,940,0,399000
2,1,1020,8100,3,6,1020,0,195000
3,1.75,1240,7620,3,7,1240,0,361810
3,2.5,3290,6830,3,10,3290,0,930000
2,1,1110,9920,5,6,700,410,343000
4,2.25,1740,9600,3,7,1160,580,294950
3,1,1280,2580,3,8,1280,0,478000
4,2.5,2810,6296,3,9,2810,0,487500
3,1,1590,11200,4,7,1590,0,247200
2,1,910,22725,1,6,910,0,305000
2,1.75,990,5850,4,6,990,0,458000
3,1,920,3532,3,6,920,0,380000
3,1.75,1740,4400,3,8,1740,0,650500
2,1,1200,9850,4,7,1200,0,189000
3,2.25,2680,41804,3,9,2680,0,676000
3,2.25,2000,7560,3,7,1400,600,300000
4,1.75,2700,7625,4,8,1450,1250,710000
2,1,700,6000,3,6,700,0,225000
1,0.75,740,1284,4,6,740,0,290000
3,1,1070,14000,3,7,1070,0,147000
3,1.75,2030,32565,3,8,1600,430,597500
3,2.25,2670,37089,3,9,2670,0,345000
3,1,1320,7155,4,6,1320,0,185000
2,1,820,5100,4,6,820,0,235000
3,1.5,1010,7755,3,6,1010,0,185000
3,1.75,1260,1133,3,7,810,450,255000
4,2.5,2990,8913,4,9,2990,0,469900
4,2,2360,6000,4,8,2360,0,640000
3,2.5,2040,7503,3,8,2040,0,619000
2,1.5,1120,1024,3,8,1120,0,440000
4,2.25,1860,9576,3,7,1400,460,249000
3,1,1000,5100,3,7,860,140,425000
3,2.5,1710,7230,3,7,1710,0,275000
4,2.5,2560,5672,3,8,2560,0,518000
5,3.25,2910,5027,3,8,2040,870,515000
3,2.5,2580,214315,3,8,2580,0,400000
3,2.5,1530,3210,5,7,1010,520,545000
3,2.5,2830,3750,3,10,2830,0,969950
4,3.5,3550,11000,3,11,2260,1290,1.36E+06
3,1,1160,9750,3,7,1160,0,305000
3,1,1590,6420,3,7,1590,0,529000
3,2.25,1730,13040,4,8,1290,440,500000
3,1,1280,5460,4,7,1280,0,443000
5,2,2310,13430,4,8,2310,0,850000
3,1.75,2470,9620,4,7,1570,900,405000
2,2.5,1500,1174,3,8,1140,360,529950
2,2.25,1800,2819,4,9,1800,0,542000
2,1,770,17334,3,7,770,0,100000
3,1.5,1660,7221,3,7,980,680,225000
3,1.5,1720,7110,3,8,1720,0,323000
3,1.75,1560,9788,3,7,1560,0,291000
4,2.75,1610,11201,5,7,1020,590,575000
4,3.5,3130,3900,3,9,2550,580,1.39E+06
2,1,1070,32633,4,6,1070,0,320000
4,2.5,3670,54450,3,10,3670,0,883000
4,2.75,2720,54048,3,8,2720,0,680000
4,3.25,2820,6611,3,7,1410,1410,485000
3,1.75,1350,2325,3,7,1350,0,388000
4,2.75,1950,6930,4,7,1250,700,621000
3,2.5,2460,54885,4,8,2460,0,520000
3,1,1210,9622,3,8,1210,0,660000
2,1,770,5040,3,5,770,0,425000
2,1,850,6370,3,6,850,0,250000
3,1,1190,6250,3,7,990,200,250000
3,1.75,1300,6318,3,7,1300,0,198000
3,1,1330,3740,3,6,1330,0,310000
5,3.25,3690,12353,5,9,3690,0,655000
3,1.75,1840,8601,3,7,920,920,285000
4,2.5,3420,222156,3,9,3420,0,650000
2,1.5,1020,1146,3,7,1020,0,455000
4,3.5,3540,4750,3,10,3540,0,550000
3,2.25,1820,7326,3,8,1820,0,489950
5,2.5,3600,17300,4,8,2410,1190,403500
3,2.25,1880,6565,4,8,1420,460,554500
2,1.75,1170,4635,4,6,690,480,480000
2,2.25,1150,711,3,7,1150,0,325000
3,2.5,1680,4584,3,7,1680,0,320000
5,3,3450,9914,3,9,3450,0,380000
3,2.5,1900,7361,3,8,1900,0,380500
3,2.5,1940,8347,3,8,1940,0,324000
4,1.75,2320,5595,3,7,1510,810,775000
5,3,3420,18129,3,9,2540,880,1.20E+06
2,1,860,10400,4,6,860,0,195000
5,2.25,2650,9140,3,8,1350,1300,536000
4,2.5,3450,17400,4,9,2180,1270,1.39E+06
3,2.5,2390,9157,3,9,2390,0,735000
4,2.5,2590,9530,4,8,1640,950,537250
4,2.5,2790,7938,3,9,2790,0,764000
3,1.75,1730,8400,4,7,1400,330,522000
5,2.25,2120,4000,4,7,1720,400,682000
2,1,760,4000,3,7,760,0,415000
3,1.5,1320,8000,3,7,1320,0,412000
3,1,1140,4500,3,6,840,300,450000
5,2.75,3810,9360,3,10,3810,0,1.70E+06
4,2.5,3160,7210,4,7,1880,1280,467500
4,2.75,3010,7215,3,9,3010,0,879950
4,2.5,2755,11612,3,8,2755,0,545000
3,1.5,1370,7697,3,7,1370,0,468000
3,2,1560,5130,5,7,1150,410,549000
2,1,940,5000,3,6,940,0,275000
3,1.5,1460,9879,3,7,1460,0,465000
4,2,2170,5404,5,6,1470,700,250000
2,1,910,9612,4,7,910,0,225000
2,1,1050,3088,3,7,1050,0,285000
4,2.75,2560,83200,3,8,1860,700,562000
5,2.75,2820,4608,3,7,1450,1370,599000
4,1.75,2090,5050,4,7,1090,1000,775000
3,1,1150,7560,4,6,1150,0,215000
3,2.5,1880,4200,3,7,1880,0,300000
3,1.75,1390,11700,4,7,1390,0,450000
3,2.5,2280,6386,3,8,2280,0,312000
4,1,1200,2171,3,7,1200,0,240000
4,2.5,3290,35001,3,10,3290,0,783350
2,1.75,1950,2719,5,7,1010,940,725000
3,2.5,2700,5764,3,9,2700,0,775900
4,1,2320,4000,3,6,1310,1010,400000
3,2,1470,16500,3,7,1470,0,300000
3,1,1010,3060,3,6,1010,0,345000
2,1,1450,7098,3,7,1450,0,822500
4,2.5,2180,10140,4,7,1180,1000,540000
5,3.5,3510,4798,3,10,2700,810,1.25E+06
3,2.5,1490,3840,3,7,1490,0,265950
3,2,2090,4077,4,8,1530,560,1.05E+06
3,1.75,1500,11968,3,6,1500,0,224000
4,1.75,2000,3728,4,9,1820,180,1.35E+06
5,2.5,3470,12003,3,8,3470,0,599000
4,2.5,2560,7492,3,8,2560,0,399500
4,2.25,1890,7210,3,8,1890,0,545000
4,2.75,1940,6555,3,8,1940,0,392000
3,2.5,1630,10762,3,7,1630,0,425000
5,3.5,3900,4400,3,9,2650,1250,1.20E+06
4,1.5,1370,3708,3,7,1370,0,545000
4,1.75,1910,8171,3,7,1910,0,220000
4,3,2420,9566,3,7,2420,0,375000
4,2.75,2310,7350,3,8,1670,640,470000
2,2,1930,5479,3,8,1930,0,548050
4,3.5,3190,31450,3,9,3190,0,790000
4,2.75,3010,6854,3,9,2570,440,625000
3,2.5,2270,4399,3,7,2270,0,469900
4,1.75,1760,3600,5,7,880,880,527950
3,2.5,2480,4950,3,7,2480,0,374900
4,3.5,3930,16970,3,9,3930,0,575000
3,2.5,1660,4898,3,7,1660,0,295000
4,1.75,1890,9205,3,8,1260,630,300000
4,3,2580,5511,3,8,2580,0,370000
4,2.75,3730,8014,3,10,3730,0,925000
4,2.25,1990,21312,4,8,1990,0,365000
3,1.75,2070,6000,3,8,1340,730,690000
4,2.5,2280,4602,3,8,2280,0,565000
4,3.5,2260,30250,3,7,2260,0,400200
4,2.5,1970,7098,3,7,1970,0,347500
3,2.5,3040,4535,3,9,3040,0,478000
2,1,910,6232,3,6,910,0,155000
3,1,1490,5700,3,7,1490,0,578500
2,0.75,780,55764,4,4,780,0,200000
3,1,1490,57381,4,5,1490,0,325000
3,1.5,1200,4800,4,7,1200,0,400000
3,1.75,2680,8625,5,8,1590,1090,575000
2,2.25,1660,2748,3,7,1660,0,235000
3,2.25,1410,7740,5,6,1410,0,490000
2,1,1010,4320,5,7,1010,0,501000
3,2.5,1400,1529,3,7,1400,0,358000
3,1.75,1690,7735,4,7,1060,630,197000
2,1,1080,4000,3,7,1080,0,345000
4,3,2400,7680,3,7,1200,1200,608000
3,2.5,2420,7500,4,8,1210,1210,649950
5,2.5,4320,107157,4,8,2160,2160,565000
4,1.75,1840,9250,4,7,980,860,480000
3,2.75,2440,76531,3,10,1640,800,720000
3,2.5,3490,21064,3,10,2290,1200,2.00E+06
4,2.5,2550,10000,3,8,1290,1260,660000
3,3,1520,7500,3,7,1180,340,460000
2,1.5,1160,982,3,7,890,270,284900
4,2.25,2390,7350,3,8,2390,0,319000
3,2.5,2280,6031,3,8,2280,0,415000
2,1.75,1850,3060,3,7,1060,790,538000
3,2.5,1950,5689,3,7,1950,0,425000
4,2.25,1900,11171,3,8,1280,620,629000
3,2.5,2830,5802,3,9,2830,0,551000
4,3.5,5000,38012,3,11,3610,1390,1.45E+06
4,1,2180,10617,3,7,2180,0,359000
4,2,1560,5220,3,7,1560,0,449000
4,2.25,2460,44431,4,9,2460,0,900000
4,1,1500,6360,3,6,1500,0,235000
3,1.75,1370,8467,4,7,970,400,460000
4,1.5,1400,8500,3,7,1400,0,257000
4,2.5,1900,5889,3,7,1900,0,360000
4,1,1200,6600,3,7,1200,0,436000
2,1,1020,13647,5,6,1020,0,160000
3,2,1100,6360,3,7,1100,0,240000
4,2.25,2330,7020,4,8,1450,880,615000
3,1,1030,4089,3,7,1030,0,570000
3,2,1870,5300,3,8,1870,0,580000
3,3.5,2940,6431,3,10,2940,0,914154
4,3.5,3560,16782,3,10,2560,1000,1.40E+06
3,1,1060,7473,3,7,1060,0,140000
4,3.5,2650,3060,3,9,2060,590,1.01E+06
3,2.5,2030,6970,4,8,2030,0,525000
4,2.25,1900,7200,3,8,1370,530,485000
3,1.5,1490,9630,4,8,1490,0,385000
5,4,2980,4500,3,7,2070,910,842500
3,2.25,1700,9008,3,8,1340,360,500000
3,1.75,1980,8100,4,7,1310,670,405000
3,2.25,1940,11612,4,8,1100,840,359950
3,1,1100,4184,4,7,1100,0,416500
2,1,1780,81021,4,9,1780,0,270000
3,1.75,2330,14892,3,8,1970,360,588500
4,3.25,3640,13530,3,9,2570,1070,1.65E+06
4,3.25,3240,4852,3,9,3240,0,789500
4,1,1810,7500,2,7,1410,400,264950
4,2.5,3070,6432,3,9,3070,0,462000
3,1,1090,10710,4,7,1090,0,280000
4,4,5610,11063,3,11,4750,860,1.58E+06
3,1,1040,9514,4,7,1040,0,299000
2,1,1080,6250,4,7,1080,0,308000
3,1,1410,81021,3,7,1410,0,299950
3,1,900,7500,4,7,900,0,304000
3,2,1430,9250,4,8,990,440,510000
4,2,980,10640,5,7,980,0,295000
4,2.5,3070,6923,3,9,3070,0,860000
3,1,1120,10176,3,6,920,200,345000
3,1.75,2270,10136,3,8,2270,0,575000
4,1,1040,4420,3,6,1040,0,396000
3,1.5,1190,11996,4,7,1190,0,332900
3,2.5,1720,4006,3,8,1720,0,535000
3,1,1710,4050,3,7,1710,0,620000
3,2.5,2470,10321,3,9,2470,0,732500
4,1.75,2230,9625,3,8,1180,1050,415000
4,4.25,4890,15188,3,11,3090,1800,2.40E+06
4,2.25,2270,8480,5,8,1310,960,527500
3,1.75,1640,10762,3,7,1130,510,226500
4,2.5,2030,7210,5,7,1330,700,365000
3,1.5,1590,7080,3,8,1310,280,720000
4,2.5,2360,43088,3,8,2360,0,542126
3,2.75,2330,4780,3,8,1730,600,550000
5,2.75,2040,7488,4,7,1200,840,449500
3,1,1100,5200,4,6,1100,0,225500
2,1.75,1350,4003,3,8,1350,0,419950
3,1,1130,8201,5,6,1130,0,350000
3,2.25,2020,21010,3,7,2020,0,420000
3,2.5,1790,8144,3,8,1790,0,583000
4,2,1720,5413,3,7,1470,250,495000
3,1,1230,6000,4,7,780,450,433500
5,2.25,2710,22120,3,7,1410,1300,495200
2,1,1460,7832,3,6,1460,0,420000
4,2.5,1860,8117,4,8,1460,400,585000
4,2.25,2240,9684,4,9,2240,0,939000
3,2.5,1450,3748,3,7,1450,0,339000
6,2.75,2520,9324,4,7,1320,1200,410000
3,1.75,1930,6000,3,8,1130,800,560000
4,1.75,2010,5070,4,7,1300,710,650000
4,2.75,4430,74358,3,10,4430,0,970000
1,0.75,560,12120,3,4,560,0,299000
3,2.5,2620,8403,3,8,2620,0,408000
3,1,1060,4880,2,6,910,150,555750
4,2.5,2290,11173,4,8,2290,0,436500
3,2,1240,14404,3,7,1240,0,405000
3,1.5,1240,8410,5,6,1240,0,390000
4,2.5,2800,5368,3,8,2800,0,676000
3,1,1092,7500,3,6,1092,0,309000
3,1.75,2140,13598,4,7,1620,520,375000
3,1,1300,5898,3,7,1300,0,236000
3,2.5,2350,3750,3,7,1740,610,650000
3,1,1200,15960,3,6,1200,0,398500
1,1,640,6350,3,5,640,0,279200
4,1.75,1880,9880,4,8,1880,0,333000
4,3,3900,9750,5,10,2520,1380,1.65E+06
2,1,2020,6720,3,7,1010,1010,355000
4,2.25,1950,5950,3,8,1330,620,895000
3,1.75,2120,18335,3,7,1380,740,249000
4,3.25,4800,12727,3,10,4800,0,1.08E+06
5,1.75,2640,7722,4,7,1650,990,823000
4,2.5,2720,8000,4,7,1360,1360,710000
2,1.5,830,1034,3,8,830,0,345000
1,1,760,3000,3,7,760,0,415000
3,1.75,2020,4800,4,8,1090,930,840000
4,2.5,3240,13978,3,9,1860,1380,635700
2,2.25,1280,835,3,7,1080,200,370000
4,1.75,1200,7680,3,7,1200,0,210000
2,1,1450,6380,3,7,1450,0,350500
4,2.5,2410,9886,5,8,1990,420,938000
3,2.5,2000,22000,3,8,2000,0,593700
2,2,1640,3021,3,7,840,800,540000
3,2.5,2530,43733,3,8,1530,1000,454000
4,2.75,3090,16538,4,8,2590,500,1.00E+06
4,2.75,2200,9676,3,8,1500,700,460000
3,1,1440,8287,4,7,1440,0,370000
4,3.5,3130,4500,3,9,2060,1070,1.38E+06
3,2,1930,10929,3,8,1260,670,570000
4,1,1550,7296,3,6,1550,0,250000
3,2,1760,6092,3,7,1760,0,295000
3,1.5,2170,16600,3,10,1130,1040,1.15E+06
3,1.5,3430,264844,3,7,2230,1200,524500
3,2,1610,8416,3,7,1610,0,268000
1,0.75,680,9600,3,5,680,0,200000
3,1.75,1960,6380,4,7,980,980,561500
5,1.75,2640,13290,4,8,1400,1240,750000
3,1.75,1880,16239,3,7,880,1000,452000
3,1,930,3348,4,6,930,0,465000
4,2.5,2980,8770,3,10,2980,0,680000
4,2.5,3060,7140,3,9,3060,0,826000
3,4.5,3970,24920,3,10,3260,710,1.45E+06
1,1,800,2480,4,6,800,0,267000
4,2.5,2050,8094,3,8,1050,1000,601002
3,1.75,1430,4920,2,6,1430,0,175000
4,2.75,3580,12000,3,10,1840,1740,879900
2,1.5,1300,1676,3,7,1300,0,685000
4,1.75,1920,3600,4,8,1920,0,870000
3,1.5,1550,9126,5,7,1550,0,245000
3,1,1200,7500,3,6,1200,0,210000
4,2.5,1620,5280,4,7,1620,0,385000
4,2.75,1790,47250,3,7,1220,570,390000
4,3.5,3860,18334,3,10,3120,740,840000
4,2.5,2640,3899,3,7,2640,0,436000
4,2.75,3070,7201,3,9,3070,0,535000
2,2,1313,3600,3,8,1313,0,885000
3,3.25,1720,1330,3,8,1030,690,675000
2,1,1650,9780,3,7,950,700,580000
3,2.25,1430,2003,3,8,980,450,457500
3,1.5,1670,10800,4,8,1670,0,295000
3,2.5,1740,1236,3,8,1740,0,580000
3,2.5,1480,1485,3,8,1280,200,584000
3,2.25,1670,3135,3,8,1220,450,540000
3,1.5,1490,7275,3,7,1090,400,415000
3,1.5,1750,7000,3,8,1750,0,260000
4,2.5,2440,5737,4,8,1700,740,820000
4,1.75,2360,6000,3,7,1280,1080,700000
4,2.5,2560,6238,3,8,2560,0,385000
4,2,1800,5465,3,7,900,900,439000
3,1,1090,6320,3,6,890,200,220000
4,1.75,2440,7475,4,9,2040,400,675000
4,2.75,2050,7171,3,8,1540,510,528000
3,2,1410,2700,4,7,1410,0,520000
2,1.75,1728,95950,3,9,1728,0,730000
4,2.5,2610,7227,3,9,2610,0,390000
3,1.75,1370,19550,3,7,1370,0,375000
4,3.5,4070,336283,3,11,4070,0,1.70E+06
5,2.75,2910,16410,4,8,2910,0,410000
3,2.5,1780,4000,4,8,1780,0,459000
4,2.75,2450,14803,4,9,2450,0,619420
2,2,1494,19271,3,7,1494,0,465000
5,3,2870,5700,3,7,1950,920,765000
2,2.25,2550,5663,3,10,1720,830,630000
4,2.5,3216,5902,3,9,3216,0,498445
4,2.5,1850,5444,5,7,1850,0,475000
4,2.25,2880,9996,4,8,1920,960,614000
2,2.5,1160,1219,3,8,1160,0,415000
4,2.5,1980,9757,5,7,1980,0,357000
4,2.75,1980,11443,5,7,1980,0,475000
4,3.25,3500,10260,3,10,3500,0,798000
3,2,1550,2401,3,7,1550,0,440000
3,1.75,1480,2185,3,9,1480,0,620000
4,1.5,1420,6720,3,7,1420,0,349950
4,2.75,1890,5240,3,7,980,910,375000
4,1.75,1530,8152,5,6,910,620,338000
2,2,1590,8000,3,7,910,680,295000
3,2.5,1830,2517,3,8,1830,0,274000
4,1.75,1720,8300,4,8,1720,0,330000
3,2.25,1960,8875,3,7,1290,670,182000
4,2.5,2280,8190,3,7,1390,890,345000
3,2.25,1580,12177,3,7,1200,380,475000
3,1.75,1730,3400,5,7,970,760,670000
3,1.75,1290,8580,4,7,1290,0,460000
3,2,1260,4125,3,6,1260,0,216000
8,3.75,3460,4600,3,7,2860,600,808000
2,2,1370,7920,3,8,950,420,585000
4,2.25,2760,5200,3,7,1790,970,600000
3,3,1460,1200,3,8,1460,0,427005
4,2,2630,16475,4,8,2630,0,843500
3,2,1370,7500,3,7,1370,0,252000
3,3.5,2690,104544,3,8,2690,0,775000
3,1.75,1660,10716,3,7,1100,560,412500
2,1,1770,16660,3,8,1220,550,345000
4,2.5,2990,6037,3,9,2990,0,594491
4,1.75,1930,6720,3,8,1130,800,495000
3,1,1600,4489,3,6,800,800,364500
3,2,1900,6660,5,7,950,950,250000
3,2.25,1390,6004,3,8,1390,0,292500
5,2.5,2800,11325,4,8,1400,1400,850000
4,2.5,2940,156988,3,9,1870,1070,503000
1,1,470,63737,5,5,470,0,192500
3,2.25,2340,14279,3,8,1340,1000,438000
4,1.75,1510,5500,3,7,1510,0,250000
3,1.75,1090,7647,3,7,1090,0,236000
5,2.75,2830,11795,4,7,1710,1120,628000
3,1.5,1510,9898,3,7,1110,400,202500
2,0.75,700,16828,4,6,700,0,250000
4,2.5,2490,8290,3,9,2490,0,390000
3,1,1150,7486,3,7,1150,0,325000
3,1,1720,16552,4,7,1720,0,354900
3,4,3910,5350,5,10,2610,1300,1.70E+06
5,3.25,4860,23723,4,11,3820,1040,1.68E+06
5,3.25,2480,10277,5,8,1640,840,525000
6,2,2800,29985,5,7,1400,1400,405000
2,1,1080,6052,5,6,1080,0,140000
3,2.5,2520,5000,3,9,2520,0,540000
3,1.75,1330,7500,3,8,1330,0,787000
4,3.5,2890,5911,3,9,2370,520,855000
5,3,2970,7000,3,8,1810,1160,320000
3,2.25,1630,9145,3,7,1630,0,203000
4,2.5,1790,6590,3,7,1790,0,397000
3,1,820,5200,4,6,820,0,220000
3,1.75,1520,9600,4,7,1520,0,314950
3,2.25,1620,1062,3,8,1620,0,490000
3,1,1280,3900,4,7,1280,0,738000
4,3.25,1560,4080,3,7,1560,0,901000
5,2,2050,3000,3,7,1470,580,629000
3,1,960,5700,4,5,960,0,208950
3,2.25,1830,7500,4,7,1330,500,419995
2,1,740,3434,5,6,740,0,175000
2,1,990,9223,3,7,990,0,365000
3,3.25,2130,2306,5,7,1420,710,616000
3,1.5,1260,3135,3,8,1260,0,523000
3,2.5,2170,11745,4,7,1410,760,225000
2,1,920,2332,4,8,920,0,176000
4,1.5,1780,14810,4,8,1180,600,240000
3,2.25,1850,2575,3,9,1850,0,474950
3,1.75,1800,5816,5,7,900,900,719000
3,2.5,1730,4004,3,7,1730,0,348000
5,2.25,3030,9430,4,8,2600,430,529900
3,1.5,1270,1443,3,8,1270,0,440000
5,1,1950,6250,4,7,1450,500,438000
2,2.25,1610,1968,4,7,1610,0,278000
3,2,1550,34175,3,7,1550,0,320000
2,1,880,4558,3,7,880,0,415000
4,2.25,2260,8715,4,8,1530,730,675000
3,3.5,1710,2212,3,7,1400,310,362500
4,2.5,2610,5240,3,8,2610,0,337000
3,2.5,1920,15124,3,8,1920,0,429000
5,2.25,2520,49222,4,8,2520,0,535000
4,2.5,2190,9880,4,8,1410,780,630000
4,2.5,2340,6973,3,8,1930,410,544000
4,3.5,3620,6499,3,9,3620,0,825000
3,1.75,1760,235224,3,7,1760,0,568000
3,1,1440,8681,3,7,1440,0,523000
3,3.5,4490,56609,3,12,4490,0,3.12E+06
3,2.25,2340,6183,3,7,1210,1130,510000
3,1.75,1610,9000,4,7,1100,510,203000
5,1,2550,4623,4,9,2550,0,847000
3,2.5,2870,25663,3,10,2870,0,465000
4,3,2720,183823,3,8,2720,0,850000
3,1.75,1490,10344,3,7,1490,0,350000
3,2,1140,11620,3,7,1140,0,340000
3,1.75,1800,7210,3,7,1370,430,505000
2,2,2180,18525,5,9,1580,600,1.41E+06
3,1.5,760,40039,3,6,760,0,190000
3,3.25,1770,1977,3,8,1770,0,401000
3,1,1250,7210,4,7,1250,0,150000
2,1,720,9520,4,6,720,0,195000
4,2.5,2390,6111,3,8,2390,0,338500
4,1.75,1960,7950,4,8,1960,0,285500
3,1.75,1480,3900,4,7,1480,0,250000
3,2.5,1425,1179,3,8,1425,0,467000
6,2,1750,17685,4,5,1750,0,315000
4,3,3680,5854,3,10,2060,1620,980000
4,2.25,2010,19000,4,8,2010,0,322200
3,2,1870,5455,5,7,1060,810,521000
4,2.5,1910,7172,3,8,1910,0,498500
3,1,1010,8108,3,7,1010,0,200000
5,2.5,2732,9500,4,8,1870,862,480000
3,2.25,2210,7680,3,8,1730,480,500000
3,1.5,1370,9000,3,7,1370,0,225000
3,2.25,2050,6648,3,7,1230,820,535000
3,1.75,1740,8625,4,7,1240,500,280000
4,1.75,2210,19025,4,7,1460,750,950000
3,2,1451,7159,3,7,1451,0,300000
3,2,1340,3000,5,7,1340,0,549000
3,2.5,1900,5194,3,7,1900,0,343500
3,1,1040,5000,3,7,1040,0,600000
4,1,1130,8308,4,6,1130,0,293000
4,2.5,2510,3479,3,8,2510,0,685000
3,2.25,1270,1566,3,8,1060,210,625504
2,2,1340,5350,3,8,1340,0,592500
4,2,2040,5050,5,7,1160,880,705000
5,3.25,5210,35765,5,10,4940,270,2.20E+06
4,1.5,1850,6125,3,6,1110,740,399950
3,1,1600,5952,4,7,1150,450,329000
3,1.5,1810,29308,3,7,950,860,261000
2,1.75,1760,5000,4,7,940,820,605000
5,2,1900,5470,3,7,1180,720,667000
2,2,1440,15000,3,7,1440,0,365000
2,1.75,1894,52769,4,6,1520,374,280000
3,2.5,2430,5000,3,8,2430,0,372000
3,1,1370,4040,3,7,1370,0,530000
3,1.5,1090,9600,4,7,1090,0,200000
4,2.5,2420,5118,5,7,1550,870,598000
2,0.75,520,6862,4,4,520,0,330000
4,3.25,3190,11774,3,8,2610,580,1.10E+06
4,2.5,2000,37045,3,8,2000,0,260000
3,2,1010,7380,3,7,1010,0,385000
3,1.75,1650,11220,4,7,1650,0,361000
2,1.5,1400,9031,3,7,960,440,190000
3,1,1230,8750,3,6,1230,0,205000
3,2,1470,8089,3,7,1470,0,280000
3,2.25,1540,1005,3,8,1540,0,550000
2,1,1250,5040,3,7,950,300,505000
3,2.25,1830,8831,3,7,1460,370,431000
5,1.75,2250,13526,3,8,1350,900,688000
4,2.5,2190,17600,4,7,1110,1080,370000
4,2.25,2620,8100,4,7,1550,1070,360000
4,2.25,2400,7738,3,8,2400,0,278000
4,2.5,3130,40918,3,9,3130,0,598000
2,2.5,1414,1960,3,8,1414,0,428000
3,1.5,1220,4080,5,7,1220,0,670000
4,2.5,3290,7538,3,9,3290,0,750000
3,2,2110,18815,5,7,2110,0,1.15E+06
3,1.75,1720,9775,3,8,1720,0,169000
3,2.5,3080,7363,3,9,3080,0,490000
3,1.5,1180,11579,4,7,1180,0,249000
4,3.5,4490,5099,3,9,3390,1100,700000
4,2.5,1785,2552,3,8,1785,0,282000
3,2,1410,4800,3,7,1410,0,481450
3,1.75,1670,9900,4,8,1670,0,620000
4,1.75,2670,6250,4,8,2020,650,750000
4,2.5,2610,5866,3,8,2610,0,350000
4,1.75,2190,41000,3,8,2190,0,602500
3,2.5,2160,35912,3,8,2160,0,475000
3,1,1510,10369,4,7,1010,500,313000
3,2,1820,5000,4,8,1720,100,750000
3,2,1860,4777,5,7,1860,0,588000
2,2.25,2130,4920,4,7,1530,600,730000
4,2.5,2410,7140,3,8,2410,0,608000
4,2.75,2010,7000,5,8,2010,0,774000
6,4,5110,7128,4,11,5110,0,2.14E+06
5,2.25,2760,6350,3,7,1380,1380,600000
4,3,2190,12825,3,9,1520,670,625000
4,2,2600,9000,3,8,1410,1190,250000
3,1.75,1840,5101,5,7,1040,800,411715
2,1,900,7620,3,7,900,0,320000
5,1.75,1550,5225,4,7,1550,0,360000
3,1.5,1690,6010,3,7,1230,460,440000
2,2.25,1040,1377,3,8,1040,0,450000
5,3,3040,9601,5,9,1970,1070,830000
5,2.5,2300,28480,3,6,2300,0,475000
3,1,2030,4080,4,7,1840,190,775000
4,1.5,1250,8400,3,7,960,290,330000
3,3.5,3420,23786,3,9,3420,0,657044
3,2.5,2060,4030,3,7,2060,0,244615
2,1,900,8556,3,6,760,140,315000
4,2.5,1790,10584,4,7,1290,500,312000
4,2.5,2420,5006,3,8,2420,0,505000
4,2.25,1750,10270,4,8,1750,0,364000
3,2.5,2620,43832,3,8,2620,0,750000
5,1.75,2850,11860,3,9,2850,0,750000
3,2.25,1650,7313,3,7,1220,430,460000
3,2.5,1680,15711,3,7,1240,440,282000
3,2.5,1550,1092,3,8,1390,160,550000
4,2.5,2910,8596,3,8,2910,0,312200
3,2.5,3180,12600,4,11,3180,0,900000
3,1.75,1210,6175,3,7,1210,0,478000
4,1,1350,9000,4,7,1350,0,430000
5,2.75,2560,5618,3,8,2220,340,1.18E+06
3,2.5,3930,55867,4,8,2330,1600,3.07E+06
3,1.5,900,8690,5,6,900,0,465000
2,1.75,1820,6050,3,7,910,910,500007
2,1,670,4640,3,6,670,0,250000
4,1.5,1330,5750,3,7,1330,0,500000
2,1,730,6000,3,6,730,0,174950
4,2.5,2040,5000,5,7,1180,860,775000
4,1,1360,5500,3,7,1360,0,439500
4,3.25,3266,5398,3,8,3266,0,424950
3,2,1840,8140,4,7,1040,800,286500
6,2.75,3200,9200,4,8,1600,1600,497300
5,3.5,3750,9612,4,9,2030,1720,942500
3,1,1270,6250,3,7,910,360,499000
3,1,910,3880,3,7,780,130,465000
4,2.5,2320,4254,3,8,2320,0,423000
5,1.75,1790,9335,5,8,1790,0,695000
4,1,1230,8636,4,6,1230,0,195500
3,1.75,1750,7020,3,7,1750,0,510000
3,2.5,2850,19593,3,10,1790,1060,1.60E+06
2,1,1100,2800,3,7,1100,0,552700
3,1.75,1400,5750,3,6,1100,300,507250
5,1.75,2460,14100,3,7,1380,1080,485000
3,1,1160,4360,4,8,1160,0,501000
4,1.75,1740,8800,4,8,1740,0,560000
3,2.25,1420,13468,3,7,960,460,450000
3,1.75,1110,9012,4,7,1110,0,452000
3,2.5,2700,6947,3,9,2700,0,950000
4,2.5,2750,16139,3,9,2750,0,763776
5,3.5,3870,65556,3,10,3870,0,850000
3,3,3730,383328,4,9,2230,1500,649500
3,2.5,2242,5744,3,8,2242,0,310000
3,1.75,1530,7930,5,7,1530,0,269000
3,1,1010,7920,3,6,1010,0,216000
3,1.75,1830,9758,3,8,1300,530,429950
3,1.5,850,2500,3,7,850,0,295000
3,2.5,1410,1250,3,8,1140,270,530000
4,2.5,2440,7155,3,8,2440,0,388000
2,2,1360,1860,4,7,680,680,536500
3,1,1660,4400,3,8,1460,200,780000
4,2.5,2870,35757,4,9,2870,0,480000
3,1,960,9000,4,7,960,0,290000
1,0.75,760,5746,4,5,760,0,95000
2,2.5,1240,1249,3,8,1240,0,459000
2,1.75,1200,3136,3,7,800,400,420000
4,2,1950,3757,4,6,1160,790,370000
3,1,1020,5950,3,6,880,140,385000
3,2.5,2850,10474,4,8,1730,1120,1.15E+06
2,1,870,7975,3,7,870,0,475000
3,2.5,1650,5000,3,8,1650,0,216300
4,1.5,1890,43560,4,8,1890,0,320000
4,2.5,2770,7000,4,7,1940,830,355000
4,1.75,2020,7865,4,7,1010,1010,302000
4,1.5,1160,6400,4,7,1160,0,199000
3,1,1900,33888,4,5,1900,0,239950
3,2.25,1470,4322,3,7,1470,0,491500
3,2.25,1710,4140,3,8,1710,0,561000
5,5,4930,14649,3,11,4160,770,1.70E+06
4,1,1200,43560,3,5,1200,0,210000
3,1,1810,7200,4,7,1130,680,431000
3,1.75,1330,14560,3,7,1330,0,475000
3,1.75,1435,8960,4,8,1435,0,390000
3,2.5,2370,4324,3,8,2370,0,404000
5,2.5,2820,9375,4,8,1550,1270,527700
4,1.5,1660,6617,5,7,1660,0,399500
2,1.5,1230,1516,3,8,1230,0,324950
5,3,3300,33474,3,9,1870,1430,1.51E+06
4,2.25,1840,7575,4,7,1390,450,442500
4,3,2110,1286,3,9,1710,400,585000
4,2.5,2710,8127,3,8,2710,0,399900
4,1.75,1780,9794,3,7,1780,0,353000
3,2.25,2890,21480,3,8,1790,1100,1.07E+06
3,1.75,2040,12065,3,8,2040,0,379950
4,2.5,1840,1562,3,7,1400,440,275000
3,1.75,1280,3880,5,7,1280,0,520000
3,1,1230,9440,3,7,1230,0,278000
3,1.75,1480,7040,3,7,1480,0,510000
3,1.5,1280,4720,4,7,850,430,465000
4,2.25,1820,8255,4,7,1320,500,399888
5,3,2008,5050,3,7,1216,792,460000
4,2.5,2670,5974,3,8,2670,0,612000
3,1.75,2040,4000,5,7,1360,680,720000
6,2,2780,13950,4,7,2780,0,325000
6,2.75,3040,36721,4,9,1760,1280,799950
4,3,2390,4000,5,8,1460,930,845000
3,2.5,2940,10809,3,10,2940,0,850000
4,2.25,1960,12243,3,8,1960,0,308000
3,2,1370,8137,4,7,1370,0,276000
3,1.75,1430,53628,3,8,1430,0,520000
2,1,690,5280,4,5,690,0,139000
6,1.75,2380,4080,3,8,2380,0,725000
1,1,960,40946,5,5,960,0,420850
4,2.25,2200,6750,5,8,1480,720,376000
2,1.75,1400,4720,4,7,820,580,483000
3,2.5,3970,263538,3,9,3970,0,1.07E+06
2,3,1160,1073,3,7,880,280,405000
3,2.5,1852,4000,3,7,1852,0,298000
4,4.25,4480,5715,3,7,3680,800,490000
4,1.75,1260,3880,5,7,860,400,485000
4,2,1210,11100,4,7,1210,0,483300
3,1.75,1210,7350,3,7,1210,0,570000
3,1,1130,7920,3,7,1130,0,270000
3,1,1270,4000,3,7,1270,0,435000
3,2.5,2930,33981,3,9,2930,0,785000
2,2.5,2410,102366,4,7,1940,470,600000
4,1.75,1814,5000,4,7,944,870,530000
3,1,1270,7344,3,7,970,300,218250
2,1,1310,6600,3,6,1310,0,280000
3,2.25,2120,18255,3,8,1590,530,550000
3,1,1100,8680,3,6,1100,0,184000
3,1,1070,4600,3,7,950,120,500000
4,2.5,3010,46173,3,9,3010,0,700000
3,1.75,1290,10117,3,7,1290,0,370000
4,2.25,2350,10072,3,8,2350,0,495000
3,2.5,1500,4445,3,8,1500,0,457500
4,2.5,2640,4725,3,8,2640,0,389517
3,1.5,1430,8861,3,7,1430,0,280000
3,2.5,2480,5137,3,9,2480,0,717000
4,2.5,2640,11816,3,8,2640,0,570000
4,2,2100,8880,4,7,2100,0,548000
3,2.5,1250,864,3,8,1250,0,353000
4,3.5,4370,422967,4,10,2580,1790,858000
2,3.5,2560,5000,4,6,1280,1280,535000
2,1,810,7440,5,6,810,0,408000
5,2,1460,169448,3,6,1460,0,306000
2,1,700,8120,3,7,700,0,400000
4,2.75,2280,3200,5,8,1520,760,675000
3,3.75,2780,5002,3,10,2780,0,815000
3,2.5,2040,2500,3,7,1470,570,494900
3,1.75,1690,1468,3,8,1380,310,380000
4,2.5,2280,8798,4,8,2280,0,520000
4,2.5,1700,4268,3,7,1700,0,245000
3,1.75,1120,7740,4,6,860,260,355000
3,2,2220,10275,3,9,1640,580,490000
4,3.25,2840,4000,3,9,2330,510,535000
3,2,1760,9282,5,7,1100,660,215000
4,2.5,2811,7251,3,9,2811,0,455000
4,2.5,2800,10786,3,8,1420,1380,605000
3,2,1330,8748,3,7,1330,0,205500
3,2.5,2060,4812,3,8,2060,0,533000
5,3,2970,6500,3,9,2970,0,680000
2,2,1370,4866,3,8,1370,0,431500
3,2.5,2970,11985,3,9,1770,1200,745000
4,4,5050,202554,3,10,3260,1790,1.34E+06
5,3.5,2730,42500,3,8,1530,1200,542500
4,2,2050,8750,3,7,1300,750,300000
3,3.25,1550,1280,3,9,1220,330,570000
3,2.5,1780,7214,4,7,1400,380,266000
3,2.5,2610,35000,3,10,2610,0,665000
3,2,1960,8846,4,6,980,980,360000
3,2.5,2560,5238,3,8,2560,0,577000
4,2,1960,16015,3,7,1960,0,367500
3,1,1740,10875,4,7,1020,720,267000
3,2.5,2400,81892,3,8,2400,0,592000
3,1.75,1700,11613,5,7,1180,520,263950
3,2.5,1680,2096,3,8,1380,300,518000
0,1.5,1430,1650,3,7,1430,0,288000
2,1,1400,19570,3,6,1100,300,250000
3,1,1280,6726,3,6,1280,0,299500
4,1.75,1320,7694,3,7,1320,0,195000
3,1.75,1100,10005,5,7,1100,0,423000
4,2.5,2670,13463,4,9,2670,0,690000
4,2.5,2380,7066,4,7,2380,0,357000
3,2,1460,7930,3,7,1460,0,258500
4,3.5,3630,5670,3,10,3630,0,698000
2,1,900,8580,3,5,900,0,83000
4,2.25,1790,42000,3,7,1170,620,494000
5,2.5,3220,5806,3,8,3220,0,355000
3,2.25,1850,12000,4,7,1300,550,469500
4,2.75,3470,212639,3,7,2070,1400,598600
4,2.5,3040,7200,3,9,3040,0,700000
2,1.5,1800,4144,4,7,900,900,850000
1,1.5,760,779,3,8,760,0,344000
6,3,4050,36171,4,8,2620,1430,670000
5,2.75,3460,7977,3,9,3460,0,858450
3,1,1030,9120,3,7,1030,0,223000
4,2.5,2970,34981,3,9,2970,0,640000
4,2.5,2440,9350,4,8,1560,880,610000
2,2.25,1260,1312,3,8,1260,0,530000
3,2.25,2730,7521,3,9,2730,0,632000
3,1.75,1420,6980,5,7,820,600,205000
4,2.25,2360,2500,3,8,1520,840,695000
4,1.75,2770,8521,4,7,1470,1300,760000
2,1,810,4560,3,7,810,0,260600
2,2.5,1090,13444,3,7,1090,0,204000
4,2.75,3100,10245,3,10,3100,0,792000
3,1.75,2480,10804,3,8,1800,680,489950
3,2.25,1440,15661,3,8,1180,260,500000
2,0.75,900,9600,3,6,900,0,180250
4,2.5,2500,36254,4,8,1590,910,450000
3,1.75,1840,7412,4,7,1240,600,269500
3,1.75,1760,10349,3,8,1760,0,575000
4,2.5,2530,8169,3,8,2530,0,336000
3,1,1010,8848,4,7,1010,0,229900
3,2.75,3130,19530,3,8,1690,1440,1.40E+06
3,1.5,1740,4200,4,7,1640,100,555000
4,2.5,2311,4396,3,9,2311,0,399440
1,1,920,8282,3,6,920,0,310000
3,1.5,1360,9625,3,7,1360,0,244000
2,2.25,1240,750,3,7,1150,90,334950
4,2.5,2030,7140,4,7,1400,630,556300
3,1,1070,22489,3,7,1070,0,195000
3,3,2610,22672,4,8,2610,0,1.58E+06
3,3.25,1651,1779,3,8,1341,310,363000
4,2.5,2820,25995,3,9,2820,0,545000
3,1.75,1320,6205,5,7,1320,0,313000
5,2.25,2630,8625,3,8,2630,0,320000
2,1,950,6426,3,7,950,0,430000
3,2.25,1960,1985,3,7,1750,210,365000
1,1,660,2600,3,6,660,0,250000
2,1,920,8341,3,7,920,0,319950
3,1.75,1720,5000,3,9,1720,0,770000
4,3,3050,6179,4,9,2330,720,1.48E+06
3,2.25,1430,1448,3,8,1430,0,407000
4,2.5,1940,10500,4,7,1140,800,550000
4,2.25,3490,6906,4,10,2280,1210,1.23E+06
3,1.75,1720,8102,5,6,860,860,420000
2,2.5,2320,9311,3,8,2320,0,694000
3,2.5,2500,21780,3,8,1770,730,390000
3,1.75,1400,7405,3,7,1400,0,334000
6,2.25,3830,11180,5,9,2440,1390,887000
3,2.25,2190,220414,4,7,1330,860,530000
3,2,1910,13505,3,8,1910,0,412450
3,1.75,2960,12420,4,8,1480,1480,936000
3,1,1400,6600,3,6,1280,120,214950
1,1,780,1033,3,7,780,0,250000
4,3.5,3828,18900,3,9,3828,0,552900
5,1.75,2280,43560,4,8,1380,900,571000
3,1,1150,9048,2,7,1150,0,305000
2,1,1020,7920,3,6,1020,0,235000
3,1,1200,7000,1,7,1200,0,130000
3,1,1250,10744,3,6,1250,0,275000
3,2.5,2330,33750,3,9,2330,0,585000
3,2,1660,8281,3,7,1660,0,380000
3,2.25,1500,2692,3,7,1500,0,400000
3,2.75,1650,7272,4,7,1230,420,429500
4,1.75,1530,3615,4,7,1530,0,675000
4,3.5,4210,9414,3,9,4210,0,884744
3,2.5,1740,1844,3,8,1320,420,330000
2,1,1410,4500,3,7,1020,390,600000
3,1,860,6635,3,6,860,0,215000
3,2.25,1260,1488,3,7,1260,0,275000
3,1.75,1460,9261,3,7,1460,0,330000
3,2.5,2890,8470,3,10,2890,0,775000
4,2.75,2330,7200,4,8,1560,770,299900
4,1.75,2490,7834,4,8,1240,1250,949000
3,1.75,1820,3140,5,8,1820,0,582000
5,4,2710,2800,3,10,2380,330,1.20E+06
2,1.75,2320,5500,3,8,1720,600,700000
4,2.5,3380,75794,3,10,3380,0,639900
3,2.5,1580,3825,3,8,1580,0,375000
3,2,2060,4437,3,7,1030,1030,460000
4,2.75,2710,41811,4,8,1690,1020,710000
4,2.25,1950,7280,4,8,1950,0,220000
3,1,1060,7350,4,7,1060,0,182000
3,2.5,2280,2296,3,9,1890,390,950000
3,2.5,2600,4724,3,7,2600,0,444500
3,1,1180,7200,4,7,1180,0,249500
2,1,700,3180,3,6,480,220,119900
5,2.5,2406,7093,3,8,2406,0,270500
3,2.5,2080,4828,3,8,2080,0,290000
5,2.5,2450,5047,3,8,2450,0,555000
2,1,620,2475,5,6,620,0,402000
3,1,1030,9916,4,7,1030,0,299950
3,1.75,2200,7700,3,7,1240,960,216600
5,1.5,2540,6660,4,8,2340,200,1.12E+06
4,3.75,4490,7623,4,10,3090,1400,1.72E+06
3,2.5,2410,46609,3,9,2410,0,715000
3,1,1250,26862,3,7,1250,0,287000
3,2.5,2190,11394,3,8,1550,640,1.29E+06
5,3.25,3340,4900,3,9,2500,840,637850
4,3.25,2360,8344,3,8,2360,0,319000
3,2.5,2690,4819,3,7,2690,0,555000
4,2,1820,7102,3,7,1220,600,385000
3,2,1220,17652,4,7,1220,0,240000
4,2.75,2790,8853,3,8,2790,0,533112
4,3.5,3500,43560,3,9,2850,650,998000
6,4.5,5480,10800,4,9,4430,1050,2.40E+06
3,3.25,1380,1234,3,8,1380,0,379000
4,2.5,2950,9010,3,9,2950,0,610000
3,2,1140,6000,3,7,1140,0,660000
2,1,940,5413,3,7,940,0,340500
3,2.25,1870,7200,3,7,1390,480,350500
2,1.75,1700,18000,3,8,1700,0,290000
3,1,910,5212,3,7,910,0,565000
2,1.75,970,4233,4,7,970,0,560000
3,1.5,1360,8910,5,7,1360,0,245000
3,2.25,1470,4653,4,7,1470,0,455000
3,2.5,1650,4725,3,8,1650,0,299000
2,1,1700,6718,3,7,1230,470,340000
5,2.75,3330,12408,3,10,1740,1590,750000
3,1.75,2070,37904,4,7,1420,650,310000
3,1.75,1720,9125,4,7,1140,580,230000
3,1,1240,3600,3,7,1240,0,390000
5,1.75,3240,34510,4,7,2690,550,605000
3,1.75,1240,10361,3,6,1240,0,192000
5,4,4590,35046,3,10,4590,0,1.72E+06
2,2.5,1785,779,3,7,1595,190,530000
4,1,1610,6000,4,7,1510,100,426250
3,2,1410,6600,4,7,1410,0,279900
3,2.5,2040,7605,3,8,2040,0,440000
4,2.5,2510,12000,3,8,1520,990,305000
3,2.75,2820,5348,3,9,2820,0,749000
4,2.5,2890,6322,3,8,2890,0,416000
2,1,1650,5106,3,7,1090,560,435000
4,2.5,2310,14023,3,9,2310,0,470000
3,2.5,1970,6634,3,8,1970,0,535000
3,2.25,2060,38377,4,8,1560,500,306500
3,2.5,4190,9624,3,10,4190,0,1.15E+06
4,2.5,2340,3784,3,8,2340,0,445000
5,1.75,2020,7902,3,7,1220,800,245000
4,2.5,2390,4639,3,8,2390,0,278226
6,1.75,2400,7500,3,7,1400,1000,499000
4,2.5,2910,35679,4,9,2910,0,817500
4,2.5,1940,6206,3,7,1940,0,278500
5,3.25,3830,6507,3,9,3830,0,955990
3,2.5,1650,2807,3,7,1650,0,238000
3,2.5,3560,11448,3,11,3560,0,843500
5,3,2240,19090,4,8,1700,540,335500
4,1.5,2210,10497,4,8,1650,560,445500
3,1.5,1260,7964,4,7,1260,0,245000
4,2.5,3730,16950,3,10,3730,0,1.26E+06
4,1.75,1520,10630,4,7,1520,0,425500
3,1.75,1880,11700,4,7,1880,0,299500
4,2.25,2200,8384,3,7,1250,950,425000
3,2,1560,7000,4,7,1560,0,226500
3,2.5,2200,34680,3,9,2200,0,424000
2,1.5,1400,11245,5,7,1400,0,421000
5,2.5,2990,7292,4,8,2990,0,339950
4,3.25,4140,46173,3,9,4140,0,810000
3,2.75,2850,14800,4,9,1920,930,775000
7,3.75,2310,5000,3,8,2310,0,727160
2,2,1110,1155,3,7,980,130,399000
4,1.75,1430,10500,4,7,1130,300,412000
3,1.75,1490,8366,4,7,1010,480,234000
3,1.75,1980,12543,3,8,1180,800,268000
3,1.75,1250,3880,4,7,750,500,443725
3,1,1120,10665,4,6,1120,0,225000
3,1,1150,6908,3,6,800,350,329999
2,2.5,1430,923,3,8,1410,20,485000
2,2,1150,6634,3,7,860,290,445000
4,2.25,2460,11250,4,8,2460,0,276000
4,1,2500,35802,3,7,2500,0,850000
4,2.5,1840,4011,3,9,1840,0,583000
3,1.5,1500,14750,4,6,1500,0,300000
3,1.75,2710,9088,4,7,2060,650,278000
4,2.5,2600,6015,3,8,2600,0,641000
3,3,2060,1850,3,8,1400,660,497000
3,1.75,2110,56192,3,7,1480,630,615000
3,1.75,1770,8235,3,7,1030,740,295000
4,4.25,4700,10800,3,11,3910,790,2.23E+06
4,3,1550,3350,3,7,860,690,623500
3,2.5,2120,4500,3,7,2120,0,437500
3,2.5,2630,4611,3,8,2630,0,497000
3,1.75,1580,11750,4,7,1180,400,575000
3,2.5,2170,8169,3,8,2170,0,442250
3,2.5,2510,9240,4,8,2510,0,353000
3,2.25,1358,1196,3,7,1358,0,311600
4,2.5,2150,7670,5,7,1240,910,344900
3,1.75,1320,1014,3,9,1320,0,455000
3,1.75,1750,9623,3,7,1150,600,279000
3,1.5,1240,8738,3,7,1240,0,475000
5,3,3520,36558,4,8,2100,1420,632000
3,2,1830,6925,4,8,1830,0,323000
3,2.5,2790,53143,4,9,2790,0,815000
4,3,2430,7163,3,8,2430,0,409950
2,1,990,3120,5,7,790,200,437500
2,2.25,1330,10838,3,8,1330,0,355000
3,1.75,2380,10450,3,8,1400,980,565000
4,2,2280,39848,4,8,2280,0,416500
3,2.25,1650,946,3,8,1650,0,619000
4,2.5,3050,8000,3,9,3050,0,740000
3,2.25,2080,9740,3,8,2080,0,324900
3,1.75,1750,16748,3,7,1330,420,435000
1,1,900,6380,3,6,900,0,395000
4,1,2550,4000,3,8,2370,180,890000
3,1.5,1450,7375,3,7,1010,440,402000
3,2.5,3200,18750,2,9,2660,540,580000
3,2,3000,21883,3,7,1970,1030,490500
3,1,1690,6658,3,7,1690,0,400000
3,3.25,1570,2048,3,8,1290,280,346500
4,2.5,2840,4750,3,9,2840,0,525000
2,1.75,1440,6265,3,8,1440,0,490000
3,2.5,2930,9280,4,10,2930,0,905000
5,2.5,2740,5400,3,8,2740,0,378800
3,1,1140,5258,3,6,1140,0,329000
1,1,650,15364,4,5,650,0,129000
3,2.25,2100,40510,3,10,1320,780,525000
3,1.75,1510,7700,3,7,1510,0,441500
3,1,990,9599,4,6,990,0,245000
4,2.5,2650,30500,4,8,1680,970,715000
3,1.5,1310,10491,4,7,1310,0,225000
5,4.5,4030,13474,3,11,4030,0,989000
5,3,3910,16200,4,9,2890,1020,1.56E+06
4,2.5,3370,7200,3,8,3370,0,890000
4,3.5,3310,4684,3,9,2290,1020,999950
2,1.75,1640,6750,4,8,1340,300,640500
1,1,580,7200,3,6,580,0,315000
3,1.75,1260,6500,4,7,1260,0,390000
4,2.5,1890,5954,3,7,1890,0,298500
3,1.75,950,6000,3,6,790,160,230000
3,1,1520,8450,2,6,1120,400,135000
4,2.5,3190,7941,3,10,3190,0,589450
3,2.25,2100,20018,3,8,1470,630,540000
3,1.5,1360,10726,4,7,1360,0,370000
3,2.25,1860,13939,4,7,1860,0,291000
3,1.75,1300,3844,3,7,1300,0,369000
4,2.25,2060,11385,4,7,1200,860,264500
5,2.5,2670,184140,3,8,1410,1260,410000
4,2.5,3520,6773,3,9,2650,870,870000
3,1,1550,4160,4,6,1550,0,425000
3,2.25,1880,7279,3,7,1280,600,466000
3,1,1220,8329,3,6,1220,0,387500
4,4.25,4420,5750,3,10,3410,1010,890000
3,2.5,2670,5000,5,9,2000,670,1.17E+06
5,1.75,1960,3748,3,7,980,980,415000
4,2.5,3200,7545,3,7,3200,0,399950
2,1,1510,3360,3,7,880,630,525000
3,2.5,1390,2450,3,7,1390,0,208800
3,2.5,1970,4120,3,6,1230,740,291700
3,2.5,2190,5091,3,8,2190,0,365000
2,1.5,1510,2001,4,8,1510,0,445000
3,1,970,4800,3,6,970,0,600000
3,1.5,1820,12686,4,7,1820,0,875000
4,2.25,2440,5000,3,7,2440,0,499000
2,2,1120,780,3,8,760,360,380000
4,2,1830,5220,3,7,1830,0,270000
4,2.75,3140,9085,5,8,1570,1570,920000
3,1,1330,8912,3,6,1330,0,234999
4,3.25,4030,36762,3,11,4030,0,985000
1,1,870,26326,3,6,870,0,157000
4,2.5,3240,22795,3,8,3240,0,574000
4,2,2240,10296,5,8,2240,0,1.35E+06
4,2,2510,13695,4,7,1280,1230,581000
3,2,1380,3600,3,8,1380,0,350000
3,2.5,1960,47044,4,8,1960,0,535000
5,2.5,2340,4500,3,7,2340,0,429000
3,2.5,1670,2589,3,8,1670,0,450000
3,1,1620,10610,4,6,1620,0,345000
3,1.75,1500,19113,3,7,1500,0,418000
3,2.75,1620,7500,5,7,1140,480,560000
4,2,1620,4600,3,7,1620,0,375000
4,1.75,1690,7680,5,6,890,800,400375
3,2,2740,101930,3,9,2740,0,850000
4,2.5,2580,11780,3,9,2580,0,456500
3,1.75,2340,5500,3,9,2340,0,982218
4,1.75,1610,9652,5,7,1610,0,215000
3,2.5,2250,7752,4,8,2250,0,550000
4,2.5,2110,13939,3,8,1270,840,607500
3,3.5,3380,108900,3,9,2700,680,554000
3,1.75,1640,13500,3,7,1110,530,450000
3,2.25,1820,19602,4,7,1820,0,277500
4,2.5,2700,25870,4,8,2700,0,725000
4,1.75,1720,9600,4,8,1720,0,380000
3,2.5,1650,1793,3,8,1650,0,370000
3,2,1410,11995,4,8,1410,0,510000
4,2.5,2890,9775,3,8,2890,0,575000
2,1,710,1131,4,7,710,0,399950
4,2.5,2690,32780,3,9,2690,0,620000
5,3,3830,8480,5,9,2630,1200,2.05E+06
3,1.75,2040,8173,3,7,1470,570,355000
4,3.25,4130,11444,3,11,4130,0,1.14E+06
3,2.5,2160,8809,3,9,1540,620,730000
2,2.25,1950,29347,3,8,1350,600,438000
4,2.75,2290,5249,3,7,2290,0,430000
4,2.5,1840,7800,3,8,1240,600,510000
2,1.75,1550,6000,3,7,1550,0,805000
4,2.5,1940,6887,3,7,1940,0,278000
3,2.5,2430,12997,3,9,2430,0,650000
4,3.25,3420,5012,3,10,2330,1090,548000
3,1.5,1340,6000,3,9,1340,0,907000
3,2.75,2930,218235,3,8,2930,0,710000
3,2,1190,4072,5,6,1190,0,245000
3,2.5,2610,7510,3,9,2610,0,725000
3,1.75,1710,5913,4,8,1120,590,675000
3,1.75,2660,5511,3,8,1330,1330,467000
4,2.5,2820,10125,3,8,2820,0,685000
3,2.5,2653,4510,3,8,2653,0,365000
4,2.25,2290,10409,3,8,2290,0,745000
2,1,1840,81892,3,6,1840,0,375000
4,2.5,3070,4000,4,8,2070,1000,1.30E+06
3,1,1520,8055,3,7,1520,0,279000
4,2.5,2900,23488,3,9,2900,0,690000
5,2.5,2090,8712,3,8,1420,670,555000
3,1.5,1060,6232,4,7,1060,0,360000
4,3.5,3420,33106,3,9,3420,0,655000
3,2.5,3310,4682,3,9,2380,930,572800
3,2,1450,9044,3,7,1450,0,222500
3,2.5,2610,5845,3,8,2610,0,515000
4,2.5,2370,7274,3,7,2370,0,351000
2,1.75,1500,6800,4,7,910,590,437000
4,1.75,2460,5100,5,7,1450,1010,735000
2,2,1350,2560,3,8,1350,0,335000
4,2.5,2640,5595,3,8,2640,0,387990
3,1.75,1350,8548,3,7,1350,0,250000
3,1.5,1200,2002,3,8,1200,0,140000
2,1.5,1480,7276,4,6,940,540,269500
4,2.5,2730,4800,5,8,2230,500,980000
4,2.75,2760,7533,3,8,1400,1360,369950
4,2.5,2120,9163,4,8,1450,670,550000
4,3.5,2630,3435,3,7,1640,990,325000
4,2.25,2610,7700,3,8,1700,910,580000
4,1,1060,5750,3,6,950,110,403504
2,1,1140,5720,3,7,850,290,455000
5,3.75,4470,8088,3,11,4470,0,1.54E+06
2,1,880,3300,4,7,880,0,460000
2,1,840,8100,4,7,840,0,401000
3,2.5,2030,8398,4,9,2030,0,700000
3,1.75,2070,96703,4,7,2070,0,449950
3,1,1150,2496,3,6,1010,140,339000
4,2.75,2530,7350,5,8,1280,1250,354950
4,1.75,2380,15324,3,8,1610,770,420000
3,1,1440,10330,4,7,1440,0,805500
3,3.5,2380,6250,3,8,1670,710,495000
4,2.5,2410,4708,3,8,2410,0,299800
3,1,990,6315,3,7,990,0,335000
5,2.75,3831,13800,3,9,3831,0,2.70E+06
4,2.5,2290,13416,4,9,2290,0,785000
3,2,1620,12482,4,7,1290,330,276750
3,1.75,1460,4000,4,7,730,730,527200
2,1,930,7550,3,6,930,0,230000
4,4.5,4920,270236,3,10,3820,1100,1.04E+06
3,2.5,2460,38794,3,9,2460,0,630000
2,2,1270,5000,3,6,1270,0,600000
4,2,1960,50112,4,7,1050,910,435000
4,2.5,2190,3855,3,8,2190,0,540000
3,1,1320,3954,3,6,1320,0,209000
3,1,1040,6535,3,6,1040,0,225000
3,1,1310,7000,4,7,1310,0,447000
4,2.5,3450,33460,3,9,3450,0,805000
4,2.5,2910,48351,4,8,1910,1000,925000
3,2.5,1800,5001,3,7,1800,0,515000
3,3,1910,4800,3,9,1910,0,850000
2,1,840,3844,4,6,840,0,290000
2,1.5,1480,1349,3,7,1240,240,418000
4,2.5,2242,37451,3,8,2242,0,490000
4,2.75,2560,6900,3,8,1480,1080,740000
2,1,970,8874,3,7,970,0,210000
2,1.5,1150,3927,3,7,1150,0,300000
3,2.5,2910,17172,3,10,2910,0,450000
4,2.75,1960,48787,4,9,1960,0,565000
4,1.75,3010,12523,3,8,1780,1230,401000
3,2.5,1430,1002,3,8,1430,0,349000
5,3,2680,8410,3,8,1810,870,375000
3,3,2630,4972,3,9,2630,0,731781
3,1,1530,389126,4,7,1530,0,230000
2,1,1010,4050,3,7,1010,0,375000
4,1.75,2220,15600,5,7,1140,1080,374000
5,3.25,2800,3200,5,10,1910,890,1.31E+06
3,2.5,1610,1728,3,8,1610,0,499000
3,1.75,2040,42693,3,10,2040,0,1.32E+06
3,2.25,1610,7187,3,7,1610,0,269950
4,2.5,1700,6031,3,8,1700,0,225000
4,2,3390,16025,4,10,3390,0,835000
3,2.25,1360,9600,3,7,1360,0,280000
3,1.75,1300,12731,3,8,1300,0,430000
4,3,3280,62726,3,7,3280,0,458000
4,2.5,3305,16164,5,7,2245,1060,492000
4,1.75,2060,26036,4,8,1160,900,647500
2,2.25,3900,14864,3,8,1950,1950,1.07E+06
3,2.25,1740,10836,3,7,910,830,252000
3,1,910,11117,3,7,910,0,128000
2,1.75,2060,2700,3,7,1030,1030,485000
4,2.25,3250,34293,4,9,3250,0,480000
3,1,1060,9663,3,7,1060,0,326250
4,3,4120,14021,3,11,4120,0,1.30E+06
4,2.5,3470,6651,3,9,3470,0,672500
5,2.25,3320,13138,4,9,1900,1420,769000
2,2,1340,7605,3,7,1340,0,230000
5,1.5,1550,9750,4,7,1550,0,510000
3,1,970,7275,4,7,970,0,215000
3,2.5,1780,4650,3,7,1780,0,299950
3,2.5,3020,4120,3,9,2360,660,775000
4,2.5,2520,13156,3,8,1520,1000,565000
3,2.5,3110,9930,3,8,1640,1470,1.26E+06
4,2.5,2570,7859,3,8,2570,0,397500
5,3.5,3760,4857,3,9,2820,940,730000
4,2.5,2650,6000,3,9,2650,0,428400
3,1,890,9870,4,7,890,0,358000
3,2.5,1770,2677,3,7,1770,0,260000
3,2.5,1920,5322,3,8,1920,0,324000
3,1,1480,7469,3,6,1120,360,260000
3,2,1160,6120,3,7,1160,0,506000
3,2.5,2860,4442,3,8,2860,0,799000
4,1.75,1880,8800,3,7,1130,750,284000
4,2.5,2430,8509,3,9,2430,0,658100
4,2.5,3320,38043,3,9,3320,0,685000
2,1,710,4000,3,6,710,0,362362
3,1.5,1260,9570,3,7,870,390,414900
5,2.75,3360,12080,3,9,3360,0,769995
3,2,1610,4364,3,8,1610,0,450000
4,2,2120,7806,4,6,1770,350,500000
3,1.75,1860,5750,5,6,1300,560,400000
2,1.5,1390,5000,4,8,970,420,530000
4,4.5,3180,4606,4,9,1990,1190,1.05E+06
4,2,2090,10800,4,7,2090,0,659000
3,1.75,1300,20700,3,7,1300,0,369500
3,2,1360,3120,3,7,1360,0,396900
3,1,1030,6127,3,7,880,150,252500
3,1,930,5160,5,6,930,0,300000
3,2.5,1920,4480,3,9,1920,0,1.01E+06
6,8,12050,27600,4,13,8570,3480,7.70E+06
3,3,3700,10375,3,9,3700,0,489000
3,1,990,9145,4,6,990,0,246000
6,3.5,3720,11690,3,10,3720,0,1.52E+06
3,4.25,3840,9751,3,10,3840,0,858450
3,3,1530,1568,3,8,1530,0,474950
4,3,1630,7626,5,7,1110,520,482500
4,1.75,2460,10061,3,7,1410,1050,790000
4,5,5310,16909,3,12,3090,2220,2.48E+06
4,2,1710,5440,5,8,1030,680,280000
3,1.5,1510,16200,3,7,1510,0,275000
2,1.5,1070,9643,3,7,1070,0,252700
6,3,2180,7956,3,7,2180,0,235000
4,1.75,2460,5750,5,7,1620,840,675000
1,1,720,3166,3,6,720,0,375000
4,2.25,2200,9351,5,7,1290,910,423000
3,2.25,1381,1180,3,8,1381,0,360000
4,2.25,1630,7969,3,7,1100,530,412500
2,2,1540,7290,3,7,1540,0,462500
4,2.25,2340,13383,3,8,1170,1170,465000
3,1,1390,9624,4,7,1390,0,299000
4,1,2200,12137,4,8,1640,560,680000
4,2.75,3080,6731,3,9,3080,0,550000
2,1,730,9975,1,5,730,0,81000
3,2,2120,7560,3,9,2120,0,386000
4,1.75,3060,94089,3,8,3060,0,455000
3,1,1110,8593,3,7,1110,0,299900
4,2.5,2900,6736,3,8,2900,0,527000
3,2.5,1470,9337,3,7,1470,0,244000
3,1.75,1700,6120,3,7,1700,0,500000
4,3.25,4270,6384,3,9,3060,1210,770000
4,3,3400,292723,3,10,3400,0,688000
3,1.75,1520,7875,5,8,1520,0,525000
4,2.5,2380,7850,3,8,2380,0,340000
4,2.5,3000,9793,3,7,3000,0,394000
3,1.75,1550,6225,4,7,1550,0,199950
4,3,3900,9750,5,10,2520,1380,1.62E+06
4,2.5,3130,10849,3,10,3130,0,999000
2,1.75,1530,3503,4,7,830,700,525000
3,2.5,2340,4200,3,7,1540,800,550000
2,1,890,6095,3,7,890,0,510000
3,2.5,2380,5017,3,9,2380,0,652100
4,1.75,1730,5922,5,7,1730,0,446000
2,1,720,4920,3,6,720,0,314000
2,1,1120,6236,4,6,1120,0,325000
3,1.5,1150,11475,3,7,1150,0,287000
5,2.75,2870,5349,3,9,2870,0,690700
2,1,1170,6000,4,7,970,200,455000
4,2,2120,4000,4,7,1720,400,597000
3,1,1340,5175,3,7,940,400,320000
3,2.25,1570,1680,3,8,1570,0,660000
4,2.5,2060,16000,3,6,2060,0,286000
2,1,1190,5200,5,7,1190,0,470000
4,2.5,2810,11560,5,7,1740,1070,674000
4,2.75,2240,8937,4,8,1460,780,675000
2,1,940,6350,4,5,940,0,283000
3,1.75,1280,10716,4,7,1280,0,290000
3,3.25,1340,5434,3,7,1340,0,176000
2,1.75,1570,1108,3,9,1570,0,720000
5,2.25,2980,7781,3,9,1580,1400,600000
2,1,930,7740,3,6,930,0,290000
3,2.25,1490,7589,3,7,1490,0,259500
5,4,2900,9779,4,7,1950,950,312000
3,2.5,2260,251460,3,10,2260,0,777700
5,2.75,2860,6000,4,8,2380,480,750000
3,1.75,1280,12776,4,7,1280,0,300000
3,2.25,2230,11835,5,8,1630,600,652450
4,2.75,3010,7200,3,9,3010,0,839950
4,3.5,4560,41636,3,9,4170,390,1.10E+06
2,1,1220,4000,4,6,1220,0,470000
4,3.75,4030,10800,3,10,4030,0,1.49E+06
3,1.75,1630,11800,4,7,1630,0,280000
3,2.5,1320,1683,3,8,1270,50,369000
4,1.75,2370,10140,3,7,1460,910,305000
4,1.75,2320,4800,3,7,2170,150,555000
3,2.5,1960,9686,3,8,1460,500,560000
4,2.5,2980,10194,3,9,2980,0,728935
5,3.75,4210,14599,3,10,4210,0,937500
3,1.75,1560,8456,5,7,1560,0,400000
2,1,890,4804,4,7,890,0,220000
4,2.75,3020,7203,3,9,3020,0,879950
4,2.75,3300,12090,3,8,3300,0,927000
6,2.75,2980,20000,3,8,2130,850,1.06E+06
4,2.5,2780,6737,3,9,2780,0,739000
4,2.5,2720,7697,4,8,2120,600,348000
4,3,1810,5012,4,7,1810,0,400000
4,2.75,3130,8920,3,8,3130,0,690500
2,1,770,7906,4,6,770,0,260000
4,1.75,1570,18730,3,7,1200,370,239900
3,2,1190,6833,3,7,1190,0,200000
3,2,1440,5469,3,8,1440,0,350000
3,1,1380,10112,4,7,940,440,230000
3,2.25,3230,35306,3,9,3230,0,370000
3,1.75,1900,3783,5,7,1110,790,615000
3,1.5,1430,7347,3,7,820,610,198000
4,2.5,3140,22100,4,8,1820,1320,310000
4,1.75,2500,8725,4,8,1500,1000,965800
4,1,1360,6000,4,6,1020,340,273500
3,1,1270,8925,5,7,1270,0,317000
2,1.5,1260,5100,3,7,1260,0,455000
3,2.5,2070,13241,5,9,1270,800,850830
4,3.5,3780,7769,3,9,3110,670,782000
4,2.25,2660,22194,4,8,2180,480,625000
3,2.5,1800,3168,3,8,1800,0,409316
3,2.75,3080,7282,3,9,3080,0,585000
4,2.5,2970,5722,3,9,2970,0,715000
3,3.75,3830,219106,3,9,3830,0,865000
2,2,1390,12530,3,8,970,420,431000
3,1.75,1370,8280,4,7,1370,0,222000
4,2,2970,5400,4,9,2970,0,1.26E+06
5,3.75,5330,6000,3,10,3570,1760,950000
4,2,2200,13320,3,6,1100,1100,205000
2,1.5,2060,10880,3,6,1190,870,348140
3,1,1140,8528,5,7,1140,0,255000
4,2.5,2980,8107,3,9,2980,0,622500
3,2,1100,9165,4,7,1100,0,397000
3,2.5,2600,5540,3,8,2600,0,355500
4,4,4168,8485,3,10,3222,946,442000
3,2.5,1890,5929,3,8,1890,0,510000
3,2.25,1790,7125,3,7,1220,570,392000
4,2.5,3170,9900,4,8,3170,0,777000
2,1.75,1760,2275,3,6,1040,720,450000
4,2.5,2019,4435,3,8,2019,0,293000
5,2.5,2550,6405,3,7,2550,0,465000
2,1.75,1270,1685,3,8,1270,0,335000
4,3.25,7420,167869,3,12,7420,0,1.95E+06
4,2.5,2350,9779,3,10,2350,0,692000
4,2.5,4080,11054,3,11,4080,0,1.05E+06
3,1,1010,25000,3,6,1010,0,150000
3,2.5,2730,7136,3,8,2730,0,510000
3,2.5,1780,11000,4,8,1210,570,635000
4,2.5,2506,6232,3,7,2506,0,365070
2,1.5,1170,1250,3,8,1170,0,475000
2,1,1280,6000,3,7,1280,0,650000
4,2.25,2430,10050,4,8,2430,0,825000
4,3.25,2590,3889,3,9,2590,0,760000
4,2.25,2310,9800,3,8,1780,530,561500
4,2,2020,48693,3,7,2020,0,356000
2,1.75,1390,4482,4,8,1390,0,216500
3,2.75,1670,1350,3,9,1350,320,589950
2,1,1050,8220,4,6,780,270,310000
3,1.5,1790,6000,4,7,1790,0,725000
2,1.5,1220,1120,3,8,1110,110,465000
2,1.75,1030,1066,3,7,765,265,335000
3,1.75,2340,5668,4,6,1200,1140,396000
3,2.5,1690,9626,3,8,1690,0,535000
1,1,1230,9300,4,6,1230,0,349950
4,1.5,1580,7350,4,7,960,620,452000
3,1.75,1850,8667,4,7,880,970,450000
4,2.75,2910,6334,3,8,2910,0,499990
2,1,1130,5236,4,6,1130,0,384500
2,1,1000,4640,3,7,1000,0,505000
1,1.5,1120,912,3,7,1120,0,310000
3,1.75,1240,38095,3,7,1240,0,345000
4,2,1900,8160,3,7,1900,0,200000
5,2.25,1950,8086,3,7,1130,820,262500
4,1.5,1760,6150,3,7,1760,0,235000
3,1,1140,5500,4,6,1140,0,476000
4,2,1660,4788,3,7,1660,0,290000
3,2,2610,6000,5,7,1310,1300,780000
3,2.5,2320,219978,4,8,2320,0,685000
3,1.5,1020,11410,3,7,1020,0,255000
5,3.25,4410,35192,3,12,3880,530,1.27E+06
3,2,1300,1920,3,8,850,450,270000
3,1.5,2080,5000,3,7,1300,780,420000
4,2.25,2020,5600,4,8,1210,810,810000
3,2.5,1250,1103,3,8,1250,0,480000
3,1.75,1970,8200,3,7,1270,700,315000
2,1,860,4320,3,7,860,0,250000
3,2,1320,6000,4,7,1320,0,410000
3,2.5,2910,12283,3,10,2910,0,610000
2,1.75,1460,10500,3,7,1460,0,220650
5,2,1930,6120,3,6,1930,0,230000
4,2.5,3284,6516,3,8,3284,0,460458
4,2,1480,3844,5,7,1480,0,449250
3,0.75,1300,72309,3,6,680,620,247500
4,2.5,2780,7838,3,9,2780,0,563500
4,2.75,1810,8677,3,7,1810,0,208000
3,1,1870,2807,4,7,1580,290,585000
2,2.25,1550,1824,3,8,1550,0,348500
3,2.5,2690,21883,3,8,2690,0,445000
4,1.75,1670,8000,4,8,1670,0,268500
3,2.5,1610,5024,3,7,1610,0,293500
2,1.75,1140,936,3,8,940,200,549900
4,2.5,1910,1502,3,8,1910,0,630000
4,1,1190,7920,3,6,890,300,190000
4,2.75,2220,5310,5,7,1170,1050,680000
3,1,1330,9620,5,6,1330,0,206990
3,2.25,1360,5111,5,7,1360,0,550000
3,1.75,2220,22081,4,7,2220,0,595000
3,3.5,1560,1490,3,8,1240,320,625000
3,2.5,2480,9041,3,7,2480,0,620000
3,2.5,1690,5175,3,7,1690,0,305000
2,1,1200,2500,3,7,1090,110,508000
4,2.5,3202,4964,3,9,3202,0,460940
3,1.75,1410,5000,4,7,810,600,550000
4,2.25,2490,7233,3,8,1460,1030,275000
3,3,3290,80471,4,8,2330,960,562000
2,1,1280,9690,4,6,640,640,340000
3,1.75,2240,5657,4,8,1910,330,1.27E+06
3,2.5,2920,434728,4,8,2920,0,859000
5,2.5,1740,8750,4,7,1740,0,199950
3,1.75,2040,6000,5,7,1120,920,555000
3,2,1250,7995,4,7,1250,0,208000
3,2,2210,6387,3,8,2210,0,383150
3,2.5,1430,1250,3,7,1430,0,399000
4,3.5,3780,20023,3,10,3780,0,970000
3,2.5,1890,7053,4,8,1890,0,347500
4,2,1690,3250,3,7,1550,140,487250
4,2.5,3290,6203,3,9,3290,0,648000
3,1.75,1710,15844,4,8,1710,0,322400
4,1.75,1850,65340,4,7,1850,0,205000
3,1.75,1410,7215,3,7,1410,0,383000
4,1,1160,20100,4,6,820,340,500000
3,2.5,1750,3354,4,7,1750,0,595000
3,2,2030,8649,3,7,2030,0,365000
3,1,920,5200,4,6,920,0,179000
3,2,2040,5600,5,7,1120,920,535000
4,2.25,1580,7307,3,8,1160,420,525000
4,2.5,2740,12106,3,8,1980,760,525000
2,1,990,3000,4,6,990,0,409950
3,1.75,2940,6000,4,8,1590,1350,635000
4,1.75,2420,7672,3,8,1480,940,525000
4,2.5,3200,5772,3,8,3200,0,337000
4,1,2520,5500,5,8,1820,700,765000
2,1,1140,7435,3,7,1140,0,327000
2,1,1380,4390,4,8,880,500,450000
3,1,990,8528,3,6,990,0,210490
3,1,1340,21336,4,5,1340,0,281000
3,2.5,1440,2500,3,7,1440,0,287450
4,3.5,4270,12305,3,10,4270,0,1.16E+06
3,1,1410,9704,3,8,1140,270,400000
3,1.75,1710,5000,4,7,1110,600,513000
3,2.75,2500,7378,5,7,1390,1110,700000
3,1,1270,6500,4,7,1270,0,765000
4,2,2040,11850,3,7,1020,1020,749000
4,2.5,1870,7471,3,8,1870,0,375000
3,1,1260,7897,3,7,1260,0,215000
4,3,3600,9687,4,9,3600,0,1.70E+06
4,1.75,2570,12039,3,8,1910,660,495000
3,3.5,2050,21744,4,9,1750,300,770000
3,2.5,2440,7600,3,7,1420,1020,500000
4,2.75,2690,8874,3,8,1370,1320,307450
3,2,1720,10098,4,8,1140,580,508800
4,2.75,2910,16362,4,9,2120,790,485000
3,1.5,1960,8815,4,7,1020,940,500000
2,3.25,2700,3444,3,9,2700,0,1.37E+06
4,2,1440,9477,3,5,1440,0,199000
4,2.75,2110,8190,5,8,2110,0,746000
2,1,1140,7200,3,6,1140,0,276000
2,1.5,1340,3600,3,7,1340,0,525000
3,1.75,1610,7392,4,7,1610,0,160000
4,2.75,3470,70131,4,8,1750,1720,772000
3,2.5,3510,9824,3,9,3510,0,948000
2,1.75,870,4000,3,6,870,0,410000
3,1.75,1660,9549,3,7,1660,0,675000
4,2.75,4190,38912,4,9,2040,2150,910000
4,2.75,3430,15877,3,11,3430,0,1.01E+06
5,2.5,2600,4641,3,7,2600,0,316000
3,2.5,2640,13775,3,8,1550,1090,530000
3,3.5,1494,1262,3,8,1494,0,650000
3,1.75,1850,15170,3,7,1850,0,390000
3,1.75,1620,12825,3,8,1340,280,298000
4,2.75,2600,19275,3,8,1620,980,555000
3,1,1300,5782,4,6,1300,0,281000
4,2.25,2370,9360,4,8,2370,0,684680
4,2.5,2300,219106,4,7,1840,460,352500
2,1,930,10505,3,6,930,0,235000
3,2.25,2020,9000,3,7,2020,0,345000
3,1,1270,8800,3,7,1270,0,447000
3,1,960,8291,3,6,960,0,158800
2,1.5,988,1080,3,7,988,0,295000
4,2.75,2260,12005,4,8,2260,0,738950
3,2.5,1930,4000,3,8,1930,0,345500
5,3.5,2310,5249,3,8,1560,750,515000
4,2.75,2900,5803,3,9,2900,0,637000
4,2.5,3190,9856,3,8,3190,0,387500
3,2,1553,6550,3,7,1553,0,240000
4,2,2260,7680,4,7,1130,1130,525000
4,2,1360,2746,3,7,1360,0,507000
2,1,940,6000,2,7,940,0,246500
3,1.75,1650,1180,3,8,1650,0,599000
4,1.75,2310,9002,3,7,1780,530,350000
3,2.5,2242,4800,3,8,2242,0,328000
3,1.75,1660,8301,5,7,1660,0,434000
4,2.5,3290,8147,3,10,3290,0,856500
3,2.5,3190,7828,3,9,3190,0,495500
2,1,860,6510,3,7,860,0,605000
3,2.25,1660,5128,3,7,1660,0,300000
2,1.75,1160,4848,4,7,1160,0,389000
3,2.5,1960,3480,3,7,1960,0,289950
3,1,1460,8400,4,6,1460,0,222000
4,1.75,3990,13470,3,11,3990,0,1.20E+06
4,1,1530,5684,3,7,1130,400,325000
2,1.75,1840,14874,3,8,1300,540,430000
3,2.25,1790,10209,3,7,1290,500,425000
3,2.5,2180,5000,4,8,1240,940,625000
2,2.5,1570,2399,3,7,1180,390,352500
3,2.25,1230,875,3,8,1230,0,550000
2,1,960,28717,4,6,960,0,255000
2,1,930,4000,3,6,730,200,269500
3,2,1030,11118,5,7,1030,0,240000
3,1.75,2000,5680,4,7,1080,920,519000
3,1,1340,18552,4,5,1340,0,160000
4,1,1200,11111,3,7,1200,0,282000
3,1.75,1400,7920,3,7,1400,0,335000
5,4.5,4850,10584,3,10,3540,1310,3.57E+06
3,1.75,1140,22267,3,7,1140,0,269900
2,2.75,1370,1140,3,8,1080,290,359000
5,3,3900,5250,5,8,2620,1280,850000
5,2.5,2400,4564,3,7,2400,0,268000
3,1.75,1360,9603,3,7,1360,0,237100
3,1,1020,9147,4,6,1020,0,214000
3,2.75,1720,28000,4,7,1720,0,326000
4,2.5,2430,44001,3,8,2430,0,570000
4,3,2440,9664,3,8,1890,550,480000
3,1.75,1350,7686,3,7,1350,0,261000
3,2,1810,4500,4,7,980,830,760000
4,3.5,3720,13591,3,10,3720,0,760000
3,1,1020,7615,3,7,1020,0,231750
1,0.75,380,15000,3,5,380,0,245000
5,2.75,2930,10148,3,9,2930,0,257000
2,1.75,2080,13054,3,7,2080,0,600000
4,3,3060,5000,3,8,3060,0,399000
3,1.75,2440,5800,4,8,1320,1120,765000
4,1.75,1780,8768,4,7,1050,730,518000
3,3,2390,8993,3,8,1680,710,260000
4,1.75,2090,7416,4,7,1050,1040,289950
2,1.5,1450,6258,4,8,1450,0,245000
3,1,1050,8498,3,7,1050,0,205000
4,2.5,2230,10414,5,7,1450,780,544500
2,2,1350,3900,3,8,1350,0,428000
3,2.25,1760,8287,3,7,1160,600,270000
3,1,1040,8122,5,7,1040,0,234000
3,1.75,1440,7198,3,7,990,450,274000
3,2.5,1390,2815,3,8,1390,0,400000
4,2.5,4270,43386,3,10,2680,1590,975000
4,2,1540,10212,5,7,1540,0,259950
4,1.75,1840,7275,3,7,1090,750,279000
3,2.25,1500,7210,3,7,1150,350,230000
2,1,950,3060,3,6,810,140,490000
3,1.75,1820,15570,3,8,1820,0,700000
4,1,1540,9541,4,7,1540,0,370000
3,2.5,1970,4058,3,7,1970,0,419000
2,2.25,1110,1290,3,8,1110,0,345000
4,2.5,2790,230868,3,8,2790,0,599000
4,2.75,3540,7091,4,8,1970,1570,784000
3,2.5,2060,8123,3,8,1010,1050,541338
2,1.5,1260,2625,4,7,1260,0,401000
3,2.25,3440,10628,3,10,3440,0,855000
4,2.5,2980,10459,3,9,2980,0,565000
4,2.5,2720,10455,3,10,2500,220,975000
4,2.5,2460,8029,3,9,2460,0,638250
3,1.75,2920,21375,3,8,1850,1070,480000
3,1.5,1150,13200,3,7,1150,0,252000
5,1.75,2360,8642,5,7,2060,300,302000
3,1,1250,7200,3,7,1250,0,485000
4,1.5,1840,10080,3,8,1840,0,701000
3,1,1030,7800,3,7,1030,0,229000
3,1.75,1540,6687,3,7,1200,340,240000
3,1.75,1430,10350,3,7,1430,0,530000
3,1.75,1900,4000,3,7,1300,600,855000
4,2.5,2210,5002,3,7,1370,840,733000
3,1,1310,8400,3,7,1310,0,375000
4,3.5,4120,12626,3,11,3970,150,1.36E+06
2,2.5,2770,7781,3,8,2770,0,754800
3,2.25,2470,5650,3,7,1550,920,361000
2,1,860,8636,3,6,860,0,170000
5,3.25,3360,6120,3,9,3360,0,829995
4,1.75,1420,5000,4,7,1420,0,535000
4,3,2100,3800,3,8,2100,0,635000
4,2.5,2650,18295,3,8,2650,0,725000
3,2.75,3170,34850,5,9,3170,0,1.09E+06
3,2.5,2056,3564,3,7,2056,0,303000
4,2.5,2570,9000,4,8,1590,980,287500
4,2.5,1690,7260,3,7,1080,610,238000
6,3,2800,4213,3,8,2800,0,677790
4,2.25,2840,31720,3,8,1780,1060,600000
2,1.5,1050,3419,3,7,1050,0,163500
4,2.5,3690,11468,3,11,3690,0,900000
3,1.75,1690,6375,3,8,1690,0,457000
3,2,2360,4800,3,9,2360,0,1.76E+06
3,2.5,1690,1613,3,8,1150,540,386591
2,1,1070,4200,4,6,1070,0,160000
5,1.75,2360,6150,5,7,1180,1180,871000
2,1,880,6380,3,7,880,0,490000
2,1,850,54000,1,4,850,0,150000
4,1.75,2190,8400,2,8,2190,0,286000
4,2.5,2590,8483,3,9,2590,0,570000
3,2.25,1920,7300,3,7,1240,680,465000
3,2,1580,7400,3,7,1050,530,480000
3,2,2500,10697,3,8,2500,0,330000
3,2.5,1800,4763,3,7,1240,560,670000
4,1.75,1900,10454,4,7,1180,720,650000
2,1,1280,5026,4,8,1020,260,425000
4,3,3150,9130,3,9,3150,0,695000
4,2,1840,4760,4,6,1080,760,433000
3,1.5,1320,7201,3,7,1320,0,370000
2,1,1380,5000,3,7,870,510,268000
5,3.5,3700,8504,3,8,2750,950,1.30E+06
3,2.25,1400,7205,3,7,1140,260,220000
6,3,3420,22421,5,9,2270,1150,975000
3,1.75,1560,8078,4,6,1560,0,1.20E+06
3,1,1200,9194,4,7,1200,0,369500
3,2.5,1800,2792,3,8,1800,0,379900
2,2.5,1250,1580,3,7,1030,220,267100
4,1.5,2020,8474,5,7,1010,1010,320000
4,2.25,2200,3404,3,8,2200,0,355000
4,2,1580,7800,2,6,1580,0,333000
3,1.5,1670,11610,4,7,1670,0,280000
3,2.5,2010,9725,4,8,2010,0,490000
4,2.75,1930,3840,3,7,1170,760,328000
3,1.5,1330,10640,3,7,1330,0,374000
3,3,1290,1112,3,7,1290,0,305000
4,2.5,2690,6124,3,7,2690,0,311000
3,1,1010,9678,5,7,1010,0,245000
4,2.5,4060,9734,3,9,2150,1910,603500
3,2.5,2400,5817,3,8,2400,0,540000
3,2,1350,11150,3,7,1110,240,310000
3,1.75,1520,5618,3,7,1170,350,550000
2,1,860,1800,3,7,860,0,390000
3,1,1270,8000,4,7,1270,0,510500
4,1.75,1620,10530,3,7,1620,0,249950
3,2.5,1720,6847,3,7,1720,0,263000
3,1.5,1580,8841,5,7,1180,400,520000
3,2.25,1640,8625,3,8,1320,320,580000
3,1.5,1520,8519,3,7,1520,0,365000
4,3,4260,18687,3,11,4260,0,1.00E+06
4,2.5,2710,6558,3,9,2710,0,455000
4,2.5,2520,5000,3,9,2520,0,680000
4,1.75,3050,9440,3,8,1800,1250,600000
1,1,1000,9084,3,7,1000,0,641500
4,2.5,2230,5970,4,7,2230,0,337000
5,1.75,1550,6986,3,7,1030,520,318500
4,2.5,4260,36360,4,8,4100,160,635000
5,2.25,3440,5000,5,9,3440,0,1.23E+06
4,1,1340,8400,5,7,1340,0,246600
3,2.25,2080,70567,3,8,2080,0,594000
3,2,2260,11305,3,7,1130,1130,400000
4,2.25,1500,5393,3,7,1500,0,215000
4,1,1490,6000,3,7,1490,0,570000
3,2,1670,4438,3,7,1670,0,249950
2,1.75,960,6200,4,7,960,0,400000
3,1.5,1060,10464,4,7,1060,0,303500
4,3,2750,7965,3,9,2750,0,395000
3,1,950,9451,4,7,950,0,350000
3,2.5,1480,1531,3,8,1480,0,598950
4,4,4690,6900,3,11,3480,1210,1.95E+06
4,2.5,2670,11877,3,9,2670,0,669950
4,2.75,2390,9968,4,9,1390,1000,415000
4,2.5,2030,4997,3,8,2030,0,310950
4,2,2100,4500,5,7,1060,1040,550000
3,1.75,2770,15232,3,8,1570,1200,750000
4,2.5,3420,21344,3,9,3420,0,640000
4,2.5,2620,5450,3,9,2620,0,648000
2,1.75,1350,4614,3,8,1350,0,498800
2,1,830,4500,3,6,830,0,160000
3,1,770,6552,3,6,670,100,307000
3,2,1540,8885,5,6,1540,0,375000
2,1,1290,4650,4,7,1290,0,494000
6,2.25,2550,5000,4,7,2550,0,1.02E+06
3,2.5,1260,972,3,8,840,420,353500
5,1.5,2160,5000,4,8,2160,0,770000
4,2.5,2440,6651,3,9,2440,0,631625
4,1,1080,26114,5,5,1080,0,275000
3,2.25,2120,13644,4,9,1420,700,693000
4,1.75,1880,4080,3,7,940,940,595000
3,2.5,1810,5192,3,8,1810,0,342500
3,1.75,1870,9000,5,9,1870,0,595888
3,1,1430,15246,4,7,980,450,235000
4,2.5,1714,3250,3,8,1714,0,305000
4,2.5,2080,7047,3,8,2080,0,329800
4,2,1770,7700,4,7,1770,0,620000
5,2.25,3200,20158,3,8,1600,1600,1.33E+06
4,2.5,2820,4174,3,9,2820,0,677000
2,1.75,1590,11276,4,7,1590,0,225500
3,2.5,1540,7280,3,7,1080,460,279000
4,2.75,3210,6825,5,7,1810,1400,580000
4,2.5,3040,6000,3,9,3040,0,431000
4,2,2850,7861,4,10,1450,1400,1.28E+06
4,2.75,2070,10125,3,7,1390,680,741000
3,1.5,1280,5065,4,6,1280,0,215000
3,1,1750,5355,4,7,1750,0,707900
5,2,3540,9970,3,9,3540,0,775000
4,2.5,3010,9155,3,9,3010,0,419000
3,1.75,1270,6600,5,7,1270,0,449000
3,2.5,2040,15463,3,8,1340,700,200126
3,1,1040,5060,3,7,1040,0,480000
1,1.5,1200,44866,3,7,1200,0,380000
2,1,770,8612,3,6,770,0,269000
4,2.5,2620,9359,3,9,2620,0,405000
3,1.75,1310,9761,3,7,1310,0,300000
4,3.25,3060,3898,3,10,2300,760,782900
2,1.75,1600,5795,3,8,1600,0,672324
4,2.5,2610,5140,3,8,2610,0,674600
3,3.5,1790,1288,3,8,1390,400,450000
3,2.25,2300,35287,3,8,2300,0,330000
4,2,1600,6861,3,7,1600,0,280000
4,2.5,2080,7000,4,8,1400,680,330000
4,3.25,3760,10920,5,9,2400,1360,1.58E+06
4,2.75,2050,4000,3,8,2050,0,355000
4,1.5,1420,4923,4,8,1420,0,679000
4,2.75,4510,5000,3,8,3270,1240,1.06E+06
6,3.75,2740,6924,3,7,1640,1100,585444
3,2,1640,5280,5,6,1640,0,234000
4,2.5,2110,11680,4,7,1420,690,580000
3,2.75,2270,13590,4,6,1300,970,199950
4,2.5,2700,4590,3,8,2700,0,1.02E+06
2,2,1870,4751,3,8,1870,0,592500
3,1.75,1800,7620,3,8,1350,450,509007
3,1,1180,32214,3,7,1180,0,179500
3,2,1460,6377,3,7,1460,0,285000
3,2.5,1380,1547,3,8,1380,0,345000
3,1.75,1600,8156,5,7,1600,0,393500
4,2.5,2060,7720,3,8,2060,0,242550
3,2.5,1980,9061,4,8,1980,0,550000
2,2.25,1550,2079,3,8,1550,0,328000
3,2.5,2950,35108,3,10,2950,0,820000
3,1,950,7610,3,7,950,0,190000
3,2.5,2770,8820,3,7,1900,870,390000
4,2.5,2600,118666,3,7,1400,1200,510000
2,1,700,4700,5,5,700,0,200000
5,2.75,2980,8500,3,8,1540,1440,374900
3,1,1200,7210,4,6,1200,0,168000
5,2.5,2820,6305,3,8,2820,0,395000
3,2,2320,10960,3,7,1510,810,657500
2,1.75,1960,30144,3,7,980,980,280000
4,2,2030,9300,4,8,2030,0,627000
4,2,2010,9474,3,7,2010,0,410000
4,2.5,2050,14724,3,7,2050,0,398000
5,2.5,2520,27951,3,7,1890,630,392400
4,4.25,5550,12968,3,11,5550,0,1.50E+06
4,1.75,1530,8750,4,7,1530,0,269900
3,2.75,3910,7080,5,9,1970,1940,1.48E+06
1,1,730,3000,3,7,730,0,395000
4,2.25,1870,5371,3,7,1870,0,293000
4,1.75,1720,3050,5,7,1040,680,460000
3,2.5,1840,8234,3,8,1840,0,297000
4,2.5,1890,15770,4,7,1890,0,389999
2,2.25,1390,916,3,8,1165,225,625000
4,2.5,2660,40312,4,8,2660,0,667400
4,2.25,1770,7778,3,7,1770,0,350000
3,2,1580,1972,3,8,1180,400,540000
3,2.5,2100,7851,3,8,2100,0,515000
3,2.75,2340,12282,3,8,1470,870,300000
3,2.5,1910,4941,3,8,1910,0,570000
3,2.5,1960,8469,4,8,1960,0,552321
3,2.5,2690,17461,3,10,2690,0,805000
3,1,960,5030,3,7,960,0,545000
1,1,640,10280,2,5,640,0,110000
3,2.25,1790,6930,3,7,1390,400,304500
3,2.25,1770,8755,3,8,1330,440,327500
2,1,860,5400,4,5,860,0,187000
4,2.5,3070,7200,3,8,3070,0,525000
4,2,2180,6000,3,8,2060,120,677000
4,2.75,3870,10046,3,11,3870,0,1.40E+06
3,1.5,1630,6625,5,7,980,650,230000
4,2.25,1960,14834,4,8,1330,630,474000
4,3.5,3040,4006,3,8,2350,690,815000
5,1.75,2230,7560,3,7,1230,1000,375000
4,3.5,2990,4200,5,9,2000,990,1.00E+06
3,1.75,1660,8303,3,7,1380,280,279950
4,2,2090,3610,5,7,1790,300,619400
5,2.75,3280,12673,4,9,2050,1230,965000
4,1.75,1770,7336,4,8,1770,0,350000
4,3,2450,4668,3,8,2450,0,500000
3,1,1430,7000,3,6,1430,0,213950
2,2.5,1320,1395,3,8,990,330,529000
3,1,1710,5110,3,7,1100,610,396500
3,2.5,1370,22326,3,7,1370,0,280000
1,0.75,850,5600,3,6,850,0,170000
2,1,1210,7667,3,6,900,310,529000
4,2.75,3260,19542,4,10,2170,1090,1.88E+06
3,2.5,2170,5500,3,8,2170,0,606500
4,1,1710,117176,4,6,1710,0,389900
4,2.5,3350,29242,3,11,3350,0,910000
3,1.75,1300,2446,3,8,880,420,676500
4,1.75,1650,8560,3,8,1650,0,525000
4,4,4130,5575,4,10,2860,1270,2.75E+06
4,2.25,1810,7068,5,7,1810,0,485000
3,2.5,1750,2150,3,7,1230,520,499000
2,2.5,1570,1268,3,7,1570,0,208400
5,2,2130,4180,5,7,1270,860,615000
3,2.5,1870,3584,3,8,1870,0,345000
2,1,1070,5824,5,7,1070,0,319950
4,3.25,4386,12275,3,10,2356,2030,545000
2,1,750,2786,5,7,750,0,435000
1,1,900,4368,5,6,900,0,152900
3,2.5,2350,9648,4,9,2350,0,643403
4,2.5,4070,57587,3,10,4070,0,965000
3,2.5,1460,11593,3,7,1460,0,245000
3,3,2230,1407,3,8,1850,380,635000
3,1.75,1360,6603,4,7,1360,0,280000
4,2.5,1990,5577,3,7,1990,0,283500
3,1,1110,7208,3,7,1110,0,411500
3,2,2100,72745,4,9,2100,0,740000
3,1.75,1570,10939,3,8,1200,370,515000
3,1,1520,6500,3,7,990,530,310000
3,2.5,2680,4990,5,8,1440,1240,830200
3,2.5,2650,40705,3,9,2650,0,770000
4,2.75,3040,7274,3,9,2320,720,640000
4,2.75,3980,285318,3,9,3980,0,760000
3,1.75,1960,11931,3,7,980,980,320000
5,2.5,2650,12987,4,7,1350,1300,459000
3,2.5,1930,6604,3,7,1930,0,550000
1,1,700,2500,4,7,700,0,295000
2,1,1530,6350,4,7,1530,0,880000
3,1.75,1720,5956,3,8,1720,0,575000
2,2.5,3360,6750,3,9,3360,0,850000
5,2.75,2110,5120,3,7,1870,240,425000
4,1,1010,7515,4,6,1010,0,248000
4,1.75,2340,5080,5,7,1170,1170,570000
3,1,1330,5000,3,7,1120,210,410000
3,1,1660,7500,4,7,1060,600,458000
3,2.75,2000,6405,3,8,1260,740,286300
3,3,2490,27702,3,10,2490,0,1.71E+06
7,4.25,4670,23115,3,11,4670,0,2.45E+06
3,2.5,2530,623779,4,8,2530,0,700000
3,3,1590,7750,3,7,1060,530,275000
3,2.5,2140,3821,3,8,2140,0,420000
5,3,2020,5917,3,7,1220,800,311000
4,5.5,6930,45100,4,11,4310,2620,2.53E+06
4,1,1760,8906,3,7,1230,530,365000
3,1.5,1790,8203,3,7,1790,0,544000
3,1,1010,7690,4,6,1010,0,165000
5,2.5,2093,10350,5,7,2093,0,300000
4,2.5,2820,5934,5,9,1770,1050,960000
4,2.5,3340,5314,3,10,3340,0,701000
4,2.5,2570,6157,3,7,2570,0,490000
4,2.5,4020,44431,3,10,4020,0,818000
6,3,2320,4502,4,7,1200,1120,384000
4,1.75,2090,8164,4,8,1070,1020,581000
3,2,2010,4320,3,9,2010,0,699000
4,2.5,2790,7673,3,9,2790,0,803000
3,2.25,2150,9900,3,8,1450,700,458000
3,2.25,1740,6650,3,7,1240,500,305000
2,2.5,2730,7246,3,9,2730,0,535000
3,1.75,1540,10800,5,6,770,770,500000
3,1,1220,6000,5,7,1220,0,161500
5,4.75,6200,13873,4,11,4440,1760,3.30E+06
6,4,3300,5720,3,8,1960,1340,780000
5,2.25,2200,9600,4,7,1100,1100,268450
3,2.5,3030,46538,3,10,3030,0,820000
3,3,2360,2750,3,7,1780,580,498000
3,1.75,2930,266587,3,8,2440,490,549950
3,1,1200,6615,4,7,1200,0,260000
3,2.5,2490,5978,3,9,2490,0,645000
2,1.5,1160,1848,3,7,1160,0,229950
3,2.25,1610,3764,3,7,1610,0,290000
2,1,1260,4377,4,7,1260,0,405000
3,1.5,1490,4400,4,7,1490,0,670000
3,3.5,1900,4805,3,8,1560,340,385000
3,1.5,1570,6450,4,6,1570,0,169000
2,1,1050,403365,5,6,1050,0,474000
2,1,1370,10038,4,7,1370,0,547000
4,2.5,2130,35752,3,8,1490,640,580000
3,1.75,1620,7500,3,7,1220,400,347500
3,2.25,2430,7614,3,8,1900,530,365000
3,1,1560,5225,3,7,1260,300,430000
3,2,2270,148975,4,6,1270,1000,452000
3,1.75,2160,22702,4,7,2160,0,260000
2,1,1120,5650,3,6,1120,0,260000
3,2,2440,13250,4,8,1440,1000,312000
3,2.25,3060,9950,4,9,1810,1250,970000
3,2.5,2020,11935,4,9,2020,0,560000
3,1.5,910,5120,3,6,910,0,107000
4,1.75,2540,7200,4,7,1270,1270,525000
4,2.25,2600,6390,3,8,1390,1210,245000
3,1,960,10181,3,7,960,0,322000
3,2.5,1760,10137,3,8,1760,0,310000
6,5,3028,18055,3,7,3028,0,480000
2,1,670,7312,3,5,670,0,348000
4,2.25,1800,5555,3,7,1800,0,272000
3,2.5,3370,14402,3,9,3370,0,595000
2,1,960,6250,3,6,960,0,355000
2,1.5,1140,1149,3,7,940,200,518000
3,2,1440,7008,3,7,1440,0,245000
2,1,1010,5200,3,7,1010,0,174500
3,2.5,1650,2802,3,7,1650,0,250000
3,1.75,1210,8075,4,6,1210,0,215000
3,1.75,1830,9620,4,8,1830,0,400000
3,1.75,1790,12000,3,7,1040,750,243000
3,2.75,3210,15939,3,10,3210,0,565000
3,2.25,1960,7414,3,7,1490,470,250000
3,1,840,5200,3,6,840,0,199990
4,2.5,1710,5000,3,8,1110,600,637000
2,1,1180,6000,3,7,1180,0,450000
3,1,1300,8284,3,7,1300,0,169575
2,1,760,3001,3,6,760,0,300000
1,1,1090,8750,4,6,1090,0,463500
3,2,1050,10072,3,7,1050,0,300000
4,3.5,3310,21050,5,9,2400,910,695000
3,1,890,6488,3,5,890,0,150000
4,2.25,2420,15482,4,8,2420,0,975000
3,2.5,2070,6145,3,7,2070,0,289950
4,3.5,3000,5300,5,7,1780,1220,760000
3,1.5,1660,4800,3,8,1660,0,926300
4,2.5,3680,11648,3,10,3680,0,909000
3,1.75,2070,5000,3,8,2070,0,880000
4,2.25,4370,22863,4,10,3670,700,2.35E+06
3,1.5,1260,5758,3,7,1260,0,333000
3,1.75,1520,5500,5,7,1520,0,738000
3,1.75,2350,12720,4,7,1180,1170,245000
5,2.75,2920,9163,4,8,1520,1400,713500
3,2.5,2320,9610,3,9,1730,590,525000
3,2.25,2880,6092,4,8,1920,960,1.05E+06
2,1,840,12252,3,6,840,0,190000
3,2.25,2470,10290,3,8,2230,240,350000
3,1.5,1510,344124,4,7,1510,0,327000
4,2.5,2240,7350,3,9,2240,0,689000
3,3.25,3030,5600,3,9,2220,810,1.22E+06
3,2.5,1520,9864,3,7,1160,360,240000
2,1.5,1480,9660,3,7,1480,0,255000
2,2,1200,7131,3,8,1200,0,389000
4,1.75,3140,12519,3,7,2320,820,585000
3,1,1530,6372,3,7,1210,320,387000
4,2.5,2550,4770,3,8,2550,0,371000
2,1.75,1710,4234,3,7,1330,380,405000
3,2.25,2220,16020,4,8,1780,440,325000
3,2.5,1620,1173,3,8,1470,150,580000
4,3.5,3920,11086,3,10,3920,0,825000
4,2,1690,35346,3,7,1690,0,612500
3,1.75,1340,8000,3,7,1340,0,260000
5,3.5,3020,15305,3,10,2230,790,754000
4,3.5,2370,3302,3,8,1610,760,800000
3,1.5,1890,6183,3,7,1090,800,400000
3,1,670,23522,4,6,670,0,340000
3,2,1030,7260,3,6,1030,0,260000
3,2.5,1660,4083,3,7,1660,0,284000
3,2,1380,5198,4,7,1380,0,329900
3,1,1000,8470,4,6,1000,0,196000
3,2.5,3800,104979,3,8,3210,590,472000
3,1.75,2190,6450,3,8,1480,710,765000
4,1.75,1520,9600,4,7,1000,520,508450
4,2.75,3150,67518,4,9,2250,900,370000
4,3,3740,30884,3,9,3060,680,869000
5,2.25,2700,9000,5,9,2700,0,898000
5,3.25,2590,11500,4,9,2590,0,1.50E+06
4,2,2340,50233,4,7,1170,1170,568000
4,1.5,2430,3600,3,8,2430,0,940000
3,3.25,1830,1804,3,8,1830,0,599950
3,3.5,3620,8072,3,10,2920,700,1.16E+06
3,1.75,1600,10530,3,8,1600,0,562000
4,1.75,1420,10300,3,7,1420,0,225000
3,2.5,1530,6000,4,7,1530,0,265000
2,1,1470,7137,3,7,1020,450,445434
3,1.75,1420,8126,3,8,1420,0,265000
2,2.25,2690,15000,3,8,1870,820,515000
3,1.5,2040,6750,3,7,1280,760,500000
3,1.75,1940,8376,4,8,1290,650,550000
3,2.5,2160,7500,3,7,1430,730,532500
3,1.5,1190,10116,3,7,1190,0,160134
4,1.75,1930,3876,5,7,1450,480,733000
4,2,2610,14321,4,6,1690,920,294950
4,1.5,1300,10050,3,7,1300,0,287000
2,1,990,8250,3,7,990,0,365000
4,1.75,1490,4485,3,8,1350,140,604000
4,3,2390,7309,4,7,2390,0,269950
5,2.25,1960,8592,4,8,1290,670,860000
4,3.5,2720,3000,3,9,2250,470,790000
4,2.25,2710,38180,4,8,2710,0,591000
3,3.25,1480,983,3,8,1180,300,315000
2,1.75,1300,14500,3,6,650,650,244500
4,1,1640,4200,3,7,1640,0,832600
4,3.25,3720,7150,3,11,3720,0,980000
2,1,1200,9488,5,7,1200,0,231500
4,1.5,2740,4000,5,9,1930,810,1.11E+06
4,2.5,2320,11259,3,9,2320,0,640000
3,2.5,3490,9362,5,9,1770,1720,1.62E+06
3,2,1430,12430,4,7,1430,0,305000
3,2.5,2970,23100,3,7,1510,1460,400000
4,2.75,3220,15467,3,11,3220,0,890000
3,2.25,1430,7222,3,7,1430,0,280000
4,3.25,3270,6027,3,10,3270,0,835000
2,1,1396,111949,3,7,1396,0,225000
4,3,3370,47959,4,10,3370,0,905000
2,1.75,1850,2530,4,7,1850,0,495000
3,2.5,2610,7256,3,9,2610,0,754950
2,1,870,6126,4,7,870,0,387500
6,5,2732,7655,3,7,2732,0,343000
6,2,1900,8057,4,7,1170,730,375000
3,1.75,1310,8065,4,6,1310,0,435000
3,2.25,1900,9990,3,7,1300,600,250000
3,2,1670,4572,3,8,1670,0,585000
3,2.25,1660,10140,4,8,1370,290,566000
3,2.5,1630,7586,3,8,1630,0,475000
3,1,1660,6992,5,7,1260,400,412000
4,2.5,1980,4745,3,7,1980,0,335000
4,2.5,2000,5962,3,8,2000,0,415000
3,1.5,1400,1091,3,8,1400,0,419500
5,2.5,4340,9108,5,8,2170,2170,537500
2,1,610,4000,4,6,610,0,286000
3,2.5,2570,5000,4,8,1480,1090,1.01E+06
2,1.5,1190,801,3,8,1190,0,300500
3,2.25,1670,6600,4,7,1670,0,289000
4,2.25,2640,3000,3,7,2080,560,1.55E+06
3,2.25,1860,1558,3,8,1860,0,539950
3,1,1120,5200,5,7,1120,0,195700
4,3.5,3260,5000,5,9,2630,630,1.55E+06
3,1.75,2040,11294,4,7,1340,700,730000
2,1.75,2320,6755,5,8,1380,940,705000
3,2.5,2250,8076,3,8,2250,0,390000
5,3.5,3560,5008,3,8,2810,750,616950
3,1.75,1760,9277,4,7,1760,0,388000
3,1,1050,7670,5,7,1050,0,235000
3,2.5,1650,14054,4,7,1130,520,379880
4,1.75,2700,27072,3,7,1380,1320,314900
4,1.75,1580,3635,4,7,790,790,537000
3,3.5,4560,14608,3,12,4560,0,1.49E+06
2,1,900,5000,5,6,900,0,210000
3,2,2060,7000,4,9,2060,0,574000
3,2,2130,4299,4,7,1680,450,700000
3,1,1040,8128,3,6,1040,0,234000
3,1,940,2366,3,6,940,0,356000
3,1,990,4250,4,7,840,150,399000
2,1,690,6000,3,6,690,0,260000
3,2.5,2240,7791,3,7,2240,0,452500
4,1.75,1570,7650,3,7,1100,470,430000
3,2,1300,11374,5,7,1300,0,287000
5,3.25,3840,4800,3,10,2750,1090,1.46E+06
2,1,860,12160,4,6,860,0,310000
3,2.5,1480,15639,3,8,1480,0,275000
3,1.5,1870,42070,3,7,1870,0,285000
4,3.5,4140,13392,3,11,4140,0,950000
3,2.75,3360,41250,4,7,1820,1540,329999
5,4.5,6085,142725,3,11,6085,0,1.61E+06
4,2,2680,18768,5,8,2680,0,360000
4,1.75,2440,5000,3,8,1340,1100,566000
4,2.5,3180,5405,3,7,3180,0,510000
3,1.5,1360,885,3,8,1360,0,359000
3,1.75,1630,7480,3,7,1330,300,291600
3,1,1200,16000,3,7,1200,0,355000
4,1.75,1500,12560,4,7,1000,500,239000
4,1.75,1670,13125,5,8,1670,0,661000
3,2,1500,2500,3,8,1500,0,505000
3,2.25,1350,6775,3,7,930,420,245000
4,3.5,4380,66613,3,11,4380,0,1.40E+06
3,1.5,910,5120,3,6,910,0,232900
3,2,2410,50654,3,7,2410,0,485000
3,1.5,1580,5000,3,8,1290,290,700000
2,1.75,1930,11200,3,8,1430,500,581000
3,2.5,1070,1155,3,7,720,350,330000
3,2,1210,7136,3,7,1210,0,269000
4,3,2840,4120,4,8,2060,780,735000
5,2.75,2790,4807,4,7,2140,650,288000
3,1.5,1240,7733,3,6,790,450,375000
4,1,1270,6459,3,7,1270,0,226000
4,1,1010,7200,3,6,1010,0,290000
4,2.5,2360,13500,4,8,1780,580,600000
3,2.25,2310,7200,3,8,2310,0,327500
3,2.5,1490,8005,3,7,1090,400,271500
3,1.75,2220,216493,3,8,2220,0,585000
5,1.5,1830,9000,3,7,1030,800,465000
4,2.75,5440,239580,2,9,2720,2720,850000
3,2.5,3720,11610,3,11,3720,0,1.08E+06
4,2.75,2860,6867,5,7,1560,1300,874000
4,2.5,1850,5388,3,8,1850,0,328000
3,1,1250,5411,3,7,1250,0,164808
3,2,1780,1750,3,8,1400,380,760000
6,2.5,3550,6533,3,8,3550,0,895000
4,1,1790,8400,4,7,1260,530,401500
5,1.75,2330,3800,3,7,1360,970,780000
4,2.5,2680,15508,3,8,2680,0,300000
4,2.5,2620,14126,4,8,1620,1000,922000
4,2.5,2720,16454,5,9,1870,850,1.28E+06
3,1.5,1900,5250,4,7,1500,400,562200
2,1,960,5150,5,6,960,0,267500
2,1,1560,5000,4,7,1560,0,724000
3,1,1390,12145,4,7,1390,0,199000
3,2.25,1640,5880,3,7,1240,400,415000
4,1,1490,6600,3,7,1490,0,185000
3,2.5,3550,32807,3,9,3550,0,775000
3,1.5,1170,11530,3,7,1170,0,157000
5,2.75,2060,329903,5,7,2060,0,432000
6,2.75,3600,9675,4,9,1940,1660,1.00E+06
1,1,720,5000,4,6,720,0,185000
3,2,2130,4000,3,7,2130,0,645000
4,3,3550,12327,4,10,2180,1370,720000
2,2,1830,3600,4,7,1230,600,825000
4,2.5,3300,10250,3,7,2390,910,905000
4,2,1870,6551,3,7,1870,0,272000
3,2,1640,9234,5,7,1060,580,319000
3,1,1310,9529,3,7,1310,0,235000
3,1,960,15273,4,7,960,0,201000
4,2.5,3740,8700,3,10,2260,1480,475000
5,2.25,2720,8800,4,7,1500,1220,530000
4,3.5,3080,5250,3,9,3080,0,775000
4,2.75,2250,3433,3,8,1500,750,1.05E+06
3,3,1520,1800,3,7,1520,0,600000
3,2.5,3110,6765,4,9,2550,560,1.64E+06
3,2.5,2020,4861,3,7,2020,0,290000
3,1.75,1670,6720,3,7,1140,530,405000
2,1,1120,12625,3,7,1120,0,360000
3,2.25,2170,5001,3,8,2170,0,802000
3,1.75,1520,6559,4,7,1170,350,295000
3,2,1640,9972,4,7,1640,0,420000
2,1,740,6840,5,6,740,0,250000
4,3,2390,4500,3,7,2390,0,290000
5,3.5,3480,36615,4,8,2490,990,650000
5,2.5,2900,8711,3,8,1650,1250,413000
6,4.75,5540,7200,4,11,3950,1590,2.63E+06
2,1,810,7980,1,6,810,0,255000
4,2.5,3420,183387,3,10,3420,0,975000
2,1.5,1050,1046,3,8,960,90,375000
3,2.5,1320,2480,3,7,1320,0,305000
3,2.5,2130,12245,3,8,2130,0,325000
4,2.25,1620,106722,3,8,1200,420,327000
3,2,2390,8025,5,7,2390,0,810000
2,2,2160,35183,3,9,2160,0,381500
5,3,3880,7180,3,7,3880,0,445000
3,1.5,1370,8470,4,7,1370,0,185000
5,2.75,2510,9180,4,8,1600,910,695500
3,1.75,1600,313672,4,7,1600,0,408000
4,2,2440,9600,5,7,1220,1220,274700
4,2.5,2290,8796,3,8,2290,0,349900
3,1.5,1580,10517,4,6,1580,0,233500
2,1,790,7153,4,6,790,0,118125
4,2.5,2740,45732,3,8,2740,0,483500
5,1.75,2330,6000,3,8,2080,250,825000
3,2.5,2230,4000,3,7,2230,0,398750
5,1.75,1380,7620,3,7,1180,200,350000
4,2.5,2800,17279,3,7,1560,1240,439000
3,2.5,1350,1250,3,8,1270,80,394950
2,1.75,2200,89298,3,7,1100,1100,295000
4,2.75,2230,9640,3,8,1320,910,435000
2,1,790,6426,3,6,790,0,100000
5,2.5,2160,7737,3,7,2160,0,480000
4,2.25,1890,7616,4,8,1260,630,291000
4,2.75,2020,7357,3,7,1350,670,520000
4,1.75,1570,8268,3,7,1570,0,452000
4,2.5,2390,9638,3,10,2390,0,645500
3,1.75,1780,120661,4,6,1780,0,336900
4,2.25,2115,6234,3,7,2115,0,272000
4,2,2000,8317,4,8,2000,0,756100
5,3.75,3830,8131,3,10,3830,0,852500
3,3,1960,1168,3,9,1600,360,556000
3,1.75,1350,7370,4,6,1350,0,300000
4,2.75,2420,4635,5,7,2420,0,820000
4,2.5,2070,4500,3,7,2070,0,343000
3,2,2020,5500,3,10,1790,230,1.40E+06
6,4.75,5480,19401,5,11,3910,1570,3.65E+06
3,2.5,1880,7838,3,7,1880,0,309950
4,2.5,3200,3600,4,9,2600,600,1.45E+06
4,2.75,2280,15347,5,7,2280,0,500000
4,2.25,2190,4104,5,8,1410,780,808000
3,3.25,2580,9825,4,9,1760,820,688888
4,2,1370,4000,3,9,1370,0,605004
3,2,2250,8800,4,7,1250,1000,589000
4,2.75,4110,8400,3,9,3130,980,1.20E+06
4,1.5,1960,12688,4,7,1960,0,442000
3,1.75,1790,6980,3,7,1330,460,402200
3,2.25,1590,926,3,8,1590,0,489950
3,1.5,1220,3286,3,7,1220,0,295000
3,1.5,960,6497,4,7,960,0,160000
3,2.5,1600,3580,3,7,1600,0,292000
3,2.5,1408,989,3,8,1408,0,416286
6,2.75,2300,24773,4,9,2300,0,900000
5,1.75,1840,10453,3,8,1360,480,395000
3,2,1400,7293,4,7,1400,0,511555
3,2,1460,7740,3,7,1460,0,225000
2,1,1000,4500,3,6,1000,0,207100
5,4,4410,14380,3,11,4410,0,1.24E+06
3,1.75,2520,5043,3,8,1260,1260,429000
3,1.75,1630,28600,3,8,1630,0,464000
5,2.5,1630,20750,4,7,1100,530,280000
3,2.5,1502,1400,3,7,1502,0,403000
3,2,1230,1613,3,8,1010,220,439950
4,2.5,2160,6825,3,8,2160,0,325000
4,1.5,1050,9516,4,7,1050,0,230000
2,2.5,1590,2088,3,9,1590,0,411000
3,1,2090,4755,3,8,1200,890,478500
2,2,1140,8400,2,7,1140,0,255000
3,2.5,1808,19200,3,8,1808,0,270000
2,1.5,1200,1259,3,8,1000,200,455000
4,1,2080,3500,5,7,1260,820,520000
3,2.5,2920,5629,5,8,1460,1460,1.02E+06
2,1,890,5423,3,6,890,0,391000
2,1,1160,5750,4,6,1160,0,208000
4,2,1680,5000,3,7,980,700,588000
1,1,1090,5250,3,6,980,110,375000
4,2.5,3160,6961,3,8,3160,0,697000
3,2,1710,10959,4,7,1030,680,488500
3,2.5,2360,12987,3,8,2360,0,750000
2,1,1220,17172,4,6,1220,0,370000
3,2.25,2130,12286,3,8,2130,0,534950
2,1.75,1260,5300,4,7,840,420,630000
3,2.5,1680,2801,3,7,1680,0,439000
4,2.5,3480,13421,3,11,3480,0,878000
4,1.75,2085,174240,3,7,1610,475,563500
4,1.5,1240,9600,3,7,1240,0,220000
4,2.5,2110,9825,3,8,2110,0,420000
2,1.75,950,15219,3,8,950,0,515000
4,2,2580,4500,4,9,1850,730,935000
5,2.75,2500,7140,4,7,1250,1250,530000
4,3,2760,4905,4,9,1840,920,1.34E+06
4,1.75,1560,7200,3,6,860,700,460000
2,1,980,3400,3,7,980,0,380000
2,3,2770,10800,5,8,1910,860,505000
4,2.25,2070,39446,3,8,1470,600,445800
4,1.75,2350,7574,3,8,1720,630,725000
4,2.75,2650,8610,3,8,2650,0,797000
3,1.5,1200,6240,3,8,1030,170,718500
3,2.75,2310,5200,4,7,1520,790,785000
4,2.5,1900,9075,3,7,1900,0,407500
2,1,1740,8100,3,6,1050,690,173000
3,2,2180,4976,4,8,1680,500,555000
4,2.25,2380,5250,4,7,1410,970,527000
4,3.5,4340,5500,3,10,2850,1490,1.28E+06
4,4,2290,6250,5,7,1690,600,661254
2,1,820,3844,4,6,820,0,300000
3,1,940,8400,3,7,940,0,229000
3,1.75,1560,6000,3,6,780,780,525000
5,1.75,1880,48787,3,6,1880,0,515000
3,2.5,1690,4584,3,7,1690,0,455800
3,2.75,2750,18029,5,9,1810,940,950000
2,2.5,1880,40575,3,9,1880,0,460000
4,2,1820,7626,5,7,990,830,605000
2,1.75,1510,851,3,8,1420,90,622500
3,2.75,3070,5280,3,7,2360,710,350000
3,2.25,2010,10760,3,8,2010,0,605000
3,1.75,1580,8820,4,7,1580,0,225000
4,2.5,2701,5821,3,7,2701,0,270000
3,2.75,1960,13252,5,8,1240,720,550000
3,1,1230,12201,3,7,1230,0,210000
3,2.5,2180,15693,4,8,1850,330,545000
3,2.5,2070,8581,3,8,2070,0,470000
3,2.5,1530,1116,3,7,1530,0,255000
3,1.75,1040,9000,4,7,1040,0,382500
3,2.5,3000,5000,4,7,2110,890,666000
2,1,720,7500,3,6,720,0,447000
3,2.5,2150,14092,3,8,2150,0,360000
3,2.5,2550,6677,3,8,2550,0,595000
2,1,1160,7500,4,7,1160,0,312000
4,2.25,2160,8119,3,8,1080,1080,440000
3,2.75,1780,15114,3,7,1080,700,315000
3,2.25,1590,9200,4,7,1110,480,225000
4,3,2300,7609,4,7,2300,0,224000
3,1,1430,13370,3,7,1430,0,394900
4,1,2080,5500,3,7,1040,1040,480000
4,2.25,2140,7701,4,7,1470,670,465000
2,1,990,5000,3,7,990,0,490000
3,1,1150,5120,4,6,800,350,420000
3,1.75,1260,9346,4,7,1260,0,200500
4,1.75,1700,14756,3,7,850,850,331500
5,1.75,1320,38125,4,7,1120,200,380000
3,2.5,2370,16455,5,7,1640,730,540000
3,2.25,1660,6000,3,7,1110,550,425000
3,2.25,1650,7739,3,8,1290,360,225000
3,1.75,1820,8400,3,7,1340,480,422800
3,1.75,1900,5000,5,7,950,950,615000
3,2.75,2030,6840,3,7,1210,820,360000
4,3.5,2730,5707,3,8,2000,730,489500
3,3.25,3230,7800,3,10,3230,0,1.78E+06
4,2.5,2420,18480,4,9,2420,0,1.49E+06
4,2.5,3160,11380,3,9,3160,0,645000
3,1,1000,10560,3,7,1000,0,140000
6,3,2890,2370,3,7,2290,600,799200
3,1.5,1280,974,3,7,1280,0,281000
6,3,2580,8064,3,7,1880,700,326000
4,2.5,2660,4082,3,7,2660,0,287000
4,2.5,2550,7200,3,7,2550,0,419500
4,2.25,1810,7601,3,7,1080,730,299950
3,2.5,1980,7309,3,7,1980,0,455000
4,2.5,3010,6100,3,9,3010,0,789500
3,2.5,2010,7200,3,8,2010,0,515000
4,4.25,5180,13077,3,12,4280,900,1.49E+06
5,1.75,2330,4947,4,8,1380,950,572500
6,2.5,2800,10490,3,7,1400,1400,442500
4,2.25,2640,8800,3,8,1620,1020,537000
5,2,3370,5000,4,7,2140,1230,762000
3,1,1150,10000,3,6,1000,150,241000
4,2.75,3010,15750,4,8,1560,1450,482000
2,1,1880,7560,3,6,940,940,280000
4,1.5,1540,7300,3,7,1540,0,260000
3,1,1300,8800,3,7,1300,0,326188
2,1,910,9869,3,6,910,0,223000
3,2,1770,14400,4,8,1770,0,381000
4,2.5,1450,3600,3,7,1250,200,431000
4,1,1740,8100,4,7,1020,720,260000
4,2.5,2060,5607,3,7,2060,0,343888
4,2.5,3480,59242,3,11,3480,0,810000
4,1,1390,4240,3,7,1050,340,657100
2,1.5,1068,1452,3,7,1068,0,239950
6,1.75,2920,5000,4,9,2780,140,823000
3,3.5,2420,4000,5,9,1820,600,740000
3,1.5,1450,9477,4,7,1450,0,240000
2,1,800,3000,3,6,800,0,299950
5,2,2940,5500,4,9,2340,600,950000
4,2.5,1981,4828,3,8,1981,0,299999
4,2.25,2550,9736,4,8,2550,0,315000
5,3.5,3450,19080,3,9,3450,0,525000
3,2.5,1460,1613,3,8,1180,280,544000
3,1.75,1410,4080,4,7,1410,0,541000
2,1,1240,42247,4,7,1240,0,825000
2,2.5,1950,2162,3,9,1500,450,500000
4,2.5,1912,5000,3,8,1912,0,353000
4,3.25,3750,74052,3,10,3750,0,1.18E+06
3,1.5,1830,217800,3,7,1010,820,505000
4,2,1940,6350,4,7,970,970,446000
3,1,1650,6400,4,7,980,670,371500
3,2.5,1960,7200,4,8,980,980,635000
2,1,1220,10170,3,7,980,240,443000
4,2.5,2450,7700,3,8,1250,1200,715000
3,2.25,2390,7000,4,7,1990,400,270000
3,3.5,3020,4082,3,9,2080,940,910000
4,3,2170,8240,4,8,1370,800,592500
2,1,980,1179,3,8,980,0,438000
3,1.75,2130,6360,3,7,1720,410,495500
4,1.75,2520,7770,3,8,1680,840,525300
3,1.5,1590,21600,4,7,1590,0,251000
2,1,1960,186872,4,6,1960,0,305000
4,2.25,3020,11489,5,10,2110,910,1.90E+06
5,2.5,2100,14858,5,8,2100,0,375000
2,1,1240,7590,4,7,1040,200,359950
3,2,1780,5720,5,7,980,800,680000
6,2.75,2940,7350,3,8,1780,1160,315000
3,2.25,2230,13100,4,8,1510,720,491500
4,2.5,3520,12193,4,10,3520,0,905000
3,2.5,2420,7307,3,7,2420,0,482000
3,2.5,3590,8400,3,9,2950,640,1.33E+06
4,2.25,1710,7000,4,7,1040,670,450000
3,2.25,1940,9100,4,8,1630,310,299000
3,1.5,1080,9774,3,7,1080,0,218250
4,4,2530,1774,3,9,2100,430,1.12E+06
3,1,1480,6750,3,7,1480,0,250000
4,2.5,1910,5000,3,7,1910,0,297500
4,2,2520,6000,3,8,1400,1120,875000
2,1,1100,4000,3,7,1100,0,570000
4,2.5,2990,5669,3,8,2990,0,655000
3,1.75,1350,155073,4,7,1350,0,385000
5,4,1400,8580,5,7,900,500,265000
3,2.5,2350,7035,3,8,2350,0,613500
3,1,1510,5000,3,7,1510,0,545000
4,2.5,2340,8990,3,8,2340,0,314000
6,3,3300,4218,3,8,2200,1100,920000
4,2.5,2840,11044,3,8,2840,0,585000
4,2.75,3190,19513,4,10,3190,0,2.13E+06
3,2,1840,2825,3,7,1040,800,750000
2,1.75,1550,7764,4,8,1550,0,600000
4,2,1830,10416,3,7,1370,460,245000
4,2.25,2270,10000,5,8,1720,550,596000
3,1.5,1220,1086,3,8,1220,0,306000
3,2.25,2850,6281,4,7,1900,950,907500
4,2.5,2080,7966,3,7,1200,880,480000
4,2.25,2130,8734,4,8,2130,0,802000
3,1,1010,7633,4,6,1010,0,225000
4,2,1470,8395,4,7,1470,0,445000
3,1.75,2300,35722,3,9,2300,0,520000
4,1,1620,4329,3,7,1620,0,415000
2,1.5,2210,5000,3,8,1530,680,850000
4,3.5,4340,217800,3,11,4340,0,1.19E+06
3,1.75,1540,6632,3,7,1070,470,284200
5,1,1460,6032,4,6,1460,0,239950
3,1.75,1190,4500,3,6,1190,0,515000
3,1,910,7194,4,7,910,0,182500
4,2.75,2500,10330,4,8,1380,1120,525000
4,2.5,2180,4000,3,8,1700,480,607010
4,1.75,1960,7945,4,7,980,980,395000
3,2.5,2620,14248,4,8,1830,790,680000
4,2.5,2730,4847,3,9,2730,0,649000
4,3,2570,262018,3,7,1420,1150,390000
3,3,2480,45302,4,8,1620,860,610000
3,2,1490,8847,4,7,1490,0,335000
4,1.75,1650,7775,4,7,1150,500,475000
2,1,1170,4080,4,7,1170,0,581000
2,1,830,4045,3,6,830,0,150000
3,2,1840,8580,3,8,1840,0,380000
3,1,880,18109,4,6,880,0,105000
4,2.25,2440,9889,3,7,1540,900,805000
4,2,1650,9305,4,6,1650,0,334009
2,1.5,940,1768,3,7,940,0,362500
3,2.25,2550,8588,3,9,2550,0,490000
3,1,960,10761,4,6,960,0,193000
4,2.5,2250,4495,3,7,2250,0,292500
4,2.5,2440,14470,4,9,1660,780,699000
2,1,1150,3600,3,6,1150,0,270000
3,1,950,7620,3,6,950,0,137000
2,1.5,1030,798,3,8,1030,0,326000
3,2.25,2390,7875,3,10,1980,410,1.19E+06
4,2.5,2150,3143,3,7,2150,0,435000
3,2.25,1670,1396,3,9,1250,420,631000
3,1.75,2080,5000,5,8,2080,0,825000
3,2.5,2153,4400,3,8,2153,0,259000
3,3,2640,5978,3,9,2640,0,535000
3,1.5,1120,8366,3,7,1120,0,205000
2,1,710,7120,5,6,710,0,285950
3,1.5,2030,14400,4,7,1310,720,250000
5,4.5,4340,5722,3,10,4340,0,2.95E+06
3,1,1160,8320,4,7,1160,0,201500
3,2.5,1520,1304,3,8,1180,340,438000
2,1,1430,5000,2,7,1430,0,455000
5,1.75,2590,6720,4,7,1750,840,334000
4,2.25,2080,7700,3,7,1450,630,300000
3,1.75,1950,8480,4,8,1250,700,615000
4,2.5,2450,12987,4,9,2030,420,836000
4,2.5,3180,11652,3,9,3180,0,850000
3,2,2590,14052,5,8,1720,870,487000
4,2.5,2240,14667,4,9,2240,0,565000
3,1,1170,8816,4,6,1170,0,207500
4,1,1500,11050,5,7,1500,0,255950
3,3.25,1410,1442,3,8,1360,50,358000
1,1,1230,3774,4,6,830,400,415000
5,3.25,4130,7197,3,10,4130,0,995000
2,1,1080,3420,4,7,780,300,550000
3,1.5,1180,1231,3,7,1180,0,435000
3,1,1240,6195,3,6,1240,0,230000
6,4.5,3902,3880,4,9,2782,1120,1.30E+06
4,2.5,1950,8628,3,8,1950,0,348450
4,2.25,1970,7200,3,8,1970,0,285000
4,2.75,3130,9711,3,9,3130,0,649000
3,1.75,1490,1036,3,10,1090,400,520000
2,1,1080,5000,3,7,1080,0,325000
4,2.5,3710,15935,3,10,2130,1580,485000
4,2.25,1730,8400,3,7,1730,0,250000
4,2.5,2920,14210,4,10,2920,0,795000
5,3.25,3510,10930,3,9,3510,0,1.01E+06
4,2.75,1960,4635,4,7,1000,960,575000
3,2,1690,10062,5,7,940,750,356200
3,2,2090,42689,3,7,2090,0,499000
4,2.25,3040,12160,4,7,1520,1520,598780
3,2.5,2940,15875,3,10,2940,0,780000
4,2.75,1540,4840,4,7,850,690,450000
4,3.5,3200,3250,3,9,2670,530,795000
3,3,3530,8345,3,10,3530,0,600000
4,2.25,2220,8872,4,8,1110,1110,495000
4,2.75,3090,6600,3,9,1800,1290,1.11E+06
1,1,1220,12426,4,6,1220,0,325000
4,2.75,2370,7320,3,7,2370,0,310000
3,1.5,1810,3880,4,8,1310,500,585000
5,3.5,3160,5175,3,9,3160,0,660000
5,2.5,3860,42733,4,8,2300,1560,430000
3,1.5,1310,2998,3,7,1310,0,325000
3,1.75,1200,8631,3,7,1200,0,205000
3,1,1020,11652,4,6,1020,0,216500
4,1.75,2010,12044,3,9,2010,0,627800
2,1,920,7688,3,6,920,0,275000
3,1,1790,11884,3,7,1790,0,260000
3,1.75,1720,223377,3,7,1240,480,439950
3,1,1250,10200,3,6,1250,0,225000
2,1,1620,9855,3,8,1320,300,700000
4,2,1450,8400,4,7,1450,0,440000
4,2.5,3250,4500,3,8,3250,0,519000
3,1.75,1270,4815,3,6,980,290,259000
3,2.5,1670,5090,3,7,1670,0,348000
4,2.5,2560,10400,4,7,1280,1280,440000
4,2.5,2400,7351,3,9,2400,0,650000
4,3,3620,403693,3,9,3620,0,495000
3,1,1040,8970,4,6,1040,0,210000
2,1,1470,6000,3,6,900,570,415000
4,3,1986,6000,4,8,1746,240,715000
5,2,1540,9629,4,7,1540,0,302000
2,1,1040,3200,3,7,1040,0,580000
4,1.5,1780,3120,3,8,1780,0,705000
2,1.75,1560,1750,4,6,780,780,494400
5,1,1880,3774,3,6,1360,520,340000
3,1,1250,20040,3,7,1250,0,318000
2,2.5,2300,6984,3,8,2300,0,665000
4,1.75,1670,13125,5,8,1670,0,697000
3,2.5,2370,3239,3,8,1950,420,475000
4,1,1730,7350,4,6,1730,0,267950
3,1,780,3540,2,6,780,0,180000
3,2.75,2810,18731,4,10,2810,0,1.70E+06
5,5.5,5190,12637,3,11,5190,0,925000
5,3.25,3800,15500,3,7,2490,1310,380000
3,1.75,2090,7505,3,7,2090,0,424950
3,1,1080,6000,4,7,1080,0,275000
3,2.25,1550,1469,3,8,1550,0,430000
4,2.5,3470,32109,3,10,3470,0,875000
4,2,1350,942,3,7,1350,0,288790
4,2.5,2620,16200,4,7,1570,1050,968060
3,2.5,3350,4007,3,8,2550,800,635000
4,2,1910,2874,3,7,1060,850,493000
3,1.75,2092,250905,3,7,2092,0,390000
3,1,1600,5001,5,6,1080,520,355000
3,1.75,1890,100623,3,8,1890,0,550000
4,2.75,3220,16145,3,10,3220,0,689000
4,1.75,1860,9364,3,7,1080,780,477500
3,2.25,2280,8500,4,7,1680,600,419950
3,2.25,1840,9929,3,7,1200,640,350000
4,4,3770,9750,4,9,1940,1830,872000
3,2.5,2980,7202,3,8,2980,0,817250
4,1.75,2410,6770,4,7,1220,1190,625000
4,2,2370,76665,4,8,2370,0,411000
2,1,1410,5650,3,6,1410,0,260000
4,2.5,1914,3150,3,8,1914,0,305000
3,2,1400,7384,3,7,1150,250,295000
3,1,1020,6903,3,7,1020,0,410000
2,1.5,1160,2158,3,7,1160,0,289000
3,2.25,1480,5400,4,8,1480,0,600000
3,1.75,1220,7447,4,7,1220,0,698000
3,1.75,1470,6682,3,7,1470,0,400000
4,2.75,3030,6625,3,8,3030,0,525000
3,2.5,1600,6315,3,8,1600,0,287000
4,2.75,2090,13500,4,8,2090,0,830000
4,2.5,2380,9362,3,8,2380,0,340000
5,3,2350,6480,4,7,1650,700,805000
4,2.5,1830,8601,3,7,1830,0,339000
3,1.5,1610,13500,3,7,1060,550,390000
3,1,960,4560,4,7,960,0,290000
3,2.5,2250,8300,3,8,2250,0,595000
6,5,7100,18200,3,13,5240,1860,3.20E+06
3,1,1620,5040,3,7,1120,500,333000
3,1.75,2550,6117,3,9,1650,900,1.19E+06
4,3.25,3090,67518,3,10,3090,0,844000
7,3.5,3890,8342,3,9,2840,1050,1.19E+06
3,2.5,3430,28718,3,10,3430,0,1.20E+06
2,1,1240,9900,3,7,940,300,170000
3,2.75,2980,12600,3,8,1590,1390,900000
3,1.75,1830,10000,4,7,1830,0,360000
3,2.5,3060,7831,3,9,3060,0,650000
4,1,1560,7980,4,7,1170,390,552500
4,2.5,3300,10764,4,9,1720,1580,765000
4,2.75,2475,4000,3,7,2475,0,335900
4,2,1400,7632,5,6,1400,0,246000
3,1.75,2650,7500,4,7,1590,1060,415000
4,1,1630,2566,3,7,1630,0,581000
4,2.75,3390,6298,3,9,3390,0,859900
3,1,1500,5750,4,7,1050,450,530000
4,2.75,1830,6643,3,8,1830,0,250000
2,1,910,4301,4,7,910,0,570000
3,1.75,1230,13056,4,7,1230,0,175000
4,2.5,3430,10157,3,10,3430,0,740000
2,1,820,10270,3,7,820,0,150000
3,2,1940,5820,5,7,1150,790,665000
3,2,1420,4080,5,8,1420,0,764000
4,3.25,4010,13797,3,11,4010,0,972000
3,1.75,1810,10625,3,8,1370,440,517500
3,1.75,1790,5120,4,6,940,850,335000
4,2.75,2210,10800,4,8,1170,1040,516000
3,2.5,1670,3980,3,8,1670,0,475200
4,2.75,2390,9650,3,8,1620,770,379750
4,1.75,1600,7400,3,7,1210,390,525000
3,2.5,2920,169448,3,9,2920,0,550000
3,2.5,1700,6200,3,8,1700,0,262000
2,1,1170,5043,3,6,880,290,324800
4,2.5,3030,7864,3,9,3030,0,685000
3,1,1980,39150,3,6,1580,400,308000
3,2,1320,1297,3,7,1320,0,385000
4,5.75,7220,223462,3,12,6220,1000,1.94E+06
3,1,990,10800,4,6,990,0,207000
4,3.5,3570,27699,3,11,3570,0,910000
2,1,1120,6180,4,7,1120,0,546000
2,0.75,900,3527,3,6,900,0,230000
4,2.25,2360,11523,4,10,2360,0,957500
3,1.75,1430,9750,5,7,1430,0,429950
2,1,1060,6050,3,7,940,120,325000
4,2.5,2150,5397,3,8,2150,0,400000
3,2.5,3100,20553,3,10,3100,0,930000
4,3.25,3900,40962,3,10,3900,0,780000
2,1.5,720,4346,4,6,720,0,287000
4,2.25,1870,4198,3,7,1870,0,313999
3,2,1570,6300,3,7,820,750,468000
5,2.5,2760,6000,3,8,2760,0,300000
3,2.75,2170,7900,4,8,1380,790,296500
3,2.25,3420,9900,3,9,1710,1710,692500
4,3,2120,7650,3,8,2120,0,295000
4,3.75,4420,9492,3,9,3420,1000,925000
4,2.5,2400,4596,3,8,2400,0,280000
3,1,960,5750,3,7,960,0,490000
3,2.75,2340,16500,4,8,1500,840,563000
4,2.5,2570,50308,3,10,2570,0,800000
4,2.25,2280,7500,4,7,1140,1140,335000
4,2.5,2490,7694,3,8,2490,0,700000
4,2.5,2800,4687,3,9,2800,0,399000
3,2.5,1427,4337,3,7,1427,0,260000
3,2.25,1370,6000,4,7,1370,0,287000
5,4.25,4830,8050,4,11,3710,1120,1.93E+06
7,2.5,2580,5750,4,7,1880,700,599000
4,1.75,1900,8250,4,7,950,950,542000
3,2.5,2210,6280,3,8,2210,0,359950
3,1,1060,9525,3,7,1060,0,349950
2,1.5,1750,19709,4,8,1440,310,575000
4,3.5,3130,5000,3,10,3130,0,1.01E+06
4,2.5,3360,11637,3,11,3360,0,420000
4,2.5,2410,7846,3,8,2410,0,334950
3,2.25,1850,7923,4,7,1150,700,461000
4,2.5,3560,5265,3,8,3560,0,882566
4,3.5,3820,17745,3,8,2440,1380,550000
3,2.5,2460,4399,3,7,2460,0,440500
3,2.5,3040,6255,3,7,3040,0,340000
2,1,1050,8750,4,7,1050,0,800000
3,2,1750,9000,4,5,1750,0,325000
2,1.75,1330,2159,4,8,1330,0,202200
3,2,1380,4800,3,7,1380,0,640000
4,2.5,5730,44947,3,11,4280,1450,1.23E+06
3,2,2350,5700,4,8,1810,540,770000
2,3.25,3570,392475,3,9,2370,1200,835000
3,1,1160,9180,3,7,1160,0,315000
2,1.5,920,1458,3,7,920,0,265000
5,3.5,3440,6037,3,9,3440,0,598992
4,2.5,2620,10016,3,8,2620,0,565000
3,1,870,8040,3,7,870,0,276000
4,3.5,3170,3858,3,8,2530,640,495000
3,2.5,3040,6054,3,9,3040,0,410000
3,3.75,3150,8550,3,10,3150,0,1.90E+06
2,1,1160,5029,3,7,910,250,605125
3,1,960,4600,4,6,960,0,457500
3,1.75,1610,22496,4,7,1610,0,338950
4,1.5,1840,11367,4,7,1840,0,415000
5,1.75,2030,12342,4,7,2030,0,470000
4,2.5,2820,6120,3,9,2820,0,897000
3,1,2050,4800,3,8,1950,100,1.03E+06
2,1,800,5000,3,6,800,0,414000
3,2.5,2100,5112,3,8,2100,0,499900
4,2.5,2560,8780,3,9,2560,0,642000
2,1,830,6030,4,6,830,0,425000
3,2.25,2020,8379,3,7,2020,0,328000
4,2.5,1710,3500,3,7,1710,0,282900
3,2,2380,17950,4,8,2110,270,550000
4,2.5,2320,4683,3,7,2320,0,305000
2,2,1780,3810,3,7,980,800,691000
3,1.5,1320,8100,4,7,1320,0,500000
3,2.5,2060,4730,4,8,2060,0,624950
4,1,1430,4080,3,7,1430,0,667750
4,2.5,2440,22594,3,8,2440,0,565000
4,3.5,4170,4524,3,9,3500,670,623300
3,2,1700,8448,3,7,1700,0,245000
4,2.25,1677,3600,3,7,1677,0,281000
4,2,1730,5500,5,7,1010,720,360000
5,3,3290,14134,3,7,1870,1420,695000
4,1,2150,3588,4,8,1850,300,810000
3,1.5,1830,12233,4,5,1830,0,212000
3,2.5,2910,10044,4,10,2910,0,1.40E+06
3,2,2330,8000,3,7,1390,940,270000
3,1.75,1780,4500,4,7,920,860,625000
5,2.25,2340,9225,3,8,2340,0,572000
3,2.5,2760,17377,3,9,2760,0,545000
3,2.25,1330,8004,3,7,1330,0,375000
3,1,1020,10200,4,7,1020,0,335000
5,2.5,3050,8200,4,8,1650,1400,1.03E+06
3,2.25,2300,8067,4,8,1300,1000,615000
3,2.25,2080,4252,3,7,1550,530,270000
4,1.75,2310,8045,4,7,1650,660,319950
5,1.75,2510,9750,3,8,2510,0,570000
4,2.5,3560,15450,5,8,2060,1500,1.28E+06
5,1,1700,11727,4,7,1700,0,539000
5,3.5,2800,5120,3,9,2800,0,345600
2,1,720,7200,5,6,720,0,199000
4,3.25,3950,10912,3,10,3950,0,1.78E+06
3,2,1900,8100,4,7,950,950,520500
3,2.5,2790,16173,3,10,2790,0,445000
2,1,1150,7552,3,7,1150,0,349000
3,1,1250,10723,4,7,1250,0,310000
4,3.25,3910,7500,3,10,3910,0,1.65E+06
3,2.25,1230,11601,4,7,910,320,273000
4,1,1360,13372,3,7,1360,0,330000
5,3,4480,5000,5,12,3420,1060,1.99E+06
2,1,810,8382,4,5,810,0,125000
4,3,2793,5703,3,9,2793,0,421500
3,2.5,2849,9588,3,10,2849,0,798000
4,1.75,2100,3000,4,7,1500,600,640000
3,2.5,3210,8630,4,10,2530,680,870000
3,2.5,1300,812,3,8,880,420,329950
4,2.5,2200,5730,3,8,2200,0,299900
4,3.25,4140,20734,3,10,3300,840,2.40E+06
4,3.25,3160,5000,5,9,2360,800,1.25E+06
3,2.5,1370,9253,3,7,1090,280,288000
4,2,1560,7104,3,7,1140,420,537000
3,1.5,1340,7391,4,7,1340,0,245000
3,1.5,1090,10454,3,6,1090,0,200000
2,2.25,1610,2040,4,7,1610,0,215000
3,1,1210,3328,4,7,1210,0,529000
4,3,3570,10273,3,9,2630,940,895000
2,2,1510,3961,3,8,1510,0,485000
2,1.75,1250,1208,3,7,1040,210,349000
2,1.5,1920,3408,4,7,960,960,517000
3,2.5,1870,9135,3,7,1250,620,502000
3,2.5,1620,2930,3,8,1620,0,334950
3,1.75,1830,11788,3,8,1430,400,373000
4,2.75,3260,4900,3,9,3260,0,565000
4,1.75,2260,7005,4,7,1130,1130,648360
3,1,1200,6250,3,6,920,280,280000
3,1,1100,5000,3,7,1100,0,249900
4,2,1220,9100,4,7,1220,0,230000
3,1.5,1600,10548,4,7,1600,0,220000
3,1,980,6800,3,6,980,0,144000
3,3.5,3240,23522,3,10,2130,1110,902500
3,2.25,2210,22040,5,8,1510,700,635250
4,2.5,2331,3826,3,8,2331,0,345000
3,1.5,2260,5300,3,7,1200,1060,440000
4,2.25,3310,127631,5,9,3310,0,1.14E+06
3,1,1230,2353,4,6,1230,0,240000
4,2.75,3390,16153,4,7,1970,1420,350000
4,3,2240,8504,3,7,2240,0,337000
3,2.5,2790,48994,4,9,2790,0,450000
3,2.5,2780,33503,4,8,2110,670,1.14E+06
5,3.25,3160,10587,5,7,2190,970,620000
3,2.75,1890,3938,3,8,1890,0,475000
3,1,1220,7876,3,7,1220,0,348580
3,2.25,2400,16301,3,8,1400,1000,595000
2,2,1440,213008,4,7,1440,0,430000
3,1.5,960,7400,3,7,960,0,237000
3,2.5,1700,2250,3,7,1700,0,268000
3,1,1060,7473,3,7,1060,0,235000
6,2,2350,6554,3,8,2000,350,400000
3,2.25,2080,50965,3,8,1590,490,460000
4,2,1520,6200,3,7,1520,0,640000
3,1,1010,10800,4,7,1010,0,290000
3,1.5,1340,6500,3,7,1340,0,387000
6,2.25,2660,13579,3,7,2660,0,730000
3,2,2410,13300,3,9,1840,570,822000
5,3.5,3200,43560,3,7,3200,0,499950
3,2.75,3890,7216,3,8,3260,630,1.08E+06
2,1,880,6650,5,6,880,0,416000
4,2.25,2140,8874,3,8,2140,0,329950
3,2.5,2300,6009,3,8,2300,0,738500
4,2.5,3890,34513,3,10,3890,0,775000
2,1,960,5000,3,6,960,0,212625
3,2,1650,7930,4,7,1650,0,251000
3,2.25,2170,15000,4,8,2170,0,439950
2,1,730,5040,3,6,730,0,316000
3,2.25,1470,5597,3,7,1470,0,468000
3,2,2860,24046,3,9,1700,1160,289275
3,2,1970,4166,5,8,1270,700,550000
3,2.25,1410,1377,3,7,1290,120,377500
3,1.75,1690,8901,3,7,1690,0,199500
2,1.5,1140,14373,3,7,1140,0,262500
4,1,1390,10800,4,7,1390,0,417500
4,1.75,1700,9000,3,7,1700,0,423000
4,2,1920,7803,3,7,1080,840,360000
4,2.5,2570,22215,5,7,2570,0,390000
3,2.5,2370,5353,3,8,2370,0,429900
4,2.25,1890,8034,4,8,1890,0,521000
3,2.25,2230,4551,5,8,1450,780,439000
3,3.5,3110,14872,3,10,3110,0,2.26E+06
3,2.5,2510,5503,3,9,2510,0,820000
4,2,1700,8043,3,7,850,850,161000
3,1.5,1960,4080,3,7,1960,0,640000
2,1.5,1330,15873,3,7,900,430,440000
3,2.5,1880,4668,3,8,1880,0,509950
4,3,3320,13500,3,7,1750,1570,302000
3,2.5,2210,7620,3,8,2210,0,535000
4,2.5,3330,8897,3,10,3330,0,936000
4,2.75,2020,7070,5,7,1010,1010,513000
4,2.25,2380,7400,4,8,1760,620,319000
2,1,740,6460,3,6,740,0,178500
3,2.5,2170,5000,3,9,2170,0,638000
4,2.5,3181,5831,3,8,3181,0,379900
5,3.5,2880,3750,3,8,2270,610,830000
4,2.75,2475,4276,3,7,2475,0,319900
2,1,1330,92782,2,6,1330,0,455000
2,1,950,3090,4,6,950,0,330000
3,3.5,4360,6240,3,10,2960,1400,1.56E+06
4,2.75,3650,4534,3,7,2940,710,550000
2,1,1380,9251,3,7,1380,0,319900
3,1.75,1590,11454,4,8,1590,0,417000
3,1.75,2060,7251,3,7,1350,710,290000
3,1,1040,8000,4,7,1040,0,250000
3,2.5,1800,3253,3,7,1800,0,300000
3,2,2560,14680,3,8,1330,1230,599000
3,1.5,1690,10250,4,7,1690,0,330000
4,2.5,2542,6120,3,8,2542,0,359950
6,2.5,3080,8163,3,7,1580,1500,300000
3,2,1530,6773,4,8,1530,0,595000
4,1.75,1440,6720,5,6,720,720,285000
3,1.75,2000,10182,5,7,1400,600,560000
3,2.75,1050,7200,3,7,1050,0,473000
4,2.5,3830,11972,3,11,2370,1460,1.85E+06
4,2.5,3120,8792,4,9,3120,0,760000
4,2.5,2800,28254,3,9,2800,0,440000
3,1,1130,8100,3,6,1130,0,272000
3,1,1270,8000,4,6,1270,0,475000
0,0,290,20875,1,1,290,0,142000
3,2,1460,7860,5,7,1460,0,480000
4,2.5,2980,12534,3,9,2980,0,515000
2,1.5,990,1380,3,7,990,0,285000
3,2,1900,7980,4,7,1340,560,235000
4,2.5,2400,6811,3,8,2400,0,456500
2,1,880,5750,3,6,880,0,280000
2,2,1920,6045,3,8,1920,0,554000
2,1,900,5160,3,6,900,0,219000
4,3.25,7000,28206,4,12,3500,3500,3.20E+06
3,1,1180,3600,3,7,1180,0,630500
3,1,1070,6109,5,7,1070,0,337000
4,1.5,2220,4000,3,8,1970,250,785000
4,3.5,2710,14016,4,8,2710,0,502700
3,2.5,2270,100545,3,8,2270,0,585000
3,2.5,1600,4271,3,7,1600,0,245000
3,2.5,1940,4927,3,8,1940,0,335000
2,1.75,1060,16470,3,7,1060,0,356000
4,2.5,2830,8399,3,9,2830,0,680000
5,3.5,3990,5000,3,8,2910,1080,740000
4,1.5,2040,10726,3,7,1380,660,385000
3,1.5,1270,5112,3,7,1270,0,465000
4,3,2550,3784,4,8,1750,800,850000
3,1.75,1610,144619,3,7,1610,0,425000
5,2.75,1540,4000,3,7,1140,400,357000
4,2.5,3540,9349,3,10,3540,0,899000
4,2.5,2030,9095,4,7,1130,900,405000
3,2.5,2460,138085,4,9,2460,0,605000
2,1.75,1650,4000,4,7,950,700,355000
3,3,3030,35123,4,8,1760,1270,599900
2,1,1020,47044,5,7,1020,0,279000
3,1,1220,13000,4,7,1220,0,300000
2,1.75,1910,12142,3,9,1910,0,435000
3,2,1610,8069,5,7,1090,520,545000
5,2.5,2630,9216,3,8,2630,0,525000
4,2.5,2520,6023,3,9,2520,0,610685
4,3.5,3910,8095,3,9,3130,780,782000
3,2,2420,8800,4,7,1420,1000,298500
2,2.25,1100,1114,3,8,900,200,574000
2,1,860,7102,3,6,860,0,340000
3,2.25,1481,2820,3,7,1481,0,250000
3,2.5,2200,11000,3,9,2200,0,580000
1,1,1120,11800,3,7,1120,0,309950
3,2.25,2070,7995,3,7,1350,720,329950
5,3.5,4140,6770,3,9,3030,1110,825000
2,1,1090,9994,3,7,1090,0,196700
3,2.5,1070,1089,3,7,900,170,386950
2,1.75,1310,3816,2,7,1110,200,505000
3,2,1140,7078,4,7,1140,0,257500
3,2.5,1230,23522,4,7,1230,0,425000
3,2.5,1910,4488,3,8,1910,0,617000
5,1,1790,30456,4,7,1350,440,346000
3,2,1320,8568,3,7,1320,0,256500
7,3,2800,9569,3,7,1400,1400,350000
4,2.5,2870,12648,4,9,2870,0,720000
3,2.25,1190,13630,3,7,1190,0,445000
2,1,1070,6678,4,7,1070,0,335000
3,1.75,1900,6334,3,8,1450,450,770000
3,2.25,1370,1007,3,8,1330,40,524000
2,2.5,1740,2500,3,8,1210,530,650000
3,2.5,1640,1269,3,8,1640,0,579000
3,2.75,1740,5639,3,7,1740,0,280000
2,1,1150,12775,4,6,1150,0,825000
3,2,1350,8960,4,7,1350,0,237500
3,2,1500,5200,3,7,1060,440,250000
3,1.75,1570,8400,4,7,1570,0,439995
3,2,1600,10318,3,7,930,670,385000
3,1,1220,71191,3,6,1220,0,223000
3,2,2020,8555,4,7,1220,800,458000
2,1,710,6960,4,6,710,0,216500
2,2.75,2810,11205,3,7,1510,1300,450000
4,2.75,2680,8500,4,9,1480,1200,1.24E+06
5,2.5,2870,4712,3,9,2870,0,760369
4,2.5,2500,4000,3,8,2500,0,635000
5,3.5,3180,14000,5,10,3180,0,760000
6,4,3180,6551,3,9,3180,0,859950
2,2,1900,7740,4,7,1150,750,450000
4,1.5,3160,19745,4,6,1840,1320,335000
4,2.25,4250,16940,4,9,2380,1870,1.53E+06
4,1.5,1720,6417,3,7,1720,0,360000
5,2.5,4570,19252,5,10,4570,0,1.48E+06
3,2.75,2770,10000,5,8,1640,1130,678000
3,1.75,1700,8400,3,8,1460,240,750000
3,2.75,2020,10744,5,7,1270,750,519000
3,2,1510,3657,3,8,1510,0,420250
5,3.5,2880,10000,3,8,1980,900,439000
3,2.25,2160,7964,3,8,2160,0,273000
3,3.25,1730,1229,3,9,1320,410,645000
3,1.75,1560,5950,4,6,780,780,385000
3,2.5,1610,1246,3,9,1080,530,659950
5,1,2590,4652,4,8,2310,280,890000
4,2.5,3000,6892,3,8,3000,0,585000
4,3,2830,213879,4,8,2830,0,549900
2,1,1030,12350,3,7,1030,0,397000
4,2.5,3560,46644,3,11,3560,0,896000
4,3.5,3990,11270,3,9,2930,1060,609000
3,2.5,2020,4845,3,7,2020,0,353500
4,1.75,1980,9000,2,7,1480,500,213000
4,1.75,1700,20283,3,7,1340,360,400000
3,2.5,2720,8622,3,8,2720,0,420000
4,5,5820,13906,3,11,3750,2070,784500
5,3.5,4090,290980,3,11,2920,1170,1.29E+06
4,2.5,2710,9248,3,7,2710,0,540000
6,2.25,3140,10250,4,8,1570,1570,740000
4,2.5,2450,4080,4,8,1490,960,793000
4,3.5,5360,25800,3,9,3270,2090,700000
2,1.5,1300,7632,3,7,1300,0,750000
2,1,1350,10096,4,7,1350,0,276900
4,2.5,2520,9604,3,9,2520,0,372000
3,2.25,3070,9645,3,10,2110,960,1.20E+06
4,2.5,3420,9575,3,11,3420,0,965000
3,2.5,2580,13096,3,9,2580,0,802000
4,2.25,2020,85813,3,7,2020,0,490000
2,1,940,8384,3,5,940,0,121800
3,2.5,2150,8060,3,8,2150,0,569000
3,2.25,1550,5401,3,7,1550,0,350000
3,2.5,1940,10035,4,8,1940,0,480000
4,2.5,3500,9198,3,9,3500,0,790000
4,2.5,3430,42775,3,10,3430,0,829950
3,1.75,1510,11120,4,8,1510,0,490000
3,0.75,920,20412,5,6,920,0,530000
4,2.5,2210,17715,3,8,2210,0,360000
5,3,3480,6625,3,8,3480,0,590000
3,1,1520,10227,4,6,1520,0,650000
5,2.5,3490,18850,4,9,1840,1650,915000
3,1,1170,6134,4,7,1170,0,209977
4,2,1590,10331,4,7,1590,0,414050
3,2,1540,8400,3,7,1180,360,529950
3,2.5,2680,5539,3,8,2680,0,459990
3,1,860,1664,3,7,860,0,399900
3,2,1610,7575,4,7,1110,500,197400
2,1,810,6697,4,6,810,0,194900
4,1.5,2993,19400,4,7,2233,760,540000
5,3,2710,4200,3,7,1890,820,925000
3,1.75,2150,13789,4,8,1610,540,450000
2,1,1740,3622,4,7,950,790,315000
4,3.25,4360,210254,3,10,2320,2040,890000
4,1.75,2550,39460,3,8,1890,660,550000
3,1.75,1480,7830,3,7,1480,0,237500
4,3.5,3400,5196,3,9,3400,0,660000
3,3,1660,1849,3,9,1660,0,716000
2,1,820,4206,3,5,820,0,489950
4,2.5,3240,3600,3,9,2060,1180,1.22E+06
3,1.75,1810,10800,5,8,1210,600,387000
4,2.5,2500,4750,3,8,2500,0,300000
3,1.75,1840,7350,3,8,1370,470,585000
4,2.5,2710,6937,3,7,2710,0,544999
3,2.25,1410,7290,3,7,940,470,240000
4,1.5,1170,6240,4,6,1170,0,525000
2,1,670,10920,3,6,670,0,240000
3,3.25,1450,1387,3,8,1180,270,320000
3,1,1300,3600,3,7,1300,0,819000
3,2.5,1330,2183,3,8,1330,0,539950
3,1.5,1090,9862,3,8,1090,0,382500
3,1,1110,6000,5,7,1110,0,589000
3,2,1560,7352,3,6,1560,0,196440
3,2,1710,4697,5,6,1710,0,233000
3,1.5,1070,9331,3,6,1070,0,220000
5,3,2730,6000,3,8,1470,1260,440000
4,1.5,1600,6180,3,6,1600,0,425000
3,2.25,2560,41346,3,10,2560,0,658588
3,1.5,1590,8256,3,7,1090,500,284850
4,2.25,2600,10660,4,8,2600,0,817000
5,1.75,1570,3000,4,7,1570,0,530000
4,3.5,2530,3000,3,8,1850,680,382000
3,1,1690,4250,3,7,1020,670,269000
4,2.5,2310,6650,3,8,2310,0,422000
3,1.75,1410,1197,3,8,1410,0,500000
3,2.5,2430,10500,3,9,2430,0,1.03E+06
3,2.5,1740,1279,3,8,1740,0,568000
2,1.5,1556,20000,4,7,1556,0,221700
2,1,1280,12500,3,7,1060,220,281000
4,1,1290,5000,3,7,1290,0,249950
3,1,1200,5252,3,7,1200,0,427000
4,2.75,2610,8967,4,8,2610,0,372000
2,1,1100,4010,5,6,1100,0,300000
4,3,4060,35621,3,9,2030,2030,404000
3,1.75,1580,20588,3,8,1580,0,625000
3,1.75,1090,7200,3,7,1090,0,345000
3,1,1250,9774,4,7,1250,0,230000
3,2,1830,12891,3,7,1830,0,336500
4,2.5,3140,8060,3,9,3140,0,389950
2,1,1060,3040,3,7,860,200,480000
6,2,1900,8240,2,7,1200,700,649950
3,2,1540,6000,4,6,1540,0,229000
4,2,1910,6960,5,8,1910,0,835000
3,2.5,1860,15457,3,8,1860,0,410000
3,2.5,1950,8130,4,9,1950,0,328500
4,2.5,3030,180263,3,7,2030,1000,400000
5,3.5,2320,4960,5,7,1720,600,822500
3,1.75,1620,37913,4,7,1620,0,370000
4,2.75,2780,6207,3,8,2780,0,705000
3,2.5,1520,3425,3,7,1520,0,402000
3,2.5,3190,49137,3,9,3190,0,760750
5,3,4530,258746,4,9,3200,1330,950000
5,3.25,2450,6534,3,8,1770,680,849000
5,2.5,2660,6572,5,9,1960,700,1.71E+06
2,1.5,1450,27075,3,7,1450,0,465000
3,2.25,1590,9425,3,7,1170,420,278000
4,3.5,3650,57538,3,10,3650,0,824000
3,2.5,2100,5824,3,8,2100,0,505000
5,2.75,2810,13144,3,8,1440,1370,555000
2,1.75,2056,52333,4,7,1048,1008,289000
4,2.5,2710,35009,3,9,2710,0,600000
3,3.5,1522,1465,3,8,1248,274,407500
3,2.25,1680,9766,3,7,1680,0,396000
3,2.5,1470,3999,3,7,1470,0,381000
4,4,3280,8448,3,10,3280,0,785500
2,1,770,7200,3,7,770,0,257000
3,1,1120,10500,4,7,1120,0,360000
3,2.5,2370,7500,3,8,1620,750,348000
4,3.25,1960,7200,3,7,1960,0,445000
3,1.75,1560,26099,4,8,1560,0,519000
4,2.25,1970,15743,3,7,1370,600,405000
5,3.5,4140,7642,3,8,4140,0,720000
3,1,1150,8050,4,7,1150,0,123300
3,3.25,2990,189852,4,10,2990,0,1.06E+06
3,1.75,1610,12247,3,8,1610,0,305000
4,2.75,2620,7001,3,8,2620,0,499990
5,2.5,2460,5604,3,8,2460,0,358000
3,2.25,1330,7200,3,7,900,430,295000
4,1,1200,7552,3,6,1060,140,249000
3,3.5,3590,6402,3,10,3590,0,798000
2,1,600,4854,5,6,600,0,174000
4,3,3310,217800,3,9,3310,0,1.25E+06
2,1.75,1560,43748,3,8,1560,0,295000
3,3.25,3230,7639,3,10,3230,0,817500
2,1,570,81893,3,6,570,0,260000
3,1,1050,5518,3,7,1050,0,350000
4,3.5,4860,23885,3,12,4860,0,2.95E+06
4,2.75,2720,3840,3,8,1790,930,860000
3,2.5,1770,6033,4,7,1770,0,296500
7,2.75,3110,4400,5,7,2010,1100,730000
3,1.5,1710,8364,3,7,1710,0,543000
2,1,930,6600,3,6,930,0,226950
3,1.75,1800,6000,5,6,900,900,381000
5,2.5,3100,5374,4,9,3100,0,1.60E+06
4,2.5,2700,6769,3,9,2700,0,470000
3,2.5,1800,3300,3,7,1690,110,475000
5,3.5,3500,10794,3,10,3500,0,815000
4,2.25,2140,8800,4,7,2140,0,245000
4,2.75,2190,3267,3,8,2190,0,465000
3,1.75,1850,2860,5,8,1210,640,678100
4,3,3220,8936,3,9,2450,770,430000
5,2.25,2450,9432,3,8,2450,0,359950
2,1.5,1480,3120,3,7,930,550,509250
3,1,1410,9656,3,7,960,450,920000
3,2.5,1930,10460,3,8,1930,0,407500
2,1,870,5635,3,7,870,0,334850
4,3,3540,11098,3,10,3000,540,2.20E+06
4,2.75,2700,6000,4,8,2100,600,749000
3,3.25,1300,1325,3,8,1080,220,539900
6,3.75,2940,5054,3,7,2940,0,480000
3,2,1450,2400,3,8,1450,0,490000
4,2.5,3190,11375,5,8,2210,980,659000
3,1.75,2180,7200,4,8,1090,1090,472000
4,2.5,4570,74487,5,12,4570,0,1.58E+06
5,5.75,9200,35069,3,13,6200,3000,5.57E+06
3,3,2090,7440,5,7,1290,800,700000
3,2,2290,16258,5,8,2290,0,450000
4,2.75,2890,4000,4,9,2190,700,740000
4,2.5,2910,6250,3,8,2910,0,585000
2,1,1300,44431,5,6,1300,0,175000
4,2.5,2303,16801,3,8,2303,0,525000
3,3.25,1210,941,3,8,1000,210,350000
5,2.25,2510,35691,3,9,2510,0,900000
3,1.5,1370,7853,4,7,1370,0,406000
3,1.75,2130,7500,4,7,1090,1040,350000
4,2.75,2330,3917,3,9,2330,0,645000
3,1,950,4500,4,6,950,0,325000
2,1,1060,5144,5,6,1060,0,202950
3,2.25,1450,1619,3,8,1140,310,521500
4,2.5,1800,5070,5,7,1080,720,365000
5,3.5,3240,6919,3,8,2760,480,612995
3,2,1310,2550,3,7,780,530,428000
4,2.5,3000,8100,3,8,3000,0,607500
3,2.5,1730,7442,3,7,1730,0,245000
5,2.5,2070,9600,3,7,1270,800,395000
4,1.5,1810,3400,3,8,1810,0,560000
3,2.5,1850,7200,3,7,1500,350,249000
3,2.5,3140,9808,3,9,2500,640,915000
3,2,1200,9566,3,7,1200,0,222400
4,2.5,3280,6181,3,10,3280,0,809950
3,2.5,2250,19270,3,8,2250,0,792000
4,2.5,1921,4888,3,7,1921,0,245000
5,3,2700,5001,3,10,2700,0,935000
5,2.75,2210,13500,5,7,1460,750,314000
3,2.5,1750,6351,3,7,1750,0,250000
3,2.5,1890,10190,3,8,1890,0,490000
2,1,1200,4000,3,7,1070,130,450000
2,1,930,6098,4,6,930,0,360000
3,1.75,1850,8160,3,8,1850,0,670000
4,3,3310,4500,5,9,2910,400,829000
4,2.25,2110,11155,3,9,2110,0,603000
4,3,3350,199253,3,10,3350,0,740000
4,1.5,1880,3500,4,7,1080,800,605000
4,3,2460,10401,5,7,1700,760,570000
5,2.25,3000,13899,4,8,3000,0,600000
3,1,1170,9000,4,6,1170,0,216500
2,1,910,4500,4,7,910,0,350000
5,2.75,2620,6389,3,9,2620,0,535000
2,2.5,1741,1439,3,8,1446,295,479000
4,4.25,5710,24663,3,11,5710,0,930000
3,2.75,3470,9610,3,11,3470,0,2.15E+06
2,1,1320,24319,3,7,1320,0,240000
3,2,1060,7412,3,7,1060,0,211000
3,2,2520,5980,3,8,1790,730,650000
3,1,1270,8792,5,7,1270,0,367500
4,3,2490,5706,3,9,2490,0,370000
4,2.5,2590,7891,3,9,2590,0,530000
4,3,1960,5000,5,7,1050,910,604000
3,2,1400,2445,3,7,840,560,373000
3,2.5,1400,7508,4,7,1400,0,430000
3,2.5,2830,4334,3,10,2830,0,1.90E+06
3,1.5,1580,8184,3,7,1140,440,260000
3,2.5,2010,17362,3,8,2010,0,551000
5,2.25,3100,97661,3,9,3100,0,850000
4,2.25,2260,29930,4,8,1400,860,599000
3,2.5,2497,4400,3,8,2497,0,275000
3,1,1100,5100,4,7,1100,0,130000
3,1,1540,9028,4,6,1540,0,450000
3,2,1420,6788,3,7,1420,0,252000
4,2.5,1980,12062,3,8,1980,0,374950
3,1.5,1460,13503,4,6,1460,0,240000
3,2,1480,5000,4,7,750,730,595000
3,2.5,1450,4106,3,7,1450,0,279000
3,1,1460,5825,5,5,1260,200,259950
4,2.5,2010,16020,5,8,2010,0,430000
3,1,1190,9199,3,7,1190,0,228000
3,1.75,1870,40250,5,7,1870,0,390000
3,1.5,1880,7400,3,8,1480,400,405000
3,2.5,2750,16000,4,9,2560,190,739000
2,1,1200,4880,3,6,980,220,245000
2,1.75,1530,4387,3,8,1020,510,700180
2,1.75,1130,276170,3,8,1130,0,565000
3,1.75,1190,7280,4,7,1190,0,235000
3,2.5,1590,3381,3,7,1590,0,300000
4,2.5,2100,3916,3,8,2100,0,346000
2,2,1440,3720,3,7,1440,0,475000
2,1,1230,6600,3,7,1130,100,440000
3,1,1460,6198,4,7,1460,0,775000
33,1.75,1620,6000,5,7,1040,580,640000
2,1,1340,7788,3,7,1340,0,300000
5,2,2740,8230,3,7,2210,530,407500
3,2.5,2530,7000,3,9,2530,0,975000
3,2.5,1770,5146,3,8,1770,0,464000
3,1.75,1350,7370,4,6,1350,0,190000
4,3.25,2810,11250,3,8,1680,1130,624000
2,1,830,5000,4,7,830,0,393000
3,2,1140,11161,4,7,1140,0,250000
2,1,1060,5703,4,6,1060,0,325000
3,2.25,1670,107157,3,7,1670,0,425000
3,1.75,1800,8462,3,8,1440,360,508000
4,2.25,2000,3800,3,8,2000,0,815000
4,4,4810,18851,3,11,4810,0,3.20E+06
4,2.75,3030,18400,3,9,2360,670,901000
4,1,1380,6700,3,7,1190,190,185000
3,1,1010,7034,3,7,1010,0,175000
3,1,900,37800,4,5,700,200,355000
3,1.75,1890,7004,3,7,1290,600,465500
3,1.5,1560,9350,4,7,1220,340,525000
4,1.5,1370,7904,3,7,900,470,190848
4,3.5,3500,9525,3,10,3500,0,1.35E+06
3,1.75,1600,14250,3,7,1070,530,316500
4,2.5,2000,6107,3,8,2000,0,459950
4,2.5,2210,13721,3,8,2210,0,353000
4,1.75,1760,7268,4,7,1080,680,336500
2,1,810,5100,3,6,810,0,229000
3,1.75,2450,9377,4,8,1540,910,687500
4,1.75,1960,4340,5,8,980,980,724950
4,1.75,1450,10074,4,7,1450,0,309950
2,1.5,1120,1201,3,8,1120,0,465000
5,1.5,2520,5753,4,7,1510,1010,250000
3,1,840,5700,4,5,840,0,180000
3,2.5,3300,11570,3,9,3300,0,850000
3,2.5,1690,4476,3,7,1690,0,302500
4,2.25,2360,8616,4,8,2360,0,752500
3,2.5,1500,1375,3,9,1200,300,649950
4,3.25,4280,47179,3,10,3050,1230,734950
3,1.5,1400,9750,4,6,1400,0,275000
2,2.5,1590,1426,3,8,1590,0,419190
3,1.5,1280,15028,3,7,1280,0,395000
5,1.75,2840,10220,4,7,2210,630,462000
4,1.5,1730,7464,4,7,1730,0,243400
3,1.75,1970,54450,3,8,1570,400,650000
3,2.5,3050,6000,3,8,1720,1330,715000
4,2.5,2440,3600,4,8,2440,0,1.33E+06
3,2.5,2420,9592,3,8,1780,640,441500
3,2.5,2820,10208,4,8,1410,1410,450000
4,3.5,2690,5564,3,7,2690,0,359950
5,2.25,3160,8065,3,8,3160,0,757500
3,2.25,1870,5876,3,7,1870,0,335000
4,2,2100,8160,3,7,1200,900,283000
3,1,1470,11398,3,8,1470,0,385000
3,1.75,1920,4000,3,7,1070,850,615000
4,3.75,2890,4164,3,9,2240,650,1.10E+06
3,2.5,1730,4924,3,8,1730,0,480680
3,2.5,2630,77972,3,9,2630,0,600000
4,2.5,3230,7331,3,10,3230,0,730000
4,2.5,2400,7215,3,8,2400,0,300000
4,1.5,1350,8113,4,7,1350,0,595000
4,2.5,2350,8906,3,7,2350,0,295000
2,1,840,3400,4,7,840,0,530000
4,2.75,2200,268329,3,7,1410,790,353000
4,1,1250,9102,3,7,1250,0,255000
3,2.25,1420,983,3,8,1420,0,500000
2,1.5,1160,1086,3,7,890,270,250000
4,2.5,1820,20011,3,8,1820,0,595000
2,1.5,1050,934,3,8,960,90,390000
4,2.25,2970,54450,3,8,2970,0,526000
10,5.25,4590,10920,3,9,2500,2090,1.15E+06
4,3.5,3590,5334,3,9,3140,450,1.30E+06
4,2.25,2170,9665,4,8,1300,870,488800
2,1,1560,10125,4,7,1130,430,410000
5,6.5,7270,130017,3,12,6420,850,2.24E+06
4,2.25,1940,10200,3,7,1360,580,322000
3,2.5,1410,1332,3,7,960,450,295500
4,2.25,3250,16684,3,9,3250,0,1.41E+06
4,2.5,3720,8633,3,10,3720,0,820000
3,1,1030,8395,4,7,1030,0,175000
3,1,1070,8179,3,6,1070,0,210000
3,1.75,1440,8560,4,7,1440,0,410000
4,3.25,4060,52707,4,9,4060,0,880000
3,1.75,1530,9362,3,7,1530,0,294000
3,2.5,1590,3121,3,7,1590,0,299000
4,3.5,4210,10308,3,10,4210,0,1.15E+06
4,2.25,1950,7700,3,8,1350,600,305000
3,1.75,1810,5733,4,7,1010,800,515000
3,1.75,1270,12420,4,7,1270,0,379600
3,1,1220,7200,4,7,1220,0,447000
4,2.5,2610,33206,3,10,2610,0,743700
3,2,2850,19200,3,8,2340,510,545400
3,2.25,2120,6710,5,7,1420,700,436000
3,1,1490,8239,4,6,1490,0,205950
4,2.25,1780,6120,3,8,1310,470,587500
3,2,1960,13100,5,8,1650,310,403000
3,1.75,1660,37642,4,7,1660,0,315000
5,3.25,3890,20005,3,10,2260,1630,1.80E+06
3,1,1140,7785,3,8,1140,0,407000
3,1,960,9748,3,5,960,0,265000
5,2.5,2180,7875,4,7,1200,980,425000
4,2.25,3750,5000,5,8,2440,1310,1.31E+06
6,3,3020,13783,3,8,3020,0,900000
3,1,1180,6947,4,7,1180,0,248000
4,2.5,3350,35298,4,9,3350,0,720500
3,2.5,2340,6837,3,7,2340,0,315000
4,2.5,2040,5616,3,8,2040,0,502000
2,1,1330,4140,4,7,930,400,443500
6,5.25,3600,3960,3,7,2400,1200,643500
3,1.75,1300,5111,4,7,1300,0,427000
4,2.75,2970,59677,4,8,1610,1360,829000
4,1.75,2430,7559,4,8,1580,850,585000
2,1,1050,4800,4,7,1050,0,325000
3,1,1250,13503,4,6,1250,0,282000
2,1,1310,4000,3,6,1310,0,510000
3,2,1770,7251,4,8,1770,0,320900
4,3.5,2730,3047,3,8,2400,330,769900
4,3.5,4285,9567,5,10,3485,800,1.65E+06
4,2.5,2550,5200,3,7,2550,0,435000
4,2.5,2280,42077,3,8,2280,0,445000
3,1.5,1700,8247,3,7,1010,690,249000
3,2.25,1800,4500,3,7,1800,0,382000
4,3.25,3070,10375,3,10,2180,890,1.50E+06
4,2.25,2090,45738,3,8,2090,0,600000
3,3,1500,1473,3,8,1120,380,408000
4,1.75,1890,6000,4,6,1110,780,430000
3,1,1590,4600,4,7,1290,300,572500
4,2.5,3118,7866,3,9,3118,0,541800
3,2.5,1990,3694,3,8,1990,0,334500
3,2,2310,21318,3,10,2310,0,1.36E+06
5,2.75,2844,3990,3,8,2844,0,359950
2,1,930,7623,2,6,930,0,100000
4,3.5,2550,3600,3,8,1880,670,675000
4,2,1890,5188,4,7,1670,220,675000
4,2.25,1900,8600,4,8,1900,0,270000
4,2.75,2280,2850,4,7,1540,740,530000
5,1.75,1940,6654,4,7,1940,0,359000
3,2.25,1800,7371,3,7,1280,520,425000
4,2.25,1680,3179,3,8,1680,0,255000
5,4.5,3820,5750,3,9,2830,990,920000
4,2.5,2070,8658,3,8,2070,0,372000
2,2.25,1330,806,3,8,1330,0,527700
2,1,860,6120,3,7,860,0,245000
3,2.5,1700,9100,3,8,1160,540,475000
3,1.75,1420,7205,3,7,1420,0,192500
4,2.5,2068,7242,4,7,2068,0,276000
5,3.25,2360,3873,3,8,1990,370,569900
2,2.25,1230,989,3,8,1230,0,356000
4,2.25,1960,10400,4,8,1220,740,285000
4,2.5,3220,6399,3,9,3220,0,697000
3,2,1310,1361,3,7,1310,0,310000
4,1.75,2150,9148,4,7,2150,0,800000
3,1,1280,9775,3,6,1280,0,215000
3,2.5,1600,6700,3,8,1600,0,280000
4,1.75,2100,4750,3,7,1340,760,759000
3,1,940,7980,3,6,940,0,223000
3,2.5,3020,12184,3,8,3020,0,515000
3,2.5,1260,1125,3,8,1260,0,437500
4,2.5,2470,6116,3,7,1420,1050,352000
4,2.25,2530,8736,4,7,1210,1320,618000
3,1.75,1450,6829,3,8,1450,0,440000
4,1.5,2080,4400,3,7,2080,0,592500
3,1.5,1600,4128,3,8,1250,350,625000
4,2.5,2470,7780,3,8,2470,0,332000
2,1,1230,1820,4,7,830,400,375000
3,1.5,1390,12500,4,6,1390,0,225000
4,1.75,1730,7980,4,8,1730,0,515000
4,2,2100,13468,5,7,1050,1050,475000
3,2.5,1320,1310,3,8,1320,0,475000
4,1,1450,6250,3,6,990,460,277000
3,1,1180,7669,4,7,1180,0,215000
3,1.75,1970,8200,5,8,1420,550,540000
4,2.25,1960,10275,3,7,1960,0,490000
4,2.5,1810,4871,3,8,1810,0,295000
4,2.5,3010,6181,3,9,3010,0,568500
2,1,1270,5100,3,7,1100,170,611000
3,1,1190,9600,3,7,1190,0,299500
5,3.75,4590,11265,4,11,3450,1140,3.00E+06
3,1,1500,9416,4,8,1500,0,475500
2,2,1120,1039,3,7,840,280,380950
3,3.5,1820,1991,3,8,1430,390,499950
5,2.5,2500,12220,3,8,1690,810,305000
5,3,3223,6371,3,9,3223,0,469950
2,1,1000,10320,3,6,1000,0,270000
3,2.5,1770,3205,3,9,1770,0,593567
4,3.5,2734,210201,5,8,2734,0,520000
3,2.25,2110,13300,4,8,2110,0,370000
3,1.75,2590,25992,3,8,1970,620,540000
3,2.25,2590,15229,3,8,2590,0,538250
4,2.5,2670,8279,3,7,2670,0,415000
4,2.5,2330,9928,3,8,2330,0,471000
2,1.5,1030,2850,3,7,1030,0,220000
5,3.5,3700,5400,3,9,2890,810,830000
3,2,1850,9570,4,7,950,900,547500
4,5.25,6500,14986,3,11,5180,1320,2.46E+06
4,2,1390,4500,5,7,1390,0,425000
3,1,1040,8199,3,7,1040,0,285650
4,2.5,3210,24527,3,11,3210,0,785000
4,2,1990,6000,3,9,1260,730,872500
6,3,3560,4290,4,7,1780,1780,435000
2,2.25,2200,2043,3,9,1760,440,950000
2,1,1060,7700,3,7,820,240,170500
5,3.5,3260,58806,4,8,3260,0,568450
2,1,900,4397,3,6,900,0,205000
3,2.75,2490,3600,3,8,2290,200,535000
3,1.75,1190,14777,4,7,1190,0,195000
2,2,1140,1118,3,7,1040,100,247300
2,1,1130,2640,4,8,1130,0,631500
3,1.75,1650,3200,3,8,1650,0,550000
4,2.75,3770,24897,4,8,2550,1220,940000
3,2.5,1860,44093,3,7,1860,0,397500
3,2.5,1450,8977,3,8,1450,0,265500
3,1.5,1890,4400,5,7,1890,0,651000
3,2.5,1900,7984,3,8,1900,0,435000
3,2,1400,45738,4,8,1400,0,410000
3,2.5,2510,4106,3,9,2510,0,699950
4,3.25,4360,91158,3,10,3360,1000,795127
4,2,2180,3870,3,7,1020,1160,558000
3,1.5,1490,10132,4,6,1490,0,320000
3,1,1060,10228,3,7,1060,0,230000
3,1,1270,6405,3,6,1270,0,153000
3,2.5,2242,4995,3,8,2242,0,329900
1,1,720,123710,4,6,720,0,250000
3,2.5,2650,2387,3,8,1830,820,850000
5,2.5,5067,13315,3,9,3154,1913,452000
4,3.5,2584,5005,3,8,2584,0,429900
4,3,2650,4924,3,8,2650,0,525000
3,2.25,1920,8223,4,7,1920,0,443000
4,2.5,2230,26989,4,8,1400,830,500000
3,2.5,3150,21893,3,9,3150,0,530000
2,1,1380,5000,3,5,1380,0,795000
3,1,1480,10094,4,7,1480,0,479000
4,1.75,1530,18400,4,6,1530,0,220000
3,2.5,1650,4636,3,8,1650,0,465000
3,3,2330,7304,3,9,1300,1030,516000
4,2.5,2370,6500,3,9,2370,0,328000
3,2.5,1980,3128,3,8,1890,90,615000
2,2.5,1233,1244,3,7,963,270,360000
4,2.5,2680,7178,3,8,2680,0,515000
3,2.25,1300,1180,3,8,1300,0,515000
4,2,2330,5000,5,7,1720,610,891000
2,2.5,1390,1132,3,8,1130,260,635000
3,1.5,1180,7000,4,7,1180,0,187500
3,2.5,3130,8750,3,10,3130,0,843000
4,2.25,1550,7579,3,8,1550,0,320000
2,2.5,1390,1821,3,7,1180,210,370000
4,3,3410,6541,3,9,2680,730,1.09E+06
2,1.75,1680,4500,3,8,1680,0,550285
4,2.25,2360,6260,3,7,2360,0,293000
3,2.75,2780,4815,3,10,2780,0,1.25E+06
3,1.5,1690,10500,4,7,1690,0,464550
6,1.75,2230,10080,3,7,1390,840,692500
2,1,800,15000,3,6,800,0,110000
3,1.75,1590,8285,4,8,1590,0,750000
5,3,2920,11440,3,8,2920,0,500000
4,2.5,1980,7334,3,7,1980,0,361500
3,1.75,1870,9897,4,8,1870,0,811000
4,2.25,2130,11843,4,9,2130,0,850000
3,1,1500,5605,5,6,750,750,270000
2,1,1120,7560,3,6,1120,0,380000
4,1.5,1600,6180,3,6,1600,0,645000
3,1.75,1770,8868,4,7,1770,0,250000
3,2.5,2020,4183,3,7,2020,0,321000
5,2.5,3070,7200,3,8,3070,0,575000
3,1.75,1200,9085,4,7,1200,0,228950
6,4.5,3500,8504,3,7,3500,0,350000
4,2.5,3140,9225,5,9,1770,1370,578000
3,1,1230,8114,4,7,1230,0,607000
2,1,2020,7200,4,7,1700,320,720000
5,2.75,2980,9838,3,7,1710,1270,352000
4,2.25,2940,20384,4,9,2940,0,1.39E+06
4,2.5,2850,25993,4,9,2850,0,670000
4,3.5,3480,4000,3,9,2460,1020,1.80E+06
10,3,2920,3745,4,7,1860,1060,660000
4,3.5,4730,13586,5,10,4270,460,2.45E+06
3,2.5,2150,4604,3,8,2150,0,580000
5,2.5,2890,15891,3,9,2890,0,706000
3,1,1010,7200,3,7,1010,0,347000
3,1.5,1350,7827,4,7,1350,0,259950
3,2.5,1660,1344,3,8,1660,0,975000
4,2.25,2370,11310,3,8,1550,820,603000
4,2.5,3130,5240,3,8,3130,0,400000
3,2.25,1410,1290,3,7,1290,120,391000
3,2.25,2200,8750,4,7,1120,1080,315000
4,1.5,1800,9576,4,7,1800,0,271000
3,2.5,1570,1433,3,8,1570,0,635000
3,2,1350,7216,3,7,1350,0,400000
3,1,1040,9600,3,7,1040,0,399950
4,2.25,1870,9680,4,7,1170,700,325000
4,2,3090,8125,5,8,3090,0,1.22E+06
3,2.5,2550,4954,4,7,1850,700,675000
4,2.5,3130,13202,3,10,3130,0,851000
4,2.5,2180,9281,3,8,2180,0,363000
3,1.5,1220,835,4,6,1220,0,415000
4,2.5,3620,17133,3,10,2220,1400,919000
3,1,1130,12500,3,7,1130,0,375000
3,2.5,1670,6666,4,7,1670,0,290700
4,2.5,3250,5000,3,8,3250,0,580000
6,2.75,4710,11000,3,10,3690,1020,2.18E+06
5,2.75,2930,7663,3,9,2930,0,718000
3,1.75,1640,17583,3,7,1110,530,410000
3,2.5,2240,21477,3,8,2240,0,1.08E+06
2,1.5,1070,877,3,8,1070,0,382000
3,2.5,1500,7401,3,8,1500,0,260000
3,1,1120,8631,3,7,1120,0,311000
3,2.5,2200,9696,3,8,2200,0,365000
3,2.5,2620,28703,3,10,2620,0,725000
3,2.25,2320,38186,3,8,2320,0,610000
3,2.5,1760,7601,3,8,1760,0,281000
4,2.5,3260,26772,3,9,3260,0,820000
3,2.75,3610,107386,3,8,3130,480,425000
4,2.75,2180,5799,4,8,2180,0,571500
5,2.5,2960,9877,4,7,1480,1480,550000
4,2.5,2790,4650,3,8,2790,0,374950
3,1.5,1890,9000,3,7,1190,700,240000
4,2.5,2170,8680,3,7,1220,950,685000
3,2.5,2810,7700,3,9,2810,0,685000
6,4,4470,17877,3,9,3230,1240,598800
3,1.75,1330,12092,4,6,720,610,339950
4,1.75,2030,12518,3,8,1610,420,380000
3,3.5,3080,6495,3,11,2530,550,2.16E+06
4,1,1400,3600,4,6,700,700,386500
4,2.25,1890,3006,3,7,1890,0,520000
4,2.5,2701,4500,3,9,2701,0,399895
3,1.75,1730,9893,4,9,1730,0,299900
3,2.25,2090,8095,3,10,2090,0,550000
3,2,1340,5670,3,6,1340,0,252000
3,2,1480,6600,3,7,740,740,385000
3,2.25,1750,9298,4,7,1410,340,265000
4,2.5,2400,8320,3,8,2400,0,515055
3,1.75,1260,15000,4,7,1260,0,204555
4,2.75,3040,2415,3,8,3040,0,735000
3,1.5,2030,8880,3,7,1330,700,404000
3,2,1840,6000,4,6,1840,0,521000
4,1.75,1275,20000,4,6,1275,0,309600
3,1,1170,7320,3,7,1170,0,183000
4,3,1820,8261,3,7,1420,400,515000
3,1.75,1400,3825,4,6,1100,300,538000
2,1,920,3780,3,6,920,0,427000
3,2.25,1890,7314,3,7,1100,790,255000
3,2.25,1640,8400,4,8,1640,0,515000
2,1,740,5200,4,5,740,0,213800
4,3.5,3510,11200,3,11,3510,0,935000
3,1.5,1510,10588,3,7,1510,0,230000
3,2.5,2040,4348,4,8,2040,0,346950
3,1.5,1810,5080,3,7,1030,780,430000
4,2.5,3220,8379,3,10,3220,0,748000
3,1,1040,7800,3,7,1040,0,240000
3,1.5,1180,7000,4,7,1180,0,193000
5,3.5,3700,7055,3,9,3700,0,889950
4,2.5,2400,4848,3,8,2400,0,344000
5,2.75,3190,16920,3,9,1690,1500,1.03E+06
3,1.75,1850,14986,3,6,1850,0,330000
3,1.5,1550,7260,2,6,1550,0,313000
3,1,1340,9339,5,7,1340,0,345000
4,3.5,2980,3000,3,9,2340,640,905000
2,1,800,5600,5,6,800,0,189900
2,1,1010,4000,3,7,1010,0,337000
4,2.75,2510,11880,5,8,1630,880,664000
4,3.5,2730,5607,5,9,1660,1070,1.03E+06
3,2.25,1765,7652,3,7,1765,0,250000
4,2.5,2070,7312,4,7,1230,840,449950
3,1.75,1770,33224,4,8,1770,0,229500
2,2.5,2305,5580,3,8,2305,0,705000
4,1.5,1260,7248,5,7,1260,0,259000
4,2.5,2000,7376,3,8,2000,0,602000
3,2.5,2134,1984,3,8,2134,0,611000
5,2.75,3370,10315,3,9,3370,0,561000
4,2.25,2860,11545,4,8,1430,1430,957000
4,2.25,2400,13430,4,9,2400,0,856600
4,2,2420,10735,3,7,2420,0,525000
4,3,4500,21780,3,9,3040,1460,870000
4,5,4110,43560,4,11,4110,0,1.04E+06
3,1.5,1380,6657,3,7,1380,0,455000
3,1,1060,9506,3,7,1060,0,364500
4,3.5,3880,8244,3,10,3060,820,620000
3,1.75,1810,12600,3,7,1400,410,450000
3,1.75,1730,11325,5,7,1730,0,292000
3,1.75,2300,43560,4,7,1350,950,525000
4,2.5,1830,7345,4,8,1540,290,494000
4,2.5,2510,8580,4,8,2510,0,330000
4,2.5,1750,4779,3,7,1750,0,415500
5,4,4280,11307,3,10,2710,1570,839000
2,2.75,1992,10946,5,6,1288,704,429592
3,3.25,1310,1072,3,8,1060,250,514700
1,1,850,8050,2,6,850,0,490000
4,2.5,3550,10968,3,9,3550,0,685000
4,2.5,2680,9185,3,9,2680,0,620000
3,2.5,2240,41339,4,9,2240,0,1.01E+06
4,2.5,2740,8336,4,9,2740,0,395000
7,4,3440,8100,3,7,3440,0,550000
4,3,2210,4191,3,7,2210,0,315000
3,1.75,1540,7558,3,8,1540,0,520000
3,1.75,1650,5100,5,7,1040,610,600000
5,2.75,2880,4425,3,8,2880,0,733000
3,1.75,2080,6609,3,7,1280,800,520000
4,1.75,1930,7245,4,8,1510,420,588000
4,2.25,2510,19550,4,9,1810,700,588000
2,1.75,1360,8100,3,7,860,500,300000
3,2,1390,2688,5,7,1390,0,550000
3,2.5,3050,33920,3,8,3050,0,840000
4,2.75,3000,5470,3,8,3000,0,355000
4,2.75,2800,19168,3,10,2800,0,999000
4,2.75,3520,5500,3,9,3520,0,859990
4,1.75,1810,21650,4,7,1810,0,465000
3,1.5,1940,4000,3,8,1310,630,728000
3,2.25,2180,9246,3,9,2180,0,570000
4,1.75,2010,3600,3,7,2010,0,740000
3,1.75,1960,8136,3,7,980,980,340000
3,1,1470,6122,3,8,1200,270,652000
2,1,1210,17389,4,5,1210,0,259000
4,2.5,2930,8641,3,8,2930,0,750000
4,2.75,2420,7102,5,7,1670,750,665000
3,2,2110,5800,4,7,1990,120,725000
4,1.75,2190,9400,4,7,1450,740,725000
5,3.5,3490,9680,3,9,2460,1030,941500
3,2,1360,4840,3,8,1360,0,382000
3,1,1240,7300,3,7,1240,0,420000
5,2,1900,5000,3,8,1720,180,630000
4,1,980,3000,4,7,980,0,295000
4,2.5,2060,5950,3,8,2060,0,292000
2,1,1030,5934,4,7,1030,0,460000
5,3,2680,9624,3,7,1870,810,359999
4,2.5,2920,9904,4,9,2920,0,690000
2,2,1490,713,3,9,1490,0,700000
3,1.75,1240,3600,5,7,1240,0,662990
2,2,1370,1339,4,8,1150,220,448175
4,2.25,2460,40635,5,8,2460,0,715000
4,1.75,1920,9380,3,7,1920,0,480000
4,2,2010,7312,4,7,2010,0,250000
4,2.25,3200,53357,4,9,3200,0,785000
2,1,1060,5754,4,6,1060,0,395350
5,3,1940,6355,3,8,1200,740,300000
3,1.75,2480,4000,3,8,1240,1240,920000
3,1.5,1430,5200,4,7,1250,180,517500
4,2.75,2540,7210,4,7,1600,940,335000
4,2,1990,4740,3,7,1080,910,430000
3,1,1320,5000,3,7,1320,0,201500
3,2.5,1690,4102,3,7,1690,0,295000
4,2.5,2280,9491,4,7,1290,990,575000
5,1,1410,6400,5,7,960,450,295832
3,1.75,1550,12956,3,7,1210,340,372500
4,2,2220,14120,3,7,1200,1020,225000
2,1,830,8183,5,6,830,0,327500
4,1.75,2530,5000,5,8,2070,460,720000
3,3,2080,10521,3,9,2080,0,830000
3,3.5,1740,1975,3,8,1310,430,640000
4,2.75,2110,13260,4,7,1290,820,320000
4,3,2250,7882,3,8,1570,680,250000
4,2.25,2980,8051,4,10,2020,960,1.16E+06
4,2.5,2120,10841,4,8,1500,620,828000
4,2.75,2790,5527,3,8,2790,0,483453
4,1.5,2390,7480,3,7,2390,0,339000
3,1.75,1730,6900,4,7,1130,600,300000
4,3.5,2970,5000,3,9,2200,770,866800
3,3.5,2450,9248,3,8,1960,490,939000
4,2.5,2810,7549,3,9,2810,0,550000
3,1,1060,10350,4,7,1060,0,206000
6,3,2790,4550,4,8,2790,0,700000
3,2.5,1750,1381,3,8,1750,0,585000
3,1,1580,3840,3,8,1580,0,729000
3,2,1520,5000,3,7,1140,380,575000
3,2,2080,12094,4,8,2080,0,589950
3,2.5,2470,7700,4,8,2470,0,365000
4,2.5,2330,4907,3,7,2330,0,337500
5,4.5,4400,15580,3,11,3390,1010,1.80E+06
3,2,1220,17652,4,7,1220,0,415500
2,1,1240,57000,3,7,1240,0,505000
4,2.5,2717,4513,3,8,2717,0,338500
3,1,1510,6083,4,6,860,650,415000
2,1.5,1995,115670,4,8,1995,0,645000
4,1,1400,9384,4,6,1400,0,325000
3,1.75,1770,16909,5,8,1770,0,419950
4,2.5,2120,13780,3,8,2120,0,403950
4,2.5,2641,8091,3,7,2641,0,393000
6,4.25,5860,13928,3,10,4150,1710,1.75E+06
3,2.25,1700,7650,4,7,1340,360,419000
4,2.5,2590,9753,3,10,2590,0,674750
3,2.25,1700,8800,5,7,850,850,565000
2,2,870,6450,4,6,740,130,235000
3,2,1520,3451,3,8,1520,0,413000
5,2.5,2430,4781,3,9,2430,0,405000
4,2.25,2192,12128,3,8,2192,0,310000
3,3.25,1710,2381,3,8,1360,350,470000
4,2.5,3220,8256,3,8,2610,610,440000
3,1.75,1500,6180,4,6,1060,440,440000
5,1.75,2760,18112,3,8,1510,1250,495000
4,2.5,2250,6064,3,8,2250,0,398500
3,2.5,1500,2314,3,7,1500,0,405000
3,3.25,2780,4002,3,8,2780,0,402500
3,3.25,2330,4000,3,10,1730,600,826000
2,1,1790,4000,4,7,1040,750,710000
5,4.5,2120,8944,5,8,2120,0,1.00E+06
5,2.75,2870,4461,3,7,1650,1220,646000
3,2,1769,9300,4,7,1769,0,495000
2,1,1000,7615,4,6,1000,0,231500
4,2.5,1820,3899,3,7,1820,0,359950
3,2.5,1720,8755,3,8,1000,720,275000
3,2.75,1990,31200,3,8,1990,0,490000
4,2.5,2480,5000,3,8,1480,1000,906000
3,1.75,1940,7500,4,8,1940,0,295000
5,3.25,3090,7069,3,9,3090,0,615000
2,1,870,3121,4,7,870,0,395000
3,2.5,2770,9350,3,8,2770,0,679000
3,1,1120,9075,3,7,1120,0,335000
2,1,870,7020,4,6,570,300,230000
2,1,1160,5038,5,7,740,420,425000
4,2.25,2210,10039,4,8,1710,500,620000
5,6.25,8670,64033,3,13,6120,2550,2.89E+06
3,2.5,3490,12410,3,8,2590,900,630000
4,2,1210,4250,4,7,1210,0,315000
3,2.75,1940,3088,3,8,1770,170,425590
5,3.5,2815,5619,3,9,2815,0,477500
5,1,1760,4264,3,8,1760,0,780500
4,2.5,2130,4467,3,8,2130,0,380000
2,1,1220,7250,4,6,1220,0,135000
3,2.25,3020,13031,3,9,3020,0,755000
4,3,2800,6977,3,8,2800,0,449950
2,1,860,4013,3,7,860,0,580000
2,1,1240,12092,3,6,960,280,232000
3,1.75,2380,6000,3,7,1320,1060,285000
3,2,1660,15050,3,7,1260,400,453000
4,1,1260,8505,5,7,1260,0,461000
3,2.75,3390,7000,4,8,1740,1650,915000
2,1,990,45528,4,7,990,0,280000
2,2.5,1280,1566,3,7,1280,0,206000
3,1,1140,9639,4,7,1140,0,230000
3,2.5,1670,4308,3,8,1670,0,483500
2,1,940,15000,3,7,940,0,225000
3,2,1470,20000,4,7,1470,0,254600
4,1,1460,16638,4,6,1460,0,162000
3,2.5,1510,10384,2,7,1030,480,250000
3,1.75,1340,63597,4,7,1340,0,290000
4,2.5,2070,4427,3,7,2070,0,425000
3,1.75,1440,16819,4,6,1440,0,252000
4,2.5,2750,10159,3,10,2750,0,812500
4,2.5,3250,13360,3,9,3250,0,486940
3,3,3230,8625,3,10,2220,1010,1.26E+06
2,1,750,4500,3,6,750,0,295000
5,2.75,2840,12253,3,7,1420,1420,396000
5,2.25,2680,13292,3,8,1340,1340,599950
5,3.25,5600,107157,3,10,3440,2160,1.09E+06
5,3,3110,4464,3,8,3110,0,588000
3,1,1810,12375,3,7,1810,0,326500
3,2.5,2010,2386,3,8,1390,620,479990
2,1,790,9784,3,6,790,0,330000
3,2,1300,5000,4,7,1300,0,240000
3,3.25,2310,3075,3,8,1730,580,589500
3,2.75,3580,14217,4,10,2210,1370,600000
3,2.5,2320,52272,3,8,2320,0,600000
4,3.25,3760,4675,3,8,2740,1020,429900
3,2,2250,14274,4,8,1500,750,624800
3,1.75,2120,5992,3,7,1060,1060,425000
2,2.25,1290,1334,3,8,1290,0,500000
3,2,1810,10860,3,7,1810,0,407450
4,1.75,2110,6708,3,8,1410,700,1.03E+06
5,2.5,3200,17204,3,7,2160,1040,1.27E+06
4,3.5,3100,15842,3,8,2400,700,590000
3,3.25,1380,1121,3,8,1380,0,475000
3,2.25,1480,7200,3,7,1190,290,291000
3,1.5,1700,14133,4,8,1700,0,979000
2,1.75,1980,8550,3,7,990,990,585000
3,2.75,3340,12690,3,10,2550,790,1.30E+06
5,3.5,3150,4120,3,8,2460,690,850000
3,0.75,1420,3060,4,7,860,560,355000
4,2,1440,10800,4,7,1440,0,230000
3,1.5,1650,9957,4,7,1100,550,369500
4,2.75,2890,7821,3,9,2890,0,978000
4,1,1190,8875,4,7,1190,0,276693
3,2.25,1630,2490,3,7,1630,0,468000
4,2.75,2450,15002,5,9,2450,0,530000
2,1.75,1010,1461,3,7,670,340,340000
5,3.25,4230,10260,3,10,3860,370,847700
3,1.75,2360,4063,5,7,1180,1180,631750
4,2,1600,12500,5,7,1600,0,356000
5,3,2110,5260,3,7,1670,440,285000
4,2.5,2120,7820,3,8,1280,840,490000
3,1,1320,24684,3,7,1320,0,150000
3,1.5,1460,9908,3,7,1460,0,310000
3,2.5,2790,19485,3,9,2790,0,535000
2,1.5,1130,1340,3,8,910,220,439108
4,2.5,4620,20793,4,11,4620,0,575000
3,1,1070,4505,4,7,1070,0,640500
3,1.75,1120,4000,4,7,870,250,445000
4,2.5,2740,8120,3,9,2740,0,690000
3,2.5,1650,4648,3,8,1650,0,500000
3,1.75,3400,46382,3,7,2050,1350,340000
3,1.5,1900,5000,3,7,1640,260,921500
4,2.5,2650,6875,3,8,2650,0,569995
4,2.5,2440,10049,4,9,2440,0,672000
5,2.75,2910,15118,5,9,1780,1130,1.17E+06
3,2,1470,7694,4,7,1470,0,254000
3,1,1220,22443,4,7,1220,0,201000
3,2,2632,18743,3,10,2632,0,695000
4,2.5,2620,5457,3,8,2620,0,321500
3,2.5,1820,1545,3,8,1640,180,504500
2,1.75,1360,10000,3,6,1360,0,279900
2,1,930,4743,4,5,930,0,141800
2,1,1450,4500,4,7,1450,0,526000
3,1.75,1300,10030,4,7,1300,0,390000
3,1.5,1370,4790,4,7,1370,0,355000
4,3.75,2400,3520,3,7,1370,1030,885000
2,2,1230,4800,3,7,1230,0,464000
5,3.25,5270,17232,3,10,4010,1260,1.80E+06
3,1.75,1690,53578,3,8,1690,0,509900
2,1,1390,11340,4,7,1390,0,185000
3,1.5,1590,7260,3,7,1080,510,339275
3,2.25,1640,2875,3,6,1240,400,390000
4,2.25,3960,8640,3,9,2630,1330,1.40E+06
3,2.25,2290,9047,4,8,2290,0,753000
3,2,1680,8946,3,6,940,740,381000
3,1.75,2300,11400,4,8,1520,780,505000
4,2.5,2040,6034,3,7,2040,0,545000
3,1.5,1180,7300,4,7,1180,0,209950
4,3.5,3700,13175,4,11,3700,0,1.29E+06
5,3.25,4010,12110,3,11,4010,0,1.10E+06
4,2.5,1820,7930,5,7,1820,0,286000
3,1,1210,9730,4,7,1210,0,310000
3,1,1230,6000,4,7,1230,0,229500
4,2.25,2400,5350,4,7,1460,940,620000
4,2.25,1990,7320,4,7,1030,960,450000
3,2.75,1880,1793,3,7,1810,70,268000
3,1.75,1390,9000,4,7,1390,0,270000
2,1,770,8600,4,4,770,0,248000
3,1.75,1900,9375,4,8,1330,570,1.04E+06
4,2.25,3270,15760,4,10,2000,1270,987500
4,1.75,2290,10290,3,7,1340,950,343000
3,2,1410,8384,3,7,1410,0,205000
4,3,2060,9138,3,8,1430,630,323400
3,1,1160,8636,3,6,1160,0,255000
4,2.25,2640,34870,3,8,1770,870,518000
4,2.75,2460,3600,3,8,1640,820,710000
4,1.75,2020,7840,3,7,1010,1010,220000
3,1,990,6000,3,6,990,0,495000
3,1.75,1370,3300,5,7,1370,0,570000
2,1,900,5000,3,7,900,0,553000
3,2.5,3110,11727,3,9,3110,0,700000
4,2.5,2650,9627,4,8,1610,1040,490000
2,1.75,6840,10000,3,11,4350,2490,3.28E+06
4,1,1860,8505,4,7,1860,0,265000
3,2.5,2700,8444,3,10,2700,0,765000
4,2.5,2320,8721,3,8,2320,0,562500
3,1.75,1500,13891,4,7,1500,0,576000
3,2.5,1720,4120,3,7,1720,0,340000
4,2.5,3120,14300,3,9,3120,0,730100
3,1,1210,4000,3,7,1090,120,450000
3,2,3200,18184,5,8,2000,1200,851500
3,3,1296,1051,3,8,1296,0,399950
3,2.5,2480,7480,3,9,2480,0,530000
5,2,2900,11970,4,7,2900,0,310000
3,2.5,2880,426452,3,7,2880,0,450000
4,3.5,3760,57063,3,9,2950,810,740000
2,2.5,1390,1302,3,7,1390,0,191950
4,2.5,1770,5000,3,7,1770,0,291500
4,1.75,1990,4725,4,7,1190,800,445000
3,2.25,4470,22518,3,9,3240,1230,1.48E+06
4,1,1300,18836,4,7,1300,0,321000
4,1.5,2220,6811,4,7,1270,950,320000
3,1.75,1770,7508,3,7,1270,500,490000
3,2.5,1650,13816,3,7,1650,0,272000
3,2,2180,5440,5,7,1100,1080,785000
4,3.25,3990,9786,3,9,3990,0,866000
5,4,4230,27295,3,8,3230,1000,2.70E+06
2,2.25,3170,3000,5,10,1990,1180,1.70E+06
4,2.5,3200,22651,5,8,1610,1590,385000
3,2,2190,13673,4,9,2190,0,432000
3,1.5,1360,10726,4,7,1360,0,348500
3,2.25,1770,8165,3,7,1770,0,420000
3,1,1440,4268,3,7,1040,400,285000
3,2.5,1680,6755,3,8,1680,0,225000
2,1.75,2230,6930,4,8,1530,700,766500
4,2.75,2330,3920,3,9,2330,0,680000
3,1.5,1450,7000,3,7,1450,0,419900
2,1,1790,3760,4,8,1490,300,570000
4,3,3130,2646,5,9,2290,840,1.27E+06
5,2.25,1870,11411,4,8,1170,700,554000
3,2.25,1600,10240,3,7,1090,510,390000
4,2.5,2500,8680,4,7,1250,1250,772000
3,3.5,4310,10842,3,10,3140,1170,1.20E+06
4,2.5,2200,3141,3,7,2060,140,465000
3,2.5,2140,3628,3,8,1960,180,589999
4,2,2670,3240,4,9,1780,890,630000
4,1.5,2120,7110,3,6,2120,0,246000
3,2,2600,6600,3,10,1930,670,1.70E+06
4,3.5,2760,4000,3,8,2000,760,765000
3,2.25,1390,1484,3,8,1390,0,374950
3,1,1140,10477,3,6,1140,0,158000
3,2.5,2370,6082,3,7,2370,0,435000
3,2.75,1950,12630,4,8,1230,720,510000
2,1.75,1210,7507,3,7,1210,0,342500
4,1.5,2700,14760,5,9,2700,0,415000
2,1.5,830,1858,3,7,830,0,334500
2,1.5,1320,826,3,8,1100,220,342500
3,1.5,1060,9600,4,7,1060,0,219000
4,2.5,2310,5813,3,8,2310,0,400000
2,1,840,6480,4,5,840,0,124500
5,4.75,5990,10450,3,11,4050,1940,2.20E+06
3,2.5,1950,3730,3,9,1950,0,899000
3,1,1090,10620,3,7,1090,0,140000
3,1.5,1230,7500,3,7,1230,0,270000
3,2.5,1360,1016,3,7,1310,50,535000
4,2,2070,10800,3,7,2070,0,400000
3,2.5,2660,10637,3,9,2660,0,595000
4,2.5,2580,5823,3,8,2580,0,552250
4,1.75,1920,9350,4,7,1000,920,235000
3,1,1010,7920,3,6,1010,0,390000
4,3,3250,2760,3,8,2420,830,863500
7,3,5350,14400,4,10,5020,330,2.89E+06
3,1.75,1440,8957,4,7,1440,0,550000
3,2,1650,6150,4,7,1650,0,590000
3,1.5,1230,7200,3,7,1230,0,424000
3,1,1180,43124,4,6,1180,0,330000
4,2,2490,9525,5,9,2490,0,940000
4,3,2280,7400,3,7,1340,940,505000
4,2.25,3720,12384,5,8,1860,1860,875000
3,1.75,1440,45302,3,7,1440,0,328000
2,1.5,1400,5000,4,7,1150,250,515000
3,3.5,1820,1501,3,8,1430,390,499950
3,1.75,2040,15695,4,8,2040,0,452500
3,2.25,1640,3896,3,8,1640,0,478000
4,2.75,2300,26650,4,8,2300,0,525000
4,2,1400,4690,4,7,1400,0,658600
3,1.75,1830,7969,3,7,930,900,312500
4,1.75,2170,5750,3,7,1370,800,588000
3,2.5,1900,7604,3,8,1900,0,512500
6,4.5,4230,6420,4,8,2360,1870,1.47E+06
5,2.5,1960,7350,4,7,1360,600,256500
1,1,850,8050,2,6,850,0,165000
4,2.5,2740,5000,3,9,2740,0,1.07E+06
3,2.5,1940,5660,3,8,1940,0,488000
3,2.5,2100,15120,4,8,2100,0,1.15E+06
2,1,900,5512,3,7,900,0,470000
4,2.5,2340,7877,3,9,2340,0,597000
3,2.25,1580,11680,4,7,1580,0,549800
2,1.75,1460,1500,3,8,1000,460,625000
4,2.5,2970,29163,3,9,2970,0,715000
4,3.25,3250,5478,3,9,3250,0,699188
4,2.5,2710,5880,3,9,2710,0,370000
4,2,1180,7275,3,7,1180,0,330000
3,1,950,5214,3,7,830,120,333000
3,2,1180,7793,4,7,1180,0,265900
3,1.75,1550,4057,3,6,830,720,294010
3,2,1190,7840,4,6,1190,0,311000
2,1,1070,6000,4,5,1070,0,225000
3,2.5,2970,23100,3,7,1510,1460,599000
4,2.25,2420,7927,4,7,1400,1020,400000
3,1.75,1710,6400,4,7,1240,470,260000
4,2.5,3361,5038,3,9,3361,0,471275
2,1,920,43560,4,5,920,0,255000
4,2,2130,8400,3,7,1350,780,250000
2,1,1260,4000,3,7,1000,260,549950
3,2.25,3230,17833,4,9,3230,0,2.11E+06
3,2.5,1920,9625,3,8,1920,0,391500
3,2,1460,7526,3,7,1460,0,240000
2,2,1470,2052,3,7,1470,0,239000
5,1,1680,9383,3,7,1400,280,274000
4,1.5,2320,5534,4,7,1540,780,475000
3,1,1190,7500,5,7,1190,0,215000
3,2.5,1610,6000,4,7,1610,0,282000
3,2.5,1340,10290,4,7,1140,200,265000
3,1.75,1330,9831,3,7,1330,0,248000
3,1.5,1320,15053,3,7,1320,0,300000
4,2,1240,3000,3,7,1040,200,375000
3,2.5,2730,7372,3,9,2730,0,350000
4,3.25,3820,24166,4,11,3310,510,1.25E+06
4,2.5,2310,3570,3,7,1490,820,700000
3,3.25,1520,1500,3,7,1520,0,500000
6,2,2840,228690,3,6,2720,120,640000
5,2.75,3390,5211,3,9,3390,0,735000
3,1.75,2020,11095,4,7,1480,540,463000
3,3.5,3790,10829,3,11,3790,0,929950
3,2.5,2074,4900,3,8,2074,0,515100
6,3,2980,7200,3,8,2980,0,1.31E+06
4,2.25,2850,7453,3,9,2850,0,540000
4,1.5,1680,11123,3,7,1130,550,380000
4,1.75,1910,16785,4,7,1110,800,425000
3,2.5,2190,17108,3,8,2190,0,463000
3,1.75,1760,12874,4,7,1230,530,577000
3,1.75,1320,35100,3,7,1320,0,284000
3,1.75,2000,7111,4,7,1360,640,427000
3,2.5,1480,7200,5,7,1480,0,256000
5,2.75,2720,4680,4,8,1710,1010,752500
4,2.5,2030,9825,3,8,1330,700,598000
6,3.75,2930,14980,3,9,2930,0,915000
3,3,2230,12968,3,9,2230,0,1.32E+06
3,2.25,2270,32112,4,8,1740,530,390000
3,1.5,1550,5034,4,7,1550,0,430000
3,3,1850,5000,2,6,1850,0,975000
3,2.5,1800,4357,3,8,1800,0,450000
4,3,4040,20001,3,9,2020,2020,1.39E+06
3,2,1550,6394,5,8,1550,0,500000
3,2.5,2540,5237,3,8,2540,0,489950
5,2.5,2540,5100,3,7,2540,0,355000
4,1.75,3730,16980,4,7,2150,1580,360000
5,2.5,1720,10202,3,7,1720,0,206325
4,1,1900,8505,3,7,1200,700,270000
3,2.5,2310,11993,3,9,2310,0,765000
3,1,980,9115,3,7,980,0,133000
3,1,1150,11396,4,7,1150,0,354500
5,2.75,2080,13189,3,8,2080,0,538888
4,1.75,1700,10230,3,8,1320,380,429950
2,1,800,7150,3,5,800,0,175000
2,1,820,4860,5,6,820,0,207000
3,1.5,1800,22000,3,8,1800,0,360000
3,1.75,1570,16817,3,7,1570,0,370000
2,1.5,1440,136778,4,8,1140,300,650000
4,2.5,2280,2432,5,8,1520,760,597000
3,1,1060,4650,3,7,910,150,450000
3,1.75,1580,6620,3,7,1580,0,279900
3,2.25,1570,7187,4,8,1170,400,476000
3,2.25,1440,1362,3,7,1440,0,469000
4,2.25,2260,41984,4,9,2260,0,925000
2,1,720,4323,3,6,720,0,405000
3,1,1040,8075,4,7,1040,0,390000
4,4,4420,16526,3,11,4420,0,1.33E+06
2,1,1120,6141,3,7,900,220,520000
4,2.5,2250,9091,3,7,1340,910,305000
4,2.5,1960,9898,3,8,1960,0,300000
2,1,870,10492,3,7,870,0,382000
3,1.75,1140,1165,3,8,1140,0,230000
4,2.5,2798,5085,3,9,2798,0,440000
3,2.25,1640,7200,4,8,1640,0,561000
3,1.75,2310,7680,4,8,1410,900,336950
3,1.75,1830,51836,4,7,1430,400,300000
2,1,2150,4500,3,7,1260,890,235000
5,1.75,2500,11617,4,9,1560,940,840000
4,2.5,1910,7683,3,8,1910,0,620000
4,2,2030,8426,3,7,2030,0,275000
5,4.5,5160,44315,3,12,5160,0,1.90E+06
4,2.5,3236,9608,3,10,3236,0,450000
3,1.75,2050,16313,2,8,2050,0,623000
3,1.75,1490,6930,4,7,1490,0,245000
5,2.5,3040,9570,4,8,1640,1400,795000
4,3.75,4980,18069,3,11,4980,0,1.21E+06
3,3,1560,1466,3,8,1560,0,640000
1,1,780,10235,3,6,780,0,167000
1,0.75,820,59677,3,5,820,0,527550
3,2.5,1670,5791,3,7,1670,0,310000
3,2.25,1230,1238,3,8,1080,150,435000
3,2,720,7598,5,6,720,0,300000
4,2.5,2927,12171,3,10,2927,0,715000
3,1.5,1500,15000,3,7,1500,0,215000
3,1.75,1560,5520,4,6,780,780,524000
4,2,2380,6122,4,8,1310,1070,812000
4,2.5,1790,6120,3,7,1790,0,370500
6,4.25,5720,10213,3,10,4170,1550,1.33E+06
3,2,2040,6880,4,7,2040,0,435000
3,1.5,1100,8140,4,7,1100,0,306500
4,2.5,2600,7200,3,7,2600,0,691500
3,2.5,3050,12558,3,10,3050,0,865000
4,2.25,2860,10702,3,10,2860,0,1.20E+06
4,1,1550,7740,3,6,1550,0,385200
4,2.75,2140,4000,3,7,1190,950,625000
3,2.75,2280,4280,5,7,1280,1000,875000
3,1,830,3386,3,6,830,0,295000
3,2.25,2100,14027,3,8,2100,0,270000
3,1.75,1650,5000,4,8,1650,0,730000
2,1,900,8000,4,6,900,0,185000
3,2.5,1590,2550,3,7,1590,0,488000
4,3.5,2000,2309,3,8,2000,0,456500
4,2.5,2820,5510,3,9,2820,0,398000
4,2.5,3172,5033,3,8,3172,0,432500
4,2.25,2390,40510,4,8,2390,0,545000
3,2.5,3550,136343,3,10,3550,0,545000
3,2.5,2198,6222,3,8,2198,0,388000
3,1,1120,10576,4,7,1120,0,320000
3,2.5,1690,3827,3,7,1690,0,449000
3,3.5,2350,10739,5,7,1340,1010,760000
2,1,900,5100,4,7,900,0,473000
2,1,1030,4188,3,8,1030,0,189950
3,2.5,2710,5733,3,7,2710,0,275000
1,1,850,6567,4,6,850,0,440000
4,3,2890,6885,3,7,1590,1300,476000
4,1.5,1430,4163,3,7,1430,0,575000
3,1,2110,10005,5,7,1110,1000,475300
4,2.5,3250,4500,3,8,3250,0,530000
3,1.75,1580,7875,3,7,1580,0,195000
3,2.5,1750,1548,3,9,1750,0,495000
3,1.75,1570,4875,4,7,1310,260,214950
3,2.25,1570,43350,4,7,1570,0,325000
3,1.75,2870,5000,4,8,1840,1030,802000
3,2.5,2230,7200,3,9,2230,0,836500
1,1,730,5005,4,5,730,0,306950
3,1.75,1100,9452,3,6,1100,0,190000
4,1.75,1650,6900,3,7,910,740,238000
4,2.5,2620,10489,3,9,2620,0,683000
3,2.5,1420,1269,3,7,1420,0,410000
4,2.5,2038,7643,3,8,2038,0,319950
3,2.25,1860,11227,3,7,1860,0,330000
4,2.25,2450,21000,4,8,1650,800,455000
5,2.75,2940,5225,3,8,2760,180,837000
3,1.75,1760,12823,4,7,1460,300,269950
4,1.75,1620,7560,4,7,1380,240,657500
3,1.75,1440,11787,3,8,1440,0,495000
2,2.75,2820,11770,3,7,1630,1190,350000
3,2,1410,7265,4,7,1410,0,274950
3,1.75,1240,8659,5,7,1240,0,255000
3,2.75,1900,16117,4,7,1900,0,255000
3,1,1010,8551,5,7,1010,0,350000
3,1.5,1820,10608,4,7,1820,0,264000
3,3,1520,4080,5,7,1520,0,495000
4,2.5,3600,21794,4,11,3600,0,875000
4,2.5,3540,7009,3,9,3540,0,920000
4,2.75,2030,9120,4,7,2030,0,302000
3,2.5,2540,8073,4,8,1880,660,650000
4,2.5,3830,4644,3,8,2900,930,679975
3,2.5,2495,4400,3,8,2495,0,267000
3,1.75,2080,7800,5,7,1220,860,365000
4,2.5,2350,5835,3,8,2350,0,270000
3,1,1400,8710,4,7,1400,0,380000
3,2.25,1960,10139,3,8,1960,0,605000
3,2.75,1720,28000,4,7,1720,0,340000
3,2.5,1840,2875,4,7,1840,0,512500
4,2.5,1790,9787,4,8,1240,550,560000
3,1,2150,7007,3,6,2150,0,300000
5,2.5,2510,10240,4,8,1410,1100,450000
3,1.75,1930,6360,3,9,1930,0,536751
3,1.75,2000,5000,4,7,1110,890,546000
3,1,760,3090,2,5,760,0,167500
4,3.25,2600,2074,3,8,2150,450,661000
4,2.25,2490,8700,3,7,1890,600,442500
3,1.75,2000,9760,4,8,1400,600,320000
4,2.5,1160,16008,4,7,1160,0,415000
3,1.75,1600,16510,3,8,1600,0,490000
3,1,950,8000,3,7,950,0,335000
3,1.75,1380,5060,3,7,1380,0,375000
4,1.5,2270,6010,3,8,1290,980,676101
3,1.75,1444,249126,3,7,1444,0,420000
3,2,1990,65340,3,8,1990,0,500000
4,2.25,1600,6202,4,7,1600,0,257700
3,1.75,1910,4800,3,7,1080,830,700000
4,2.5,3560,11119,3,10,2290,1270,860000
3,1.75,1750,14400,4,7,1750,0,368000
3,1,1300,20812,3,6,1300,0,300000
3,1,970,9583,4,6,970,0,209950
2,1.5,1068,1158,3,7,1068,0,207000
5,3.25,2610,3642,3,8,2080,530,440000
5,2.75,2660,8737,5,8,1470,1190,1.10E+06
4,1.5,1940,8970,3,7,1270,670,306888
3,3.5,1320,1161,3,8,1320,0,345000
3,2.5,1430,2200,4,7,1430,0,720001
1,1,710,4725,3,6,710,0,264000
4,2.75,2840,4000,5,8,1960,880,870000
4,2,2280,43692,3,7,1140,1140,446000
6,2.75,2630,9420,5,9,2510,120,1.30E+06
3,2.25,1740,9488,4,8,1180,560,450000
3,2.5,2450,19744,3,10,2450,0,450000
4,2.5,3470,14271,3,9,3470,0,730000
4,2.5,1780,3600,3,7,1780,0,296000
3,2.5,1760,6477,4,8,1760,0,267000
4,2.5,2290,4450,3,9,2290,0,540000
3,1.75,2100,15480,3,7,2100,0,299000
3,1.5,1660,3190,3,7,1660,0,658000
4,1.75,2140,4959,3,7,1080,1060,350000
3,1.75,2030,10089,4,8,1330,700,485000
2,2.5,1680,975,3,9,1680,0,840000
3,2.25,2420,5304,5,7,1640,780,697000
3,1.75,1660,12865,5,7,1660,0,431000
3,2.75,2290,5002,4,9,1950,340,1.07E+06
3,2,1760,16928,3,7,1760,0,810000
3,1.75,1290,3870,5,7,1290,0,647500
3,1.75,1610,14182,4,7,1100,510,225000
4,2.5,3420,6233,3,9,3420,0,890900
3,2,1380,2500,3,7,750,630,435000
2,1,1070,3000,4,7,870,200,550000
5,2,1210,12538,3,7,1210,0,230000
4,2.5,2440,7491,4,10,2440,0,700000
2,2.25,1150,711,3,7,1150,0,338500
4,2.5,2230,5000,3,8,2230,0,305000
3,1,1060,8040,4,6,1060,0,385100
5,1.75,2240,4750,4,7,1120,1120,635000
4,1.75,1640,7194,4,7,1480,160,465000
4,1.75,2000,3750,5,8,1120,880,725000
3,2.75,3410,9360,4,8,3410,0,500000
3,1.5,1150,27319,4,6,1150,0,358000
3,2.5,2180,11100,3,8,1230,950,540000
2,1,990,4800,3,6,990,0,245000
3,3,2980,28000,3,10,1820,1160,675000
3,2,2070,9600,3,7,1590,480,1.35E+06
4,1.75,1680,6834,3,7,1680,0,375000
4,2.5,2460,9973,4,8,1560,900,640000
2,1,1430,8157,3,7,1150,280,350000
4,2.75,4030,10888,3,10,4030,0,912000
2,1.75,1440,5680,4,8,1440,0,210000
3,2.5,1690,3322,3,7,1690,0,479000
2,1,1000,4776,4,6,1000,0,332000
3,1,1190,85226,5,5,1190,0,390000
3,2.5,2300,9521,3,8,2300,0,435000
2,1,720,6345,3,6,720,0,240000
3,1.75,1760,6300,3,7,1060,700,224000
3,1,1390,6000,3,5,1390,0,230000
4,2.25,1830,7200,3,8,1750,80,1.25E+06
3,1.75,1510,10450,4,7,1510,0,593777
4,4.25,4980,13000,3,9,3080,1900,1.25E+06
4,2.5,2660,10452,3,9,2660,0,755000
3,1.5,1330,12500,3,7,1330,0,405000
3,2.5,3192,5653,3,8,3192,0,427000
3,1,1410,7419,3,7,1050,360,301500
3,1,1010,9920,3,6,1010,0,179900
2,2.25,1460,1607,3,8,1460,0,309950
4,3,2640,5267,3,7,2640,0,490000
3,3.5,1360,1419,3,8,1040,320,515000
2,1,1600,7936,3,7,1600,0,265000
4,2.5,2350,3150,4,8,1690,660,870300
3,1.75,1620,3360,5,7,980,640,532500
3,1,1180,4219,3,7,1060,120,435000
5,2.75,2481,4045,3,8,2481,0,309000
2,2.5,1640,1953,3,10,1640,0,669000
1,0.75,770,4600,4,6,770,0,315000
3,2.5,2370,12753,3,7,2370,0,499950
4,2.5,3420,8405,3,10,3420,0,840000
2,1,940,6000,3,6,940,0,115000
3,2.5,1570,2577,3,7,1570,0,299950
2,1,930,36478,3,6,930,0,675000
5,2.75,2540,5022,4,8,1540,1000,531000
2,1,800,8550,3,7,800,0,95000
3,2.5,1794,4769,3,7,1794,0,254950
5,1.75,2040,8996,4,7,1020,1020,561750
2,1,1190,5100,2,7,1190,0,417000
3,1.75,2410,51763,4,8,1410,1000,432000
4,0.75,1440,13300,3,6,1440,0,142500
3,2.5,2250,11632,3,8,2250,0,538000
3,2.5,1750,6725,3,7,1330,420,199000
2,1.5,1110,986,3,7,950,160,252500
2,2.25,2950,15593,4,8,1560,1390,1.55E+06
3,2.75,2390,7939,5,7,1610,780,405300
4,2.5,2560,4000,5,8,1610,950,825000
3,2.5,2070,4697,3,7,2070,0,405000
3,3,2470,7410,5,8,1860,610,811000
4,4.5,4490,24767,3,11,3800,690,1.39E+06
4,1.75,1500,1856,5,7,750,750,432500
3,1.75,2090,8910,3,8,1230,860,536650
4,2.5,3780,23623,3,9,3780,0,962800
3,1.75,1820,5500,4,8,1620,200,659500
4,2.75,3820,8850,3,10,3820,0,1.27E+06
3,1.75,1880,30346,3,8,1880,0,310000
4,3,2810,6000,3,9,2810,0,454450
4,1.5,1530,9000,4,6,1530,0,299800
4,1.75,2180,28710,3,8,1180,1000,210000
4,2.5,2155,8140,3,8,2155,0,358800
3,2.5,1890,4838,3,8,1730,160,269950
3,2.25,2300,9914,4,8,2300,0,680000
5,2.25,2900,10300,3,8,1450,1450,675000
5,3.75,4360,8504,3,10,3530,830,1.79E+06
2,2.25,1430,1210,3,8,1340,90,522500
3,2.25,1790,9927,4,7,1240,550,650000
3,2,1270,7198,3,7,1270,0,247000
4,1.75,2260,7200,5,7,1360,900,380000
3,2.25,1654,8464,3,7,1654,0,336600
3,1,1610,8579,4,7,1010,600,205000
3,1.5,1950,15954,4,8,1950,0,290000
3,2.5,1590,3411,3,7,1590,0,356000
2,2.5,1000,1092,3,7,990,10,220000
3,1,1570,7727,4,8,1270,300,404600
4,2,1780,7350,5,7,900,880,318500
4,1.75,1900,7313,3,7,1900,0,340000
4,2.5,2580,6260,3,7,2580,0,374000
4,1.5,1320,14250,4,7,1320,0,510000
3,1,1180,6000,3,7,1180,0,507000
2,1.75,840,3340,3,6,700,140,450000
3,1.75,1960,7705,4,7,980,980,355000
4,3.5,3217,4000,3,8,2587,630,458000
4,2.5,2510,5936,3,9,2510,0,665000
3,1,940,9198,3,7,940,0,347000
5,2.25,2500,13500,3,7,1850,650,467000
1,0.75,840,7203,3,6,840,0,224000
5,2.5,3180,13806,4,10,3180,0,800866
4,3.75,3790,7200,3,10,2530,1260,2.20E+06
5,2.75,1800,4500,4,7,1680,120,754300
4,1.75,2110,265716,4,8,2110,0,568000
4,1.75,1620,8132,3,8,1620,0,442200
3,2.5,1690,5131,3,7,1690,0,460000
4,2.5,2740,43101,3,9,2740,0,630000
3,1.5,1460,5040,3,7,1100,360,329932
5,3.5,3420,4216,3,9,2520,900,925000
2,2.25,1560,1705,3,8,1270,290,347000
4,3,2200,10800,3,6,2200,0,300000
1,1,1180,4000,4,8,840,340,713000
3,1.75,1910,12321,4,7,1100,810,746000
3,1,1010,11675,3,7,1010,0,166000
4,3.75,3160,9525,3,10,3160,0,1.38E+06
3,2.5,3560,9796,3,8,1860,1700,662500
3,2.5,2050,5694,3,8,2050,0,457000
4,2.25,2030,13500,3,7,1230,800,335000
4,1,800,8775,3,6,800,0,268750
3,3.25,1500,1442,3,8,1150,350,346000
3,1,1290,4720,3,6,790,500,256000
3,2,1470,6950,5,6,1470,0,344950
4,2.25,1890,8549,3,8,1890,0,525000
4,3.5,4350,6000,5,10,2970,1380,2.54E+06
2,1.5,830,1276,3,7,830,0,299000
3,3.25,3320,15022,3,10,3320,0,760000
2,1.5,1300,6120,3,6,820,480,300000
4,2.5,3280,25211,3,11,3280,0,810000
5,1.75,1930,8040,4,8,1930,0,218000
2,1,770,6000,3,6,770,0,395000
2,2.25,2290,9772,3,8,2290,0,737000
2,2.25,2320,18919,4,8,2320,0,600000
3,2.25,2550,4089,3,9,2550,0,834000
4,1.75,1240,4532,4,7,1240,0,520000
3,1,2020,19210,3,6,1760,260,415000
3,3.25,1370,1194,3,8,1370,0,460000
5,3.75,4130,226076,3,9,3170,960,900000
5,3.5,3300,7860,3,9,2410,890,789888
4,4,4460,103382,3,11,4460,0,1.15E+06
4,3,1800,2500,3,7,1800,0,250000
3,1,1200,4000,4,6,1200,0,438000
4,1.75,1560,8700,4,7,1560,0,382500
3,1.75,1760,6500,3,7,1150,610,240000
3,1.75,1870,8400,3,7,990,880,315500
4,2.5,3670,315374,4,9,3670,0,921500
3,2,1340,8505,3,6,1340,0,215000
2,1,820,5040,3,7,820,0,508000
3,2,2260,7163,3,9,2260,0,479950
4,4.75,4575,24085,5,10,3905,670,2.92E+06
5,2.5,3390,9760,5,8,1750,1640,460000
3,1.75,2140,13286,4,8,1220,920,577500
4,2.5,2100,1397,3,8,1580,520,546000
3,2,1250,1306,3,7,1250,0,491000
4,1.5,1920,6000,3,7,1920,0,406000
2,1,860,5000,3,7,860,0,199988
3,1.75,1600,9579,3,8,1180,420,525000
5,2.75,2710,4685,3,8,2710,0,430760
4,2.5,2170,7275,3,8,1820,350,638150
4,3,3350,23781,4,9,2020,1330,805000
5,2.5,2780,12335,4,8,1590,1190,582000
5,4.25,6490,10862,4,11,3940,2550,2.00E+06
4,2.75,2830,8126,3,8,2830,0,515500
4,2.5,3960,38615,3,10,3960,0,805000
4,3,3150,9703,3,9,3150,0,727000
3,2.25,2560,117176,4,9,1280,1280,465000
3,3,2180,2650,5,8,1410,770,634950
3,1.75,1250,7710,4,7,1250,0,338000
3,1.5,1630,10200,4,8,1300,330,246000
5,2.5,2000,3600,3,6,1150,850,474500
3,3.25,4030,6300,3,10,3630,400,1.31E+06
3,1.75,2050,9045,4,6,2050,0,273000
4,2.5,1950,4947,3,8,1950,0,449999
4,2.5,2660,9030,4,7,1450,1210,313100
4,2.5,3510,13100,4,10,3510,0,1.26E+06
4,2.25,2170,10000,3,8,1420,750,546800
4,2.75,3410,23000,4,10,3410,0,870000
3,2.25,1880,7350,3,8,1390,490,320000
3,1.75,1910,10230,4,7,1290,620,250000
2,1.5,950,865,3,8,950,0,396000
4,3.5,2500,3080,3,8,1810,690,599950
3,1,1230,9720,5,7,1230,0,220000
4,1.75,1630,5750,3,7,1160,470,575000
3,2,1980,7680,4,6,1070,910,606000
4,3,2340,7048,4,8,1340,1000,485000
3,1.5,1620,5108,3,7,1620,0,499100
4,2.5,1987,6000,3,7,1987,0,255000
3,2.25,2760,10160,3,8,2760,0,336000
3,2.25,1760,10013,4,8,1760,0,450000
3,1,1910,8167,4,8,1270,640,588000
3,1.75,1730,15003,3,7,1150,580,335000
3,1.5,1010,10350,3,7,1010,0,240000
5,3.5,3620,7821,3,10,2790,830,1.49E+06
2,0.75,550,7980,3,5,550,0,115000
3,1.75,1500,7475,4,8,1500,0,244000
3,2.25,1250,1017,3,8,1250,0,318000
3,1,1100,17334,3,7,1100,0,139000
3,2.5,1750,7490,4,7,1180,570,225000
3,1.75,2240,78225,5,8,2240,0,550000
3,1.75,1500,15246,3,6,1500,0,295000
3,1.75,1350,8737,3,7,1350,0,281000
4,2.5,2490,6537,3,8,2490,0,595500
5,2,2760,6420,5,7,1380,1380,399950
3,2.5,3380,7126,3,8,3380,0,749000
2,1.5,1090,4013,3,7,1090,0,685000
3,1,1090,10114,4,7,1090,0,140000
3,1.75,1850,8823,4,8,1370,480,605000
1,1,710,4000,4,6,610,100,390000
4,2.5,2020,8044,3,8,2020,0,633000
3,2.5,2490,7589,3,9,2490,0,572500
3,2,1420,1716,3,7,1050,370,320000
3,1.75,1770,3880,3,8,1300,470,667000
3,3,1850,19966,4,7,1090,760,287200
2,1,1090,3160,3,7,840,250,474000
2,1,720,4125,4,6,720,0,295000
5,2,2080,4000,4,6,1040,1040,467000
3,1,1030,6250,3,7,1030,0,253000
3,2.5,2390,34041,3,8,1840,550,339950
3,2.5,1640,10424,3,7,1640,0,350000
2,1.75,1550,4257,3,7,830,720,415000
3,1,1320,11457,3,8,1320,0,339950
3,2,1380,3500,3,7,1380,0,275000
2,1,700,4800,3,7,700,0,260000
4,2.5,2780,7290,3,8,2780,0,478000
3,2,980,5000,3,6,980,0,435000
2,1.75,1340,7250,5,5,700,640,269950
6,2.25,2770,5854,3,8,2120,650,685000
3,2.5,2000,7205,3,8,2000,0,325000
5,2.5,2810,6000,3,9,2810,0,1.17E+06
1,0.75,940,87120,3,6,940,0,250000
6,3,2470,9267,3,8,2470,0,609000
5,1.5,1500,7112,5,6,760,740,265000
4,2.75,2190,14937,3,8,2190,0,367300
3,1.75,1310,8670,4,6,1310,0,216000
4,3,2260,7336,4,7,2260,0,486000
4,2.5,2130,6003,3,8,2130,0,381000
3,1.5,1420,4500,3,7,1420,0,371000
3,2.5,2510,5400,3,9,2510,0,550000
3,2,1110,10500,5,7,1110,0,320000
2,1,670,6300,5,6,670,0,279000
4,2,1560,8800,5,6,1560,0,290000
4,2.25,1930,8338,3,8,1930,0,586000
2,1.5,1643,14616,4,7,1643,0,324950
3,1.75,1180,4000,3,7,1040,140,338900
3,2.5,2010,4059,3,8,2010,0,471000
3,1,1110,7603,3,7,1110,0,369950
3,1.75,1960,5520,4,7,1080,880,655000
2,1,1760,4441,3,8,1310,450,428950
4,1.75,1400,54014,4,7,1400,0,242025
4,1,1530,7920,3,7,1030,500,419950
3,1,1130,7000,3,6,830,300,460000
4,1.75,1570,16697,3,7,1030,540,525000
3,1.75,1700,6500,3,8,1700,0,559000
3,2,1230,6802,3,7,1230,0,554663
3,2.5,1580,1487,3,9,1580,0,779000
3,2.5,1350,874,3,8,1270,80,389500
3,1.5,1840,9990,5,8,1840,0,686000
3,3.5,1560,2198,3,8,1180,380,560000
3,2.25,1250,1033,3,8,1250,0,344000
3,1.75,1260,7200,3,7,1260,0,352000
3,2.25,2140,9990,4,8,2140,0,270000
3,2.25,2640,7544,3,10,2640,0,1.22E+06
3,1.75,1450,12125,4,7,1450,0,243000
4,1.5,1220,10580,3,7,1220,0,418000
3,2.5,3680,203860,3,9,3680,0,755000
3,1.5,1780,5000,4,7,1030,750,420000
2,1.5,1160,8060,4,7,1160,0,365000
4,3.75,3180,9889,3,9,2500,680,1.15E+06
3,2.5,1300,5150,4,7,1300,0,690000
4,1.5,2020,7560,4,7,2020,0,379000
3,2,1110,8375,5,7,1110,0,505000
3,1.5,1560,7884,3,7,1060,500,368000
5,2.5,2880,8216,3,8,2880,0,362000
3,2.5,3090,13316,3,10,3090,0,751000
3,3.5,4240,21578,3,10,3500,740,1.39E+06
4,2.5,2320,4142,3,7,2320,0,340000
3,1.75,1060,38644,3,7,1060,0,420000
5,2.5,2570,61855,4,7,1470,1100,449000
3,1.75,1890,9920,3,7,1230,660,385000
3,1.75,1630,9000,4,7,1630,0,431000
2,1,950,4800,3,6,950,0,445000
3,1,1640,6516,4,7,1440,200,750000
3,1,1290,12415,3,6,1290,0,300000
3,1.75,1940,9000,3,7,1290,650,287000
4,2.5,2030,4080,4,8,1730,300,730000
3,2.5,2060,8778,3,8,1160,900,731100
1,0.75,530,33278,4,4,530,0,355000
3,1,1430,5000,3,7,1430,0,552500
5,3.75,2800,9900,3,7,2800,0,255000
3,3.25,2200,4800,3,7,1910,290,818000
4,2.5,2540,28563,3,10,2540,0,775000
3,1,1290,6566,5,7,1290,0,205000
4,1.75,2180,10200,3,8,2000,180,440000
4,2,2920,10424,5,8,1520,1400,810000
4,3.25,3160,6327,3,9,2280,880,840000
3,2.5,2260,5500,3,7,1280,980,405000
3,2.5,1790,6371,3,8,1790,0,272000
2,1.75,1280,7110,4,7,1000,280,585000
3,2,1840,16815,5,7,960,880,390000
3,2.25,2070,7225,3,8,1690,380,300000
3,2.5,1340,4200,3,7,1340,0,217000
3,2.75,2540,8604,3,8,2540,0,359950
4,2.5,3170,8523,3,9,3170,0,820000
3,2.5,1420,1162,3,8,1420,0,349950
3,2.25,2440,8378,3,7,1480,960,565000
2,2.5,1780,2493,3,8,1780,0,631500
2,1,880,4000,3,7,880,0,525000
4,2.75,3110,6050,3,9,3110,0,799990
3,2.5,3100,23790,3,9,3100,0,759950
5,3.5,4050,13495,4,9,2230,1820,925000
4,3.25,4110,15929,3,12,2720,1390,2.30E+06
4,2.5,2643,5750,3,8,2643,0,376950
3,2.25,1670,1596,3,8,1670,0,539950
3,2.25,1481,2820,3,7,1481,0,240000
4,1.75,1490,10000,4,8,1100,390,269000
4,3.25,3440,4920,3,10,2520,920,1.35E+06
2,1,670,5140,3,6,670,0,183000
5,2.75,3320,23760,4,8,2190,1130,622500
3,1.5,1380,7600,4,7,790,590,235500
5,3,3490,6091,3,9,3490,0,715000
3,2.5,2550,10355,3,9,2550,0,547500
2,1,900,4500,3,7,900,0,263300
4,1.75,2000,6120,3,7,1100,900,228000
4,2,2560,7798,4,7,1890,670,640000
2,1,2080,14659,3,7,1040,1040,315000
4,2.5,2520,10850,4,8,1680,840,600000
2,2.25,2770,11884,4,8,1570,1200,645000
4,2.5,2350,8182,3,8,2350,0,367000
4,2,2360,7440,3,7,1180,1180,300000
3,1,1040,6800,5,6,1040,0,212000
4,2.5,2620,9525,4,9,2620,0,838400
2,1.5,1530,1012,3,8,1200,330,450000
4,2.5,3720,35000,3,10,3720,0,828500
4,2.5,2030,5754,3,8,2030,0,295000
3,2.5,1650,3076,3,7,1650,0,447000
3,2.25,1413,3403,3,8,1413,0,260000
3,1,840,8400,3,6,840,0,187500
3,2.25,1445,1028,3,7,1300,145,366000
3,1.5,2360,6750,5,7,1930,430,702500
3,2.5,3040,34670,4,10,3040,0,790000
3,2.5,2242,4500,3,8,2242,0,309780
3,1.75,1870,7030,3,7,1870,0,619100
3,2.75,2470,10125,3,8,2470,0,970500
3,1.5,1820,8585,4,7,1820,0,205000
3,1.5,1300,7313,4,7,1300,0,288000
3,1.75,1510,12408,4,7,1510,0,310650
3,2.75,3040,21052,4,10,3040,0,1.60E+06
3,2.25,1690,12662,5,7,1090,600,318000
3,2.25,1510,6000,4,7,1150,360,269950
3,2.5,2550,4240,3,7,2550,0,325000
2,1,950,9000,3,6,950,0,193000
4,3,2090,5102,3,7,1350,740,385000
3,2.25,1740,5460,3,7,1210,530,266500
4,2.25,2040,12000,4,7,1300,740,506000
5,1.5,2550,6300,4,7,1560,990,272000
2,1,710,1157,4,7,710,0,399950
3,2.5,1580,7918,3,7,1580,0,280000
3,2,1500,11233,3,7,1500,0,330000
4,2,2050,4400,4,9,2050,0,740000
3,2.5,1690,10113,3,7,1310,380,390000
3,1.75,1630,10001,4,7,1100,530,280000
4,2.5,2260,13600,4,8,1770,490,865000
3,2.25,2120,40518,3,8,2120,0,530000
3,1,1660,11200,3,7,1660,0,261000
4,2.5,3070,8086,3,10,3070,0,804100
3,1.75,1100,10125,4,7,1100,0,224000
4,1.75,2480,9195,3,7,1390,1090,780000
4,2.25,3230,9935,3,8,3230,0,625000
3,2.5,2090,7163,3,8,2090,0,299500
5,2.5,2780,9272,3,8,2780,0,550000
4,3,2430,7243,3,8,2430,0,410000
4,2.5,1880,9426,4,7,1880,0,306000
3,2.5,2360,12164,3,10,2360,0,625000
4,2.75,2790,5000,3,8,2790,0,484259
2,1,1130,8184,3,6,1130,0,322500
2,1,900,6000,3,7,900,0,451000
3,1.5,1570,1050,3,8,1570,0,792000
4,3,2483,5701,3,8,2483,0,331000
2,1,920,6600,4,6,920,0,365000
3,1.75,2110,11250,4,8,2110,0,743000
5,2.5,3320,7266,3,9,3320,0,805000
5,2.5,2140,10320,4,7,1330,810,270000
2,1.75,1900,5175,3,7,1200,700,539000
3,1.75,2050,5160,4,8,1300,750,739000
5,3.25,3500,7254,3,8,2760,740,632500
4,2.25,3190,11597,3,10,2300,890,750000
4,2.25,3070,9210,3,8,2740,330,664500
3,1.75,1010,8580,3,7,1010,0,350000
3,1,1240,5750,4,6,1240,0,425000
4,2.5,2970,9072,3,10,2970,0,845000
2,1,1140,3834,3,6,1140,0,320000
3,1.75,1920,9512,3,8,1440,480,417000
4,1.75,2220,7230,3,8,1280,940,675000
4,1.5,2550,5055,4,10,2550,0,952500
4,2.5,2220,5900,3,8,2220,0,652600
4,2,1480,15000,4,7,1480,0,275000
3,1.5,2605,12030,3,8,1355,1250,599900
3,1,1270,7153,5,6,1270,0,235000
4,2.75,2390,7330,3,7,2390,0,282000
2,1.75,2040,28593,4,7,2040,0,615000
4,2.5,2200,7719,3,8,2200,0,325000
4,3.5,3090,100835,3,9,3090,0,675000
6,3.25,3560,107362,4,8,2760,800,1.10E+06
4,2,2490,339332,3,8,2490,0,590000
2,1.5,1440,11954,4,8,1440,0,330000
3,2.25,1920,10961,3,8,1920,0,549000
3,1,990,7520,4,7,990,0,222000
4,2.5,2820,6983,3,9,2820,0,457000
3,2,1410,10248,3,7,1410,0,271920
4,2,2240,7085,3,7,2240,0,395000
4,2.25,2720,18295,4,8,2000,720,645000
2,1,750,6350,3,5,750,0,250000
2,1,1020,4002,5,7,1020,0,460000
5,3.25,3940,9780,3,9,3940,0,695000
3,3,1490,2944,3,7,960,530,390000
4,3.5,3420,49223,3,9,3420,0,679000
4,1.5,1570,8775,3,7,1570,0,228900
4,1,1680,4021,3,7,1680,0,700000
3,3.25,1570,1777,3,8,1260,310,570000
3,1.75,1970,10548,4,8,1300,670,678700
4,3.25,3740,11467,3,10,3740,0,1.14E+06
3,1.5,1540,3570,5,7,1490,50,565000
2,2.25,1160,1010,3,8,1000,160,495000
4,2.5,2520,7205,3,8,2520,0,335000
3,1.75,2430,9133,4,7,1410,1020,335000
4,2.5,2650,4120,3,8,2650,0,398651
4,1.75,2260,19500,3,8,1450,810,540000
4,2.75,2330,14175,3,7,1800,530,372000
3,2.25,1840,11403,3,8,1840,0,417000
4,3.5,4080,10666,3,9,4080,0,920000
3,2,2250,7904,3,8,2250,0,328000
3,1.75,2190,8000,4,8,2190,0,313000
4,2.5,4090,11225,3,10,4090,0,885000
3,1,1230,9877,3,7,1230,0,375000
2,3.25,1840,1500,3,8,1840,0,601450
3,2.5,1340,10018,4,7,1340,0,425000
4,1.75,1810,9750,4,7,1810,0,400000
3,2.25,2160,37000,4,7,1760,400,550000
2,1,1100,17817,3,7,620,480,325000
3,2.25,1830,11331,3,7,1250,580,230000
4,1.75,1880,4175,3,7,1090,790,475999
4,3.5,3500,9523,3,10,2460,1040,1.38E+06
3,2.5,3170,12750,3,10,2360,810,405000
3,2.5,1800,2791,3,8,1800,0,379900
4,2,1880,3840,3,7,970,910,435000
3,2.5,1470,4488,5,7,1470,0,399950
2,2,1180,2521,3,6,1180,0,215000
4,2.5,2490,9346,3,9,2490,0,364900
3,2.5,2120,5277,3,7,2120,0,561000
3,1.75,1290,4811,3,7,1290,0,163000
3,2.5,2830,6000,3,9,1730,1100,713414
2,1.5,1100,1228,3,7,900,200,343000
3,2,1820,17600,5,7,1820,0,320000
3,2.75,1160,1073,3,7,880,280,402723
3,2.25,1830,39165,5,8,1830,0,470000
4,2.75,2290,3060,5,7,1550,740,620000
3,1,1300,10125,4,6,1300,0,137000
3,2,1350,14200,3,7,1350,0,322500
3,2.5,1550,930,3,8,1060,490,445000
5,2,2420,21000,3,8,2420,0,675000
4,2.25,1990,7712,3,8,1210,780,627000
4,3.25,3470,5222,3,10,2830,640,1.50E+06
5,3.75,4450,7680,3,9,3460,990,1.30E+06
4,3.5,3320,19850,4,10,2040,1280,1.03E+06
5,2.5,1970,8605,4,7,1970,0,297000
4,4,4620,130208,3,10,4620,0,1.46E+06
3,2,1820,4080,3,8,1820,0,699000
4,1.75,1340,8700,3,6,1340,0,263000
2,1,880,9750,5,6,880,0,210000
2,1,770,6017,3,7,770,0,407500
4,3.5,4330,15335,4,11,3230,1100,1.70E+06
3,1.75,1360,18123,3,8,1360,0,350000
3,2.25,1660,3478,4,7,1100,560,620000
3,2.75,2020,9505,3,7,1260,760,401000
2,1,720,6400,4,6,720,0,285000
3,2.5,1620,5992,3,7,1620,0,345000
4,3,2430,5502,3,8,2430,0,425000
3,1.75,1300,7770,3,7,1300,0,360000
4,1,1550,4750,3,7,1550,0,533000
5,2,1590,9350,5,7,1060,530,247000
3,1.75,1630,1166,3,8,1020,610,541000
3,3,1730,1442,3,8,1440,290,357500
3,2.25,2600,14810,4,8,1490,1110,452000
5,3.25,4100,7578,3,10,4100,0,890000
4,2.5,2370,6000,3,8,2370,0,335000
4,2.75,2870,7200,3,9,2870,0,577288
6,2.75,2840,8346,5,8,1420,1420,665000
4,1.5,1880,11400,3,7,1280,600,455000
1,1,530,13679,4,6,530,0,400000
4,1.5,2290,8773,4,7,1330,960,425000
3,1.5,1190,20672,3,7,1190,0,375000
5,3,2480,7200,3,7,1560,920,360000
3,1,940,3000,3,7,940,0,520000
3,1,1290,6859,4,7,1290,0,535000
3,1.75,1460,7967,3,7,1040,420,186000
4,2.5,2800,5900,3,8,1660,1140,665000
4,2.5,2340,19850,3,9,2340,0,539000
3,2.5,1680,1683,3,9,1120,560,629950
3,2.5,1778,147823,3,7,1778,0,435000
4,1,1210,7740,3,7,1210,0,364000
3,2.25,1630,2520,3,7,1630,0,475000
3,1.5,1200,1848,3,8,1200,0,185000
3,1,1470,7350,3,7,1470,0,240000
4,1.75,2040,6000,5,7,1020,1020,500000
3,3.5,1650,1577,3,7,1100,550,495000
5,3.25,3680,10300,4,10,3680,0,1.48E+06
2,1,930,3200,3,7,930,0,500000
3,3,1730,1902,3,8,1730,0,566950
4,1,1500,5750,3,6,1500,0,277000
2,2.5,1050,1609,3,7,1050,0,325000
4,2.5,2500,5264,3,7,2500,0,336500
4,2.5,3420,17038,3,9,3420,0,720000
2,1,1090,6771,3,6,1090,0,340000
4,2.5,1950,2617,4,7,1250,700,519000
4,2.75,2500,26400,3,8,1780,720,368500
6,3.25,4440,17424,4,9,2220,2220,959000
3,1.75,1300,8976,3,7,1300,0,236000
2,1,700,5559,5,6,700,0,266000
4,3.25,3330,17533,3,9,1750,1580,975000
4,2.25,1800,4500,4,8,1800,0,321000
4,1.75,1510,9176,5,7,1510,0,402000
2,1.75,2510,19141,3,9,2510,0,368500
3,1.75,1400,9900,3,7,1400,0,850000
3,2.75,2370,8900,4,9,1670,700,1.00E+06
3,1.25,1510,13737,4,6,810,700,397500
3,2.25,1260,2556,3,7,1260,0,449500
3,1.75,1140,3395,5,7,620,520,424000
3,3,2480,5500,3,10,1730,750,1.39E+06
4,3.5,3040,7125,3,8,2240,800,415000
3,1,1240,6090,4,7,1240,0,305500
4,3,2580,7299,3,8,2580,0,449500
3,2.25,1950,9600,4,7,1200,750,260000
4,1.75,2120,7420,4,7,1060,1060,453000
5,3,2520,5500,3,8,1550,970,350000
3,2.5,2880,11443,4,9,2880,0,885000
3,2.5,3560,107290,3,10,3560,0,851000
4,2.5,1470,1612,3,7,980,490,228800
3,1.5,1490,8475,4,7,1490,0,412500
4,2.5,3290,6628,3,9,3290,0,715000
3,1.75,2010,9417,4,8,1500,510,335000
3,2.5,1740,3721,3,8,1740,0,257000
3,3.5,4500,21870,3,10,4500,0,785000
3,2.25,1606,1452,3,8,1606,0,417250
3,1,1040,8125,3,7,1040,0,210000
3,2.75,2050,3320,4,7,1580,470,613200
3,2.5,1610,6600,3,7,1610,0,250000
3,2.25,1830,19965,3,8,1400,430,430000
2,2,1310,2841,3,6,1310,0,218000
2,1,770,4000,5,5,770,0,413500
3,3.5,4080,217697,3,10,4080,0,900000
2,1.5,1380,209959,1,6,1380,0,270000
5,3,2640,3200,4,7,2140,500,739375
3,2,1440,4421,3,8,1440,0,413800
4,2.75,2820,13193,3,8,1860,960,615000
6,3.5,2120,5840,5,7,2120,0,317000
4,2.75,3460,13168,4,8,3460,0,460000
3,2.5,2970,9600,3,9,2970,0,820000
5,3.25,3060,11778,3,8,3060,0,708000
4,1.75,2100,11942,3,7,1030,1070,368000
3,1.75,1310,5000,4,7,1310,0,600000
4,1.5,1520,8800,4,7,1520,0,230000
3,3,1740,1100,3,8,1740,0,590000
2,1,920,4095,4,6,920,0,356000
4,1,1410,3376,5,7,1410,0,563000
5,3.5,3860,9600,4,8,2660,1200,670000
3,2.5,2740,5925,3,10,2740,0,1.16E+06
3,1,1360,73616,3,7,1360,0,415000
4,2.5,2550,4630,3,7,2550,0,537500
5,2.75,3060,7015,5,8,1600,1460,549900
4,2.5,2070,11286,3,8,2070,0,635000
3,3.25,3190,5283,3,9,3190,0,765000
3,2,2110,5150,5,6,1080,1030,516200
3,1,970,14850,3,7,970,0,184000
4,2.25,2020,8400,4,8,1350,670,496600
3,2,1980,12150,3,9,1980,0,479900
4,2.5,3060,27251,3,8,3060,0,369000
4,2.25,2270,12000,4,7,1360,910,420000
4,2.5,1850,5040,3,7,1230,620,449000
3,4.25,5150,7800,3,11,4170,980,2.25E+06
2,1.5,1030,4500,3,7,830,200,595000
3,2.25,1520,1464,3,8,1240,280,380000
3,1,1740,5247,3,7,1270,470,283000
2,2.5,1611,2210,3,10,1611,0,850000
3,1.5,1830,4000,4,7,1350,480,740000
3,2.5,1540,7120,3,7,770,770,485000
2,1.5,2060,7713,4,7,2060,0,213500
2,1,870,6552,3,6,870,0,240000
3,3,2400,4000,3,7,1860,540,852000
2,1,830,9000,3,6,830,0,235000
3,2.5,2570,5500,4,7,1320,1250,654000
3,1.75,1850,26445,4,7,1850,0,475000
4,2.5,2020,5501,3,7,2020,0,415000
2,1,1250,12507,5,7,1250,0,290000
4,2,1750,7245,4,7,1050,700,225000
3,2.5,1510,7300,3,7,1040,470,399950
3,2.25,1530,4580,3,7,1530,0,335000
4,2.5,2220,6233,3,7,2220,0,291375
3,1,1350,165092,5,6,1350,0,349990
4,2.5,2480,16360,5,7,1510,970,560000
4,1.5,1790,3952,4,8,1790,0,800000
3,1,1390,4820,4,7,910,480,350000
3,1.75,1350,7588,3,7,1350,0,241250
3,1.75,1100,8662,5,7,1100,0,421000
4,1.75,2660,3520,4,8,2080,580,896000
5,4,7320,217800,3,11,7320,0,1.14E+06
3,2.25,2560,8040,3,8,1510,1050,565000
3,2.5,2680,7836,3,8,2680,0,350000
4,2.75,3800,9606,3,9,3800,0,730000
4,1,3410,5000,5,8,2190,1220,1.04E+06
3,2.25,1880,11556,3,8,1880,0,550000
5,3.25,3030,7410,3,8,2150,880,580000
3,1.75,1350,9000,3,7,1350,0,304950
4,2.75,2580,11900,4,7,1620,960,358000
2,1,1050,5671,3,7,850,200,439000
3,2.25,1590,926,3,8,1590,0,484950
4,2.5,2370,10580,3,8,2370,0,383000
3,1.75,2270,13000,5,8,2270,0,475000
4,2.75,2790,10819,3,10,2790,0,765000
3,1,1520,10798,3,7,1520,0,375000
3,1.75,1320,10416,3,7,1320,0,243000
3,2.5,1730,7200,4,7,1730,0,250000
4,2.75,2410,6000,5,8,1410,1000,805000
4,2.25,2410,4560,5,9,1800,610,960000
2,2.5,1620,3795,3,7,1620,0,272167
4,3,1670,1189,3,8,1427,243,582000
4,3.25,2330,9687,3,9,2330,0,1.30E+06
5,2.75,3160,10059,3,10,1740,1420,540000
4,2,1970,7451,3,8,1350,620,352500
3,1,970,7503,4,6,970,0,165000
3,1,1280,4875,5,6,1280,0,180000
3,1,1290,8470,4,7,970,320,225000
3,2,1610,14046,3,7,1610,0,259000
3,2.5,1790,4038,3,8,1790,0,541000
3,2.5,2360,8764,3,8,2360,0,290000
3,2.75,2910,3094,5,7,2010,900,780000
3,3.25,1430,1276,3,8,1430,0,535000
3,2.5,1990,1891,3,9,1990,0,1.08E+06
3,2.25,1430,800,3,8,1140,290,384000
4,2.25,1980,7081,3,7,1470,510,287000
4,2.25,2050,9583,3,8,1770,280,386000
3,1,1170,6700,3,8,1170,0,415000
3,2.25,1430,5999,3,7,1430,0,221000
6,3,3320,15600,4,8,1660,1660,400000
3,2.25,2160,9612,3,7,2160,0,277000
3,2.25,1420,1309,3,8,1420,0,510000
3,2.25,1489,2800,3,7,1489,0,265000
5,1.5,1720,12551,3,7,1720,0,435000
3,1.75,1650,7276,4,7,1150,500,715000
3,1.75,1930,5400,3,9,1930,0,605000
4,2.75,2200,13498,3,8,2200,0,345000
3,3.25,2080,3025,4,8,1220,860,969500
3,2.5,2290,3475,3,9,2290,0,653000
1,0.5,880,1642,3,6,500,380,255000
7,4,2690,10880,4,8,2690,0,597157
3,2.5,2200,1970,3,9,1610,590,1.05E+06
7,3.5,3470,16264,4,9,3470,0,950000
3,2.25,2370,9619,4,8,1650,720,746000
4,3,3150,6175,3,9,3150,0,680000
5,3.25,3680,6060,5,9,2630,1050,1.85E+06
2,1,1270,3008,4,6,650,620,235000
4,2.5,2230,5000,3,7,1650,580,448000
4,2.5,2650,4644,3,8,2650,0,731500
2,2.25,1370,1248,3,7,1200,170,555000
3,2.5,2190,10370,3,9,2190,0,665000
2,1,1020,5130,4,6,1020,0,175000
3,1,1380,7575,4,7,1380,0,295000
4,2.5,3240,7621,3,9,3240,0,870000
3,1,1160,10518,3,7,1160,0,351000
3,2.5,2420,8856,3,9,1620,800,755000
3,2.5,1610,10292,4,7,1190,420,390000
4,2.25,1780,10416,5,7,1060,720,350000
4,2.25,2570,9503,3,8,2570,0,439000
3,3.5,4410,10756,3,11,3430,980,3.00E+06
2,2.25,1170,1313,3,8,1170,0,512000
4,2.5,2240,9385,3,8,2240,0,590000
4,1.75,1370,9993,3,6,1370,0,325000
4,2.5,2550,7555,3,8,2550,0,340000
4,1.75,1730,11700,3,7,880,850,465000
4,2,1900,5100,3,6,950,950,410000
4,2.25,1860,12693,3,8,1140,720,266000
2,1,850,3276,3,6,850,0,389000
3,2.5,2060,10839,3,8,2060,0,585000
4,3.25,3450,11240,4,10,2430,1020,1.04E+06
3,1.75,1660,10440,3,7,1040,620,288000
4,2.5,3110,5048,3,8,3110,0,386500
3,1,960,7200,4,6,960,0,215000
2,1,1130,5070,4,7,1130,0,325000
3,1,1030,8164,4,7,1030,0,332500
2,1.75,1240,4120,4,7,890,350,540000
1,1,820,1060,3,8,760,60,219500
2,1,1140,10404,3,5,1140,0,275000
4,3.5,4000,15253,3,9,4000,0,762000
3,1.75,1730,9211,3,8,1730,0,400000
3,1.75,3320,478288,4,8,2260,1060,667000
3,2.5,3360,8708,3,9,3360,0,850000
5,2.25,3060,13630,3,10,3060,0,749999
3,1,1250,6250,2,7,1030,220,155000
3,1,1670,5200,5,7,1030,640,282000
4,2.5,2100,7355,5,7,2100,0,399000
3,1.75,1400,6956,4,7,1400,0,230000
3,1.5,1780,12231,4,8,1780,0,285000
4,1,1200,2171,3,7,1200,0,380000
3,2.25,1720,7885,3,8,1720,0,290256
4,2.5,2690,18653,3,8,2690,0,645000
2,1.75,1330,4903,3,7,1330,0,440000
3,1.75,1660,4800,3,7,960,700,530000
2,1,2160,2192,5,8,1170,990,625000
4,1.5,2120,8554,4,7,1170,950,249500
3,1,1380,7470,5,7,1380,0,335000
2,1.75,1280,8500,3,7,1280,0,595000
3,1,1120,7320,4,7,1120,0,355200
3,2,1430,10850,3,7,1430,0,234950
5,5,5774,31675,3,11,4490,1284,740000
4,2.5,3570,6218,3,9,3570,0,942990
3,1,1410,5120,3,6,1210,200,294350
5,3.75,2980,4635,3,8,2980,0,598200
4,2,1410,4480,3,8,1410,0,625000
3,1,1560,4500,5,7,1560,0,669000
3,1.5,1240,9125,4,7,1240,0,275000
3,1.5,1200,7236,3,7,1200,0,361000
3,2.25,2040,130680,3,9,2040,0,730000
4,2,2490,4700,4,7,1690,800,700000
3,2.5,2100,6021,3,7,2100,0,277950
3,2.25,2630,9916,4,9,2630,0,340000
3,2.5,3490,8343,4,9,2150,1340,1.68E+06
4,2.75,2400,3844,5,7,1200,1200,403500
3,2,1840,14985,3,7,1840,0,560000
3,2.5,1770,5146,3,7,1770,0,375000
2,1.5,1400,4050,4,8,1400,0,699000
4,2.5,2630,4000,3,8,2630,0,655000
3,1,790,6750,2,6,790,0,170000
4,4.25,4930,25714,3,12,4930,0,835000
3,1,1030,9834,3,7,1030,0,326000
4,2,2190,3622,5,8,1990,200,625000
3,1,870,5330,3,6,870,0,180000
4,1,1320,11212,5,6,1320,0,250000
3,1.75,1710,5000,4,7,1360,350,561000
2,1,830,2820,4,7,830,0,519000
3,1.75,1450,61419,4,8,1450,0,365000
4,2.25,3550,13900,3,8,1830,1720,859000
5,1,3020,4800,3,7,3020,0,630000
4,2.5,1975,8734,3,7,1975,0,311000
4,2.5,2890,17349,3,8,2890,0,300000
2,1,1420,5332,3,8,1070,350,641000
4,2.5,3220,5120,3,9,2420,800,558000
3,3.25,3020,6073,4,9,3020,0,1.40E+06
3,1.75,1150,17585,3,7,1150,0,361000
2,1,750,6439,4,6,750,0,338000
4,2.25,1800,2752,3,8,1800,0,352800
2,0.75,1130,11429,3,7,1130,0,204950
4,2.75,2150,9820,4,8,1220,930,470000
4,2.5,2110,6295,3,8,2110,0,320000
3,1,1230,10170,3,7,1230,0,255000
4,2.5,2060,8968,4,7,1190,870,459500
3,1.5,1660,5100,4,7,1210,450,515000
3,1,2710,19000,4,7,2710,0,410000
3,1.5,1270,1318,3,7,1080,190,386000
5,2.25,2000,7900,4,7,1300,700,330000
2,2,2370,217800,3,7,1600,770,543000
3,2.5,2240,6396,3,7,2240,0,432500
3,2.25,1260,3000,3,7,1260,0,477000
3,1.75,1460,22651,4,7,1460,0,395000
3,1.75,1720,5280,4,8,900,820,465000
4,2.5,2910,7287,3,8,2910,0,595000
3,1.75,2380,5650,4,8,1190,1190,415000
3,1.75,1430,12632,3,7,1430,0,487000
3,2.25,1840,9040,3,8,1370,470,285000
4,3.5,4730,47870,3,10,2940,1790,3.40E+06
2,1,1030,6000,3,7,1030,0,305000
3,2.5,1250,1150,3,8,1080,170,308000
3,1.75,4060,136290,3,8,2810,1250,718000
3,2.5,1820,6785,3,7,1420,400,245000
3,2.5,2650,144183,3,8,2650,0,425000
2,1,800,3090,4,6,800,0,339950
2,2,1870,6275,3,8,1870,0,579000
4,2,1780,15648,5,8,1780,0,1.00E+06
4,3.5,3490,87497,3,9,3490,0,728000
2,2.5,750,1430,3,8,750,0,375000
3,1.75,2080,3000,4,7,1040,1040,495000
3,1,900,4750,4,6,900,0,89000
3,2.5,3400,38400,3,8,1870,1530,825000
1,1,670,5750,3,7,670,0,334000
3,2.25,1960,7000,3,8,1600,360,355000
3,1.75,1820,8740,4,8,1820,0,247000
3,1,1230,9568,5,7,1230,0,387000
4,2.5,2610,7091,3,9,2610,0,325000
2,2.75,1770,10534,3,8,1210,560,279000
3,2,1750,4990,3,7,950,800,477000
2,1,1060,7868,3,7,1060,0,294950
4,3,3720,29043,3,9,3720,0,857000
3,1,1040,4480,3,7,870,170,642000
4,2.5,3550,35689,4,9,3550,0,730000
1,1,630,5150,4,5,630,0,396000
6,3.75,4090,49542,3,9,3100,990,1.15E+06
4,1.75,1630,6120,5,7,980,650,540000
4,1.5,1280,7400,3,7,1280,0,367400
3,1,1280,7572,4,6,1280,0,175000
2,1,720,6321,3,6,720,0,235000
4,4.5,3080,10550,3,8,1940,1140,1.40E+06
2,2,1870,5143,3,8,1870,0,572000
3,1.75,1470,7350,3,8,1470,0,432500
3,1.75,1430,8400,4,7,1430,0,440000
3,2,1490,1286,3,8,1490,0,429900
4,2.75,2990,6626,3,9,2990,0,814950
4,2.5,2390,6976,3,7,2390,0,345000
3,2.5,1270,2509,3,8,1270,0,343000
6,2.75,2730,5000,3,8,1780,950,733000
3,1.75,1260,9600,4,7,1260,0,291500
3,2.5,1480,9743,4,7,1480,0,269950
2,2,1350,1209,3,8,1350,0,455000
4,2.5,2150,37647,3,8,2150,0,380000
4,2.75,2630,7505,3,8,2630,0,725000
3,2.5,1730,6653,4,7,1360,370,269000
2,2,1140,690,3,8,760,380,570000
4,2.5,3220,9328,3,8,3220,0,550000
3,1.75,2150,19127,3,7,1650,500,369900
5,2.75,3710,13874,4,9,2340,1370,1.25E+06
3,1,1250,150117,3,7,1250,0,475000
6,3,2390,4000,3,7,2390,0,462500
2,2.25,1000,905,3,8,1000,0,305000
4,1.75,2290,7765,3,6,2290,0,247500
4,2.5,2340,8971,3,9,2340,0,590000
3,1.75,1760,3520,3,7,1160,600,410000
6,1.75,2210,8594,3,7,1310,900,240000
6,3,2880,6800,3,7,2880,0,751000
5,2.5,3020,24750,3,8,1650,1370,449228
2,1.75,1090,4590,4,7,790,300,417000
4,1.5,1690,9391,3,7,1290,400,420000
3,2,1400,8821,3,7,1400,0,231200
3,2.5,3110,6000,3,8,1560,1550,435000
3,2.5,1690,4851,3,7,1690,0,499000
3,3,2400,3192,3,7,2400,0,570000
4,2.5,2570,7980,3,9,2570,0,715000
5,3.75,3570,10125,3,10,3570,0,1.60E+06
2,1,960,8236,2,6,960,0,99000
3,1.75,1230,8250,3,7,1230,0,280000
4,2.75,2910,9000,4,8,2130,780,539950
3,2.5,1553,1991,3,8,1553,0,412000
3,3.5,1730,1349,3,9,1350,380,635000
3,1,1020,7650,3,6,1020,0,625000
5,2.25,1820,10500,4,7,1080,740,275000
3,1.75,1640,3400,4,7,930,710,505400
3,2.5,2700,7434,3,9,2700,0,525000
3,1.75,1260,6908,3,7,1260,0,245000
2,1,600,6120,3,5,600,0,135000
3,2.5,2530,13446,3,9,2530,0,435000
2,1,840,5100,4,7,840,0,471000
4,3.25,3230,4838,3,9,3230,0,572115
4,1,1220,5120,5,6,1220,0,231000
4,2.5,2500,8434,4,8,2500,0,684000
3,2.25,1420,7800,4,7,1130,290,270000
3,1.75,1680,2400,5,7,870,810,591000
3,1,1400,8100,3,6,1400,0,267000
2,2,1520,1020,3,7,1520,0,307300
3,2.5,2090,32718,3,7,1550,540,400000
4,2.75,2940,4232,3,9,2940,0,710000
3,1.75,1740,6220,4,6,1740,0,395000
3,1.75,1460,7361,3,6,1460,0,265800
5,1.75,2590,9394,4,7,1390,1200,368000
4,2.5,2130,4496,3,7,2130,0,215000
3,2,2070,4200,4,7,1670,400,662500
4,1,1370,41194,5,5,1370,0,255500
2,2,1300,6515,3,8,1300,0,439888
5,1.5,2000,8100,3,6,2000,0,245000
5,2.5,3361,6983,3,10,3361,0,511000
3,1,1060,7920,4,7,1060,0,326500
3,2.5,2560,3600,3,9,2110,450,1.40E+06
4,2.5,2750,15099,3,8,2750,0,535000
3,1.5,1410,8800,4,7,1410,0,226740
3,2,1670,7700,3,7,1170,500,424000
3,2.5,1600,3172,3,7,1600,0,440500
4,3.5,2700,443440,3,8,2700,0,569950
3,1.75,2450,15001,3,7,1980,470,399950
4,2.5,2930,5973,3,10,2930,0,422000
3,1.75,1290,1237,3,7,1060,230,288790
4,2.75,3340,7230,3,9,3340,0,808000
3,2.25,1450,13439,4,7,1180,270,265000
2,1.75,2040,8600,4,6,1430,610,210500
3,2.5,1530,2890,3,7,1530,0,320000
2,1.5,1360,1934,4,7,1360,0,150000
3,1,950,10723,4,6,950,0,285000
3,1.75,1520,7500,3,8,1520,0,249000
2,1.75,1060,1202,3,7,760,300,335000
4,3.75,2130,34689,3,9,2130,0,1.34E+06
3,1.75,1550,7200,3,7,1100,450,453000
5,2.75,3190,5857,3,9,3190,0,544800
3,1.5,1480,9086,3,7,1480,0,305000
3,2.25,1600,7620,3,7,1280,320,370000
3,3,2920,23085,3,7,1540,1380,555000
3,1,1430,5000,4,6,1080,350,552000
3,1,1380,10875,3,7,1380,0,299500
3,2.25,1940,8312,4,7,1220,720,450000
5,3.5,2815,4900,3,9,2815,0,491000
5,2.75,3320,10500,4,7,2020,1300,687500
3,2,1260,7560,5,6,1260,0,375000
3,1.5,970,5488,3,7,970,0,209500
4,1.75,3080,6500,4,9,1700,1380,1.14E+06
3,1,1270,3840,3,7,1270,0,540000
3,1.75,1520,12246,4,6,1520,0,235000
3,1.75,1900,36769,3,8,1900,0,335000
5,3.5,4390,10140,3,9,3350,1040,971000
4,1.75,2610,21600,4,8,2610,0,1.30E+06
3,2.5,1730,7202,3,7,1330,400,379260
3,1,1160,10732,3,7,1160,0,875000
3,2.5,2440,10363,3,9,2440,0,620000
3,2.5,2100,6825,3,8,2100,0,305000
3,2.25,1570,6810,3,8,1180,390,485000
3,2,1860,3600,3,7,1110,750,590000
4,2.5,2780,6369,3,8,1590,1190,505000
4,1.75,2620,11041,4,9,2620,0,720000
3,1,1350,14212,4,6,1350,0,335000
3,1,1240,5250,4,6,1240,0,221000
5,3,2630,3149,3,8,1670,960,420000
3,1,960,12527,3,7,960,0,550000
1,1,970,7639,4,5,570,400,215000
3,2,1240,11172,3,7,1000,240,401000
3,2.5,2520,53143,3,7,2520,0,499500
4,3.25,4400,186846,4,9,4400,0,687000
2,1.5,1140,7620,4,6,1140,0,379900
3,1,1860,44431,4,6,1860,0,1.05E+06
3,1,1830,12036,3,7,1550,280,347500
4,3.5,4280,9583,3,11,4280,0,1.60E+06
3,1.75,1570,4375,3,7,970,600,560000
3,1.25,1230,4500,4,7,1230,0,275000
3,2.5,2230,5050,3,7,2230,0,333700
8,3,2850,12714,3,7,2850,0,373000
3,1.75,1600,2538,3,7,1600,0,845000
4,2.5,2180,7203,4,8,2180,0,464000
4,2,1700,21780,4,6,1080,620,445000
4,2.25,1830,5720,3,7,1830,0,295000
3,2,1260,5612,4,7,1260,0,325000
5,2.75,3020,9187,3,9,3020,0,880000
4,2.5,2770,10274,3,9,2770,0,675750
3,1,1150,8924,3,6,1150,0,120000
5,2.25,2880,11965,4,8,2880,0,382000
4,3.5,3770,8501,3,10,3770,0,1.02E+06
2,1,630,6550,3,5,630,0,315000
4,5.25,4670,43950,3,12,4670,0,1.42E+06
2,2,1770,7607,4,8,1770,0,360000
4,2.5,2510,7992,3,8,1610,900,319000
3,1,1380,8147,4,7,1380,0,380000
5,2,2000,3000,3,6,1200,800,464000
5,3,2240,94960,3,6,2240,0,313500
4,1.75,2120,4000,4,8,1920,200,980000
3,1,1090,17630,4,7,1090,0,197000
3,1.5,1870,9000,3,7,1120,750,350000
3,2.5,2280,18241,3,9,960,1320,557000
3,2.25,2820,8100,4,7,1720,1100,297975
5,1,2480,4400,3,7,1640,840,540000
2,1,1420,4635,4,7,1420,0,496000
4,2.5,2240,5402,3,8,2240,0,556000
2,1.5,830,1077,3,7,830,0,350000
2,1.75,1060,4182,3,7,1060,0,420000
4,2.5,3520,35991,4,10,3520,0,864500
4,1,1680,4087,3,7,1680,0,709000
5,3,3730,5500,3,7,2160,1570,979700
3,2,1940,40588,3,7,1940,0,362500
4,2.5,3150,4203,3,9,3150,0,815000
3,2.5,1260,3855,3,8,1260,0,300000
4,2.5,3180,20870,3,8,2120,1060,523000
3,1.75,1740,5500,5,7,970,770,577000
3,2,1880,9659,3,8,1180,700,475000
3,1.75,1610,12555,3,7,1080,530,512000
3,1,1380,4635,4,6,1380,0,475000
4,2.25,3180,9600,3,10,3180,0,725000
4,1.5,1580,5000,3,7,1390,190,535000
3,1.5,1790,7526,3,7,1790,0,865000
4,3.25,5180,19850,3,12,3540,1640,2.25E+06
3,2.25,1750,8400,3,7,1350,400,270000
2,2,800,5765,4,6,800,0,278750
4,2,1470,10291,4,7,1470,0,465000
4,3.25,3320,8587,3,11,2950,370,1.00E+06
5,3.5,4390,6220,3,9,3170,1220,1.88E+06
4,2.5,2420,8056,3,8,1680,740,550000
3,2.25,2190,8834,3,7,1390,800,194250
3,2.5,3600,21399,3,9,2310,1290,1.36E+06
3,1.5,1710,4500,3,8,1410,300,462000
3,2.5,2220,60984,4,8,2220,0,475000
4,1.75,2480,60548,4,7,1600,880,420000
4,2.25,2210,8862,4,8,1270,940,465000
5,2.25,3740,32481,3,8,2240,1500,392000
3,1.75,1430,4850,3,7,930,500,284000
3,2,1360,6082,3,7,1360,0,249000
5,2.75,3500,5040,3,9,2950,550,970000
4,2.25,2260,7200,4,7,2260,0,289659
3,2.5,3150,20189,3,10,3150,0,570000
4,3.25,2960,4296,3,9,2190,770,1.14E+06
3,2.5,2020,7800,4,7,1330,690,444950
2,1,1430,12092,4,7,1430,0,460000
3,3,3460,5353,3,10,2850,610,1.25E+06
3,1.75,1430,13399,4,7,900,530,215000
4,3.75,4120,8258,3,10,4120,0,949950
4,2.75,4910,15139,4,10,2560,2350,1.54E+06
3,1,1130,3600,3,6,1130,0,261500
3,2,2140,7200,4,8,1480,660,346150
3,2.5,1650,2201,3,8,1650,0,428000
4,2,1870,6000,3,7,1870,0,310000
4,2.5,3190,7869,3,9,3190,0,725995
2,1,1040,7372,5,7,840,200,380000
3,2.75,2390,21804,3,8,1450,940,623000
4,2.5,1990,9656,3,7,1990,0,264950
3,1,1050,7577,3,7,1050,0,194000
5,4.75,6390,13180,3,10,4560,1830,2.47E+06
1,2,1240,4800,3,6,1240,0,290000
4,2,2080,13510,3,7,1040,1040,248000
2,1,900,28800,1,6,900,0,235000
3,2.75,2690,10443,3,9,2690,0,829000
3,2.5,1870,5000,3,7,1870,0,270000
4,1,1660,6075,5,7,1660,0,680000
4,1,1300,8400,4,7,1300,0,315000
4,1.75,1710,10480,4,6,1710,0,320000
3,2,1340,9750,4,7,890,450,324950
2,1,950,5650,5,6,950,0,290000
3,2.5,2200,4052,3,8,2200,0,365000
3,1.75,1400,2003,4,8,700,700,460000
2,1.5,1010,7719,3,7,1010,0,306888
4,1,1170,5400,5,6,1170,0,299950
4,2.5,2070,7476,3,8,2070,0,300000
2,1,900,9260,3,7,900,0,496000
3,2.25,2100,8201,3,8,1620,480,445000
3,2.5,2200,4692,3,8,2200,0,480000
3,1,1100,6000,2,6,1100,0,174900
3,1.75,1640,4579,4,6,1640,0,443000
4,3,2370,3836,3,9,1750,620,957000
3,2,2220,209523,3,7,2220,0,585000
4,2.25,2220,15232,3,9,1690,530,464000
2,2,1290,9041,3,7,950,340,275000
4,4.75,5310,57346,4,11,5310,0,1.37E+06
5,4.25,3920,11412,3,7,3920,0,650500
4,2.25,2590,36256,3,8,2590,0,550000
3,1,1150,8000,4,6,1150,0,168000
3,2.75,2200,14925,3,6,1100,1100,432000
4,2.5,2430,14400,5,8,1670,760,645000
4,1.5,1470,5850,4,7,810,660,426000
4,2.25,3490,8400,4,8,3490,0,449950
5,4.5,4820,13165,4,11,3950,870,1.06E+06
3,2.75,2300,8000,3,7,1430,870,420000
4,2.75,2160,4205,3,7,1080,1080,590000
2,1,910,6282,4,7,910,0,412000
4,1,1360,11175,3,7,1360,0,197000
4,2.5,2910,6338,3,8,2910,0,549000
3,1.75,1780,9660,3,7,1780,0,438000
3,1.5,1420,8580,3,6,1420,0,136500
3,1,1540,7740,4,7,1540,0,384950
4,2,1930,3240,4,7,1930,0,631000
4,2,1540,5000,4,7,1540,0,550000
3,1.75,1430,11761,4,8,1430,0,462600
3,1,940,12521,4,7,940,0,430000
3,1.75,1520,9600,3,8,1520,0,240000
4,2.5,2630,6247,3,8,2630,0,575000
4,2.5,3320,8325,5,10,3320,0,1.80E+06
3,2,1510,3760,5,7,930,580,520000
4,4.25,3500,8750,5,9,2140,1360,1.08E+06
4,2,1850,11700,4,8,1850,0,385000
2,2.25,1140,1184,3,8,1010,130,399950
2,1,970,3400,3,7,970,0,546000
4,2.5,3060,7161,3,8,2860,200,520000
1,1,610,6000,4,5,610,0,314200
3,1.75,1300,8099,4,7,1080,220,275000
3,3,2880,3750,3,9,2220,660,1.00E+06
2,1,940,9458,3,6,940,0,265000
5,2.5,3190,8160,3,9,3190,0,865000
3,2,1580,5289,3,7,870,710,563000
3,1.5,1340,8450,4,7,1340,0,255000
3,1.5,1500,11616,3,7,1100,400,230000
4,2.75,3340,5677,3,9,3340,0,799000
3,1,1370,6001,5,7,1230,140,447000
4,2.5,3600,203425,3,9,3400,200,682000
2,1,940,5040,3,7,940,0,212700
6,2.75,2520,54160,3,7,2520,0,975000
4,1,1550,7620,3,7,1550,0,345000
3,1,1200,8360,2,6,1200,0,160000
4,1.75,2520,11017,4,7,1320,1200,425000
3,1,1210,4872,4,6,1210,0,465000
4,2.25,3070,16028,3,9,1870,1200,1.23E+06
4,2.75,3190,10970,3,10,3190,0,687500
3,2,1580,14398,3,7,1080,500,617450
3,1.75,2120,11340,4,7,1060,1060,368000
3,2.25,1880,10880,3,8,1480,400,535900
5,3.5,2440,10200,4,7,2440,0,519950
2,2,1730,4248,3,7,1730,0,450000
3,2.5,3610,26359,3,8,1950,1660,635000
6,7.75,9890,31374,3,13,8860,1030,6.89E+06
2,1,810,9882,3,6,810,0,170000
3,2.25,998,904,3,7,798,200,324000
5,3.25,3760,9792,3,9,2550,1210,851000
3,2.5,1990,3478,3,10,1520,470,450000
3,1,1410,40500,4,7,1410,0,288000
2,2,1405,1073,3,8,1140,265,405000
2,1.75,1300,4000,3,7,1300,0,440000
4,2,2150,14161,3,8,1330,820,530000
2,1,990,5643,3,7,870,120,435000
4,2.25,2280,8550,3,8,1660,620,539500
4,2.5,2590,7910,3,9,2590,0,799000
2,0.75,1440,3700,3,7,1200,240,562100
2,1,840,5551,3,6,840,0,350000
3,2,1360,5120,4,6,910,450,430000
2,1.75,2770,19700,3,8,1780,990,575000
3,1,1580,13912,4,8,1580,0,424000
4,2.5,2210,9427,3,7,2210,0,375000
5,1,1710,9100,4,7,1320,390,560000
4,3.75,4475,20424,3,12,2659,1816,2.57E+06
4,1.75,2480,11010,4,9,1630,850,840000
3,2.25,2140,3000,3,9,2140,0,780000
4,2.5,2790,5423,3,9,2790,0,685100
4,2.25,2280,6660,3,8,1960,320,820000
3,2,1440,7425,4,7,1440,0,405000
4,3.5,3560,6562,3,10,3560,0,882990
4,2,1350,942,3,7,1350,0,304500
3,1.5,1610,9964,3,7,1080,530,514000
3,2.75,1740,8436,3,7,1140,600,239999
3,1.75,1280,16200,3,8,1030,250,340000
2,1.5,2070,5432,3,7,1370,700,500000
3,2.5,2950,10254,3,9,2950,0,554950
3,1,1360,20000,4,7,1360,0,159000
4,1.75,1790,5341,4,7,1050,740,297000
3,3.5,1900,2133,3,8,1520,380,420000
6,2,2210,9870,4,7,2210,0,360000
2,1,1140,3750,4,7,1140,0,517000
3,2.25,1780,3665,3,8,1780,0,499000
3,1.75,1730,11986,5,6,1730,0,340000
2,2.5,1660,2258,3,7,1660,0,160000
3,2.25,1230,1097,3,8,1230,0,440000
3,2.5,2170,1984,3,8,2170,0,645000
3,2.25,990,736,3,8,880,110,384000
4,2,1780,19843,3,7,1780,0,272000
3,2.25,1800,36704,4,8,1360,440,410000
3,1,940,8377,4,7,940,0,725000
5,4.5,5620,5800,3,11,4700,920,1.57E+06
3,2.5,2594,4455,3,8,2594,0,351000
4,2.5,3810,7728,3,9,3810,0,878000
5,1,1860,3040,3,7,1530,330,775000
3,2.5,2480,5007,3,8,1960,520,775000
4,2,2640,5000,3,7,2040,600,750000
2,2,1070,649,3,9,720,350,259950
4,3,2710,7199,4,7,1710,1000,258000
4,2.75,2830,13059,3,10,2830,0,744000
3,3,3760,8500,4,10,3060,700,1.25E+06
3,1.75,2010,4905,5,7,1230,780,700000
3,3.25,2440,2812,3,8,1710,730,613000
2,1,630,6000,3,6,630,0,190000
3,2.5,1830,8372,3,8,1830,0,236775
3,2.25,1670,1596,3,8,1220,450,505000
4,2.5,3840,12151,3,10,3840,0,884250
5,2.75,2570,12906,3,8,2570,0,675000
4,1.75,1960,9300,5,7,1340,620,372000
5,3.5,3130,4797,3,9,2570,560,866059
2,1,830,9000,3,6,830,0,85000
3,2.5,1900,18414,3,8,1900,0,552775
4,2.5,2009,4800,3,8,2009,0,279000
4,3,1680,6003,3,7,1150,530,230000
3,3,3040,5067,3,10,3040,0,653000
4,2.5,2800,72309,3,9,2800,0,752875
2,2,1030,2271,3,7,1030,0,310000
3,2.25,1640,4420,4,7,1640,0,250000
2,1.5,1710,4189,5,7,1160,550,453500
4,2.75,1550,4000,3,9,1550,0,835000
3,3.25,2610,16387,3,9,2610,0,2.00E+06
4,2,2630,9099,3,7,1830,800,445000
5,2.5,1900,7843,5,7,1900,0,685000
4,2,1520,7983,5,7,1520,0,425000
3,2.5,1520,7200,4,7,1520,0,158000
6,3.5,4010,16200,3,8,2090,1920,1.65E+06
3,3.25,1980,2850,3,7,1980,0,660000
3,2.5,1580,2170,3,7,1580,0,247800
5,3.25,3320,11340,4,8,2480,840,409124
3,1.5,1400,9600,4,7,1400,0,210000
3,1,1260,7265,4,7,1260,0,188200
3,1.5,1470,7200,4,7,1470,0,590300
4,1.75,2340,17541,4,7,1360,980,476000
3,2.5,1720,6271,3,7,1720,0,265000
3,1.5,1970,22486,4,6,1970,0,289000
6,1.75,2240,11180,4,7,2240,0,279000
3,2.5,1380,1590,3,9,1160,220,350000
3,1,1390,16000,4,6,1390,0,230000
3,1,1390,12823,4,7,1390,0,319000
4,3,1780,7260,4,8,1780,0,538200
4,2.5,3500,7048,3,9,3500,0,780000
3,2.25,2380,11824,4,9,1450,930,800000
3,2.25,1780,9672,3,8,1350,430,395000
3,2.5,2920,3942,3,10,2920,0,868500
4,2.75,3950,12840,5,8,3950,0,1.05E+06
4,2.75,3180,13348,3,8,3020,160,510000
4,2.5,2770,8879,3,9,2770,0,1.40E+06
3,2.5,2690,11575,3,8,2130,560,650000
3,1.75,1680,8100,3,8,1680,0,640000
2,2.5,2420,60984,3,7,2420,0,430000
4,2.75,2330,7642,3,8,1800,530,257000
3,1,960,6180,4,6,960,0,320000
3,2.5,2150,15304,4,9,2150,0,649950
3,1,1100,7470,4,5,1100,0,250000
3,2.5,2050,11690,4,9,2050,0,585000
2,1.5,1520,8040,5,7,1520,0,500000
4,2.5,2700,9122,3,9,2700,0,652500
3,2.25,1620,12309,3,7,1620,0,473000
3,1.5,1390,5040,3,7,1090,300,589000
4,3.25,4060,20822,3,10,4060,0,1.18E+06
3,1.5,1610,5304,4,6,1610,0,215000
3,2.5,1240,1115,3,8,1240,0,340000
3,2.5,2450,7051,3,8,1870,580,537100
2,1,940,4000,3,6,720,220,473000
4,2.5,2340,13445,3,8,2340,0,360000
2,1.5,1360,1898,3,7,1360,0,200000
3,1.75,1700,7532,3,7,1700,0,255000
4,2.5,2040,9225,5,8,1610,430,675000
3,2,1640,2808,4,7,820,820,570000
3,2,1410,10577,3,7,1410,0,269000
2,1.5,1280,2096,3,7,1080,200,370000
4,1.75,2290,36900,5,7,1690,600,449999
4,2.5,1850,5674,3,7,1850,0,290000
3,2.25,3270,168000,4,10,3270,0,750000
5,1.75,1798,11232,3,7,1798,0,199900
4,2.5,3420,30410,3,9,3420,0,725000
4,4.75,4150,6303,3,9,4150,0,988990
3,2.5,2300,3060,3,8,1510,790,696000
4,1.75,2030,7350,3,8,2030,0,565000
2,2,1760,7200,5,7,880,880,579000
4,2.5,2130,9653,3,7,1500,630,320000
3,2.25,1310,1264,3,8,1310,0,514950
4,2.5,1740,4642,3,7,1740,0,316475
5,2.25,2440,20828,4,8,2440,0,489990
3,1.5,1360,1795,3,7,1360,0,415000
5,2.5,2990,15085,3,9,2990,0,625000
3,1.5,1450,7316,3,7,1450,0,430000
3,1.75,1990,5600,3,8,1330,660,779000
5,4.5,6070,14731,3,11,6070,0,1.57E+06
4,3,1850,9976,3,8,1850,0,430000
4,2.5,3070,7207,4,10,2670,400,1.72E+06
4,2.5,2020,3600,3,7,2020,0,345000
3,1.5,1350,9315,3,7,1350,0,499950
4,1.75,1450,8891,3,7,1180,270,235000
4,2.75,3410,5838,3,9,3410,0,743000
5,2,1870,7344,3,7,1870,0,450000
3,1.75,1560,3000,4,6,770,790,481000
3,1,1130,9907,3,7,1130,0,179950
3,1.75,1890,3825,3,7,1290,600,524950
5,2.75,2600,8160,3,8,2600,0,628000
3,1,1340,13750,4,7,1340,0,479000
2,1.5,1340,1286,3,8,1190,150,485500
2,1.5,1180,844,3,7,990,190,345000
3,3.5,3580,95832,3,9,3580,0,665000
2,2,1300,3608,3,7,1300,0,230000
2,1,1210,10000,3,7,1210,0,222200
3,1,1760,6927,3,7,1050,710,444950
3,1.5,2160,2260,5,8,1620,540,900000
4,3,3750,11025,3,10,3750,0,920000
3,1,1320,8220,3,7,1320,0,150000
2,1,770,5680,4,6,770,0,365000
1,1,1020,3200,3,7,1020,0,465000
4,3.5,2910,5260,3,9,2910,0,645000
4,2,1780,8149,4,7,1780,0,395000
3,1,1430,5960,4,7,1430,0,450000
4,1,1310,8640,3,6,910,400,154200
4,2.5,2100,5857,3,8,2100,0,380000
4,2.5,2610,4978,3,8,2610,0,373500
3,3,2330,4284,3,9,1920,410,453000
4,2,3510,12905,3,8,2210,1300,554820
4,1.75,2860,48351,3,8,1710,1150,583500
4,3.25,2050,5000,4,8,1370,680,750000
3,2.25,1620,998,3,8,1540,80,415000
4,2.5,3500,11306,3,9,3500,0,655000
3,2,1760,2875,3,7,1290,470,437500
3,1.75,1360,5850,4,7,1000,360,550000
3,2.25,2950,8036,3,8,1950,1000,386500
3,2.75,2590,12063,3,10,2590,0,796500
3,1.5,860,3200,3,6,860,0,445000
3,2,1450,8771,4,7,1450,0,271900
3,3.25,2200,2400,3,8,1740,460,605000
3,1.5,1620,6630,3,8,1280,340,620000
3,2,1490,3072,5,7,770,720,438500
3,1.75,2580,11000,4,7,1290,1290,459900
5,3.5,3150,10542,5,9,1620,1530,600000
3,1,990,7420,5,6,990,0,208000
3,1.75,1880,5978,5,7,940,940,562000
4,2.25,2510,133729,4,8,2510,0,788500
4,2.5,2961,12146,3,9,2961,0,695000
4,1,1310,6000,3,7,1310,0,370000
3,1.75,1490,8000,4,7,1200,290,203000
4,2,1630,10375,5,7,1630,0,360000
4,2.5,2990,12788,3,10,2990,0,760000
4,1.75,1540,5120,5,6,770,770,395000
3,1,3060,30166,5,8,3060,0,835000
3,1,960,8100,3,7,960,0,255000
3,1.5,1200,12000,3,7,1200,0,219000
4,1.75,2600,18042,4,8,2020,580,339900
3,1,820,5150,5,6,820,0,305000
3,2.5,1690,5171,3,8,1690,0,277500
3,1,1080,8214,3,7,1080,0,284000
5,3.5,2720,11454,3,9,1830,890,740000
3,1,1000,8018,3,7,1000,0,275000
2,1,800,5280,5,6,800,0,195000
3,1.75,1140,1201,3,8,1140,0,230000
3,3,2230,1407,3,8,1850,380,646800
3,2.25,1900,7225,3,8,1220,680,440000
3,1.5,1360,2030,3,8,1360,0,385000
3,2.25,1420,1230,3,8,940,480,425000
3,2.5,2370,4950,3,8,2370,0,685000
3,2.5,2090,6294,3,9,2090,0,566000
2,1.75,870,18537,4,6,870,0,199950
4,2.25,2560,8927,3,7,1790,770,303000
4,2.5,3250,235063,3,9,3250,0,293000
2,1.5,1130,746,3,8,1030,100,536000
3,2.25,1500,7308,4,7,1210,290,290000
4,2.5,1780,6000,3,9,1780,0,315000
4,2.5,2050,8909,4,8,1690,360,403900
3,2.5,1910,4408,3,8,1910,0,400000
3,1.75,1670,5209,5,7,1670,0,329900
3,1,2140,5037,3,7,2140,0,330000
4,3.25,3400,99170,4,8,2000,1400,865000
2,1,1100,6000,4,6,1100,0,210000
4,3.5,3970,210830,3,9,3970,0,775000
5,2.25,2400,13450,5,7,1200,1200,650000
4,2.75,1960,8937,5,7,980,980,325000
3,2.25,2370,7878,3,8,2370,0,577000
3,1,1310,3963,5,7,1310,0,420000
4,2.25,2180,7000,3,8,1680,500,318000
4,2.75,2620,6707,3,9,2620,0,672500
2,2,1420,5185,3,7,1420,0,335000
4,2.5,2910,5000,3,8,2910,0,395000
3,2.25,1830,7770,4,7,1400,430,255000
3,1.75,1420,7200,3,7,1000,420,300000
3,2.5,1590,2910,3,7,1110,480,575000
5,4,3720,15200,3,10,3720,0,960000
3,1.5,1480,6752,4,7,1480,0,307150
3,1.5,1700,9579,4,7,1100,600,262000
2,1,780,6727,3,6,780,0,221900
3,1,1175,10454,4,6,1175,0,775000
3,2.5,4040,147856,3,9,4040,0,760000
3,2.25,2130,8721,3,8,1570,560,316000
3,3,2260,1834,3,8,1660,600,651000
3,1.75,1250,7030,3,7,1250,0,439000
4,2.25,2250,13500,4,9,2250,0,801501
3,3,2230,1407,3,8,1850,380,635000
2,2.25,1210,1267,3,8,1120,90,461100
3,2,2070,9000,4,7,1450,620,254000
4,2.5,2290,6738,3,8,2290,0,570000
3,2.5,1410,2500,3,7,1410,0,265000
3,2.5,1700,3575,3,7,1700,0,300000
3,2.5,2160,7525,3,9,2160,0,756000
4,4,3860,67953,4,12,3860,0,1.76E+06
3,2.5,2880,36820,3,10,2880,0,710800
4,1,1230,7410,3,7,1230,0,252750
4,2.75,2730,4268,3,9,2730,0,905000
3,2.25,2070,11576,3,7,2070,0,196000
3,1.75,1440,4000,4,7,1050,390,295000
3,1.5,1230,3060,3,7,910,320,625000
4,2.25,2040,7600,4,8,1580,460,272000
4,2.25,2470,7350,3,7,1600,870,618000
4,2.25,2770,9340,4,9,2770,0,825000
3,2,2090,15790,3,9,2090,0,560000
4,1.5,1570,9210,3,7,1400,170,339900
5,3.5,3220,8000,3,9,2900,320,1.21E+06
3,1.5,2600,5085,4,7,1400,1200,540000
3,2.5,1510,6095,4,7,1510,0,260000
3,4.5,3850,62726,3,10,3120,730,915000
5,2.5,2210,10772,3,9,1430,780,648000
2,1,830,6893,3,7,830,0,222000
4,2.25,2200,9163,4,8,1430,770,655000
5,3,2150,6117,3,7,1370,780,420000
5,3.25,2700,3650,3,9,2070,630,950000
2,2,1930,4500,3,8,1930,0,542000
3,2.5,2200,7278,3,8,2200,0,349900
5,4.25,4830,11466,3,10,3720,1110,1.68E+06
4,1.5,1540,7168,3,7,1160,380,345000
3,1.75,1660,10819,4,7,1240,420,650000
3,2.25,2600,15000,3,9,2600,0,428000
3,1.5,1420,22100,5,7,1420,0,269900
3,2.5,1350,1189,3,7,1080,270,270000
4,3,3510,12410,4,9,3510,0,970000
4,2.5,1620,8125,4,7,1620,0,510000
2,1.75,860,5535,3,7,860,0,442000
3,2,1740,9300,4,7,1740,0,410000
4,2.5,3210,8532,3,10,3210,0,915000
3,2.5,2280,2502,3,8,1880,400,567500
3,3,1680,1570,3,8,1680,0,610950
3,1.75,2160,5863,4,7,1260,900,385000
3,1.75,1480,8667,5,7,740,740,501000
2,1,680,5250,4,6,680,0,500000
3,1.5,1780,214315,3,7,1780,0,643000
2,2,2360,11340,3,9,2360,0,1.09E+06
6,2.5,3880,5700,3,7,3880,0,635000
3,1,1060,10023,3,6,1060,0,169500
3,3.25,1720,936,3,8,1030,690,649000
3,2.25,1820,8446,3,8,1820,0,469000
3,1.75,2250,11520,3,8,2250,0,735000
3,1,1390,6160,4,7,1390,0,396000
3,1.75,1250,9486,4,6,1250,0,295000
2,2.25,1300,2104,3,8,1010,290,394950
3,1.75,1480,8475,4,7,1480,0,234000
4,2.5,3090,10730,5,8,2420,670,974350
3,1,960,10815,5,5,960,0,199999
4,2.5,2040,21781,3,8,2040,0,443500
4,3.25,2980,7000,3,10,2140,840,1.40E+06
4,1.75,1760,11180,4,8,1760,0,320000
3,2.25,3200,3800,5,9,2650,550,995000
4,2.5,3800,22029,3,9,3800,0,894000
3,3,1760,2114,3,7,1400,360,605000
3,1,1300,8160,4,7,1300,0,237000
3,2.25,1980,7200,3,8,1300,680,355000
3,1,1160,7491,4,6,1160,0,417500
3,2.5,2230,4006,3,8,2230,0,700000
2,1,940,8532,4,7,940,0,249950
2,1.75,2060,7192,3,7,1420,640,457000
4,2.5,2360,5226,3,8,2360,0,600000
4,2.5,1890,6962,3,8,1890,0,280500
3,2.5,1730,1301,3,9,1730,0,625000
2,1,1000,3513,4,5,1000,0,715000
3,2.5,2250,4134,3,9,2250,0,675000
4,3.25,3266,5969,3,8,3266,0,418000
3,3.25,1540,1487,3,8,1540,0,520000
3,1.75,1370,10866,4,6,1370,0,270000
3,2.5,1870,3118,3,8,1870,0,205000
3,3,1790,2003,3,7,1480,310,249950
3,3.25,1220,1281,3,8,930,290,526000
2,2.75,1590,20917,3,5,1590,0,199950
3,2.5,1600,7936,3,7,1600,0,280000
4,3.5,3070,4684,3,10,2190,880,785000
2,1,940,5375,4,5,940,0,234000
3,1,840,8400,3,6,840,0,105000
4,2.5,2590,8571,3,9,2590,0,781000
3,2.25,1580,8659,4,7,1220,360,475000
1,2,3000,204732,3,8,3000,0,415000
3,2.5,2030,2805,3,8,1720,310,471000
3,1.75,1120,10450,3,7,1120,0,178500
4,2.25,1660,7184,3,7,1110,550,277500
4,2.5,1980,5400,3,8,1980,0,449000
4,4,4390,17832,4,11,2430,1960,1.28E+06
4,1.75,2180,7560,4,7,1560,620,390000
4,2.5,2780,6235,3,8,2780,0,690000
5,1.75,2340,9148,3,7,2340,0,210000
4,2.5,2380,9614,4,10,2380,0,782000
4,1,1650,8250,3,7,1650,0,517000
3,2.5,2660,1973,3,9,1870,790,1.24E+06
3,2.5,3120,6000,3,9,3120,0,419950
3,2.5,3380,7074,3,8,2200,1180,435000
4,2,1370,8837,3,7,1370,0,239000
5,2.5,2760,4000,3,8,1730,1030,575000
3,2.25,3250,34848,3,10,2260,990,1.15E+06
10,2,3610,11914,4,7,3010,600,650000
4,3.75,4410,8112,3,11,3570,840,1.63E+06
3,1,950,8400,3,7,950,0,286000
2,1,1050,6250,4,6,840,210,209950
3,1.5,1860,7190,5,7,1860,0,580000
3,1,1250,7015,3,7,1250,0,170000
3,1,990,7050,3,7,990,0,310000
3,2.75,3230,5250,3,9,2680,550,591975
2,1,920,8612,5,7,920,0,340895
2,2.5,2630,7957,3,8,2630,0,750000
3,2.5,1990,5149,3,8,1990,0,545000
2,1,1070,6120,3,6,1070,0,209000
2,2,1580,5750,5,6,790,790,558000
2,1,1250,8520,3,6,1250,0,200000
3,2,1420,12655,5,7,1420,0,421000
4,2.5,1904,8200,5,7,1904,0,365000
3,2,2660,16677,3,9,2210,450,435000
4,2.75,2990,7389,4,8,2090,900,1.08E+06
3,2.5,1590,4108,3,7,1590,0,324500
4,2.5,3010,5040,3,8,3010,0,500000
2,1.5,1170,5248,5,6,1170,0,335000
2,1,860,5800,5,5,860,0,222900
2,1,910,7617,3,6,910,0,365000
4,2.5,2040,5770,3,7,2040,0,250000
3,2.5,2410,7225,3,8,2410,0,614905
3,2.25,1780,16290,4,8,1780,0,350000
4,2,1960,30480,4,7,1060,900,275000
3,2,1820,15068,3,7,1520,300,283000
4,3.5,4210,18564,3,11,4210,0,1.91E+06
3,1.5,1420,1192,3,8,1140,280,345000
5,3.5,3330,3705,3,9,2610,720,795000
4,3.25,2190,4265,3,9,1540,650,920000
3,2.5,1390,1411,3,8,1390,0,560000
4,2.25,2920,17023,4,9,1690,1230,707000
4,2.5,2740,10533,3,9,2740,0,672800
3,2.5,2600,7465,3,9,2600,0,571000
4,2,2270,18450,3,7,2270,0,375000
3,1,1290,8974,5,7,1290,0,373000
4,1,1960,3194,3,7,1960,0,569500
5,2.75,2630,10165,4,8,1690,940,495000
3,2.25,1570,9096,4,7,1180,390,272950
3,1.75,2000,14733,4,8,2000,0,700000
4,2.25,2330,11400,4,8,2330,0,375000
1,1,920,5000,4,7,920,0,535000
5,2.75,2830,8925,3,7,2830,0,451000
4,2.5,2490,12929,3,9,2490,0,616000
3,1,1460,43000,3,7,1460,0,400000
3,1.75,1330,6743,3,8,1330,0,601000
3,1.75,1750,5200,4,8,1750,0,660000
4,2.5,2430,5556,4,8,2430,0,381500
3,1,1020,6120,3,7,1020,0,485000
4,1.75,2160,7417,4,7,1360,800,355000
3,2.25,1420,1282,3,8,1420,0,523950
3,2.5,1580,1161,3,8,1010,570,525000
4,2.25,1890,3615,3,7,1890,0,535000
2,1.75,1280,37373,4,7,1280,0,297000
3,2,2050,11454,3,8,2050,0,500000
3,1.5,1430,8000,5,7,1430,0,330000
3,1,1020,13504,5,7,1020,0,322500
2,2,1100,3000,3,7,1100,0,450000
3,2.5,1850,4600,3,7,1850,0,299000
3,1.75,1580,9719,5,7,1580,0,517100
5,4,4050,11358,4,10,2780,1270,1.29E+06
3,2.25,2180,60112,3,8,2180,0,650000
3,1,1640,18144,3,6,1640,0,308000
3,2.5,2517,3900,3,8,2517,0,353900
3,2.5,1540,1614,3,8,1470,70,413450
3,3,1260,1251,3,7,1040,220,342000
5,1.5,2830,4000,4,8,2830,0,405600
2,1,1310,7128,4,7,940,370,253000
3,2.5,2620,6842,3,7,2620,0,635000
4,1,1210,6000,3,7,1210,0,279000
4,2.5,2340,10800,3,8,2340,0,880000
4,1.75,2000,6032,3,7,1300,700,453500
4,2.5,2110,3750,3,8,2110,0,772000
3,2.25,2080,26574,3,7,1380,700,270000
2,1.5,880,1498,3,7,880,0,248500
1,1,900,6380,3,6,900,0,350000
1,1,890,211576,3,7,890,0,362000
4,1.75,1800,8385,5,6,900,900,377000
2,1.5,1090,2686,3,7,1090,0,249000
3,2.5,2150,8361,3,8,2150,0,371000
3,1.5,1460,5040,3,7,1100,360,539000
3,2.5,1730,5799,4,7,1730,0,275000
3,1,1190,9000,3,7,1190,0,268300
4,2.25,2130,9000,4,8,2130,0,586000
4,2,3090,87120,4,7,1590,1500,595000
4,2.5,3100,8529,3,9,3100,0,735000
6,2.5,3180,9375,4,8,1590,1590,680000
3,1.5,1210,5240,4,7,610,600,305000
2,1,1210,7140,3,6,1210,0,305000
3,2.5,1260,1622,3,8,1260,0,305000
5,2,1910,12264,4,7,1010,900,460000
2,1,940,8997,5,7,940,0,219950
4,2.5,2190,4944,3,8,2190,0,563500
3,2.5,3000,25341,3,9,3000,0,740000
3,2.25,1910,3481,3,8,1910,0,293000
4,3.5,2140,2278,3,9,2140,0,675000
3,2,1660,13085,3,7,1010,650,250000
4,2.5,2810,11120,3,9,2810,0,675000
4,2,1890,6302,3,7,1890,0,282000
5,2.75,3550,9600,3,7,3550,0,580000
3,1,1470,6500,4,7,1470,0,410000
3,2.25,3010,9600,3,8,2410,600,499000
3,1.5,1440,12040,4,7,1440,0,253500
4,2,1930,5398,3,7,1430,500,700000
5,2.75,3750,8279,3,9,3750,0,910000
4,3.5,4420,7902,3,10,3350,1070,730000
5,3,2300,8214,3,8,2300,0,312891
2,1,830,4000,3,6,830,0,394475
3,2.75,2220,4000,3,8,1700,520,800000
3,2.25,2930,7005,3,9,2670,260,1.05E+06
3,2.5,1990,4978,3,8,1990,0,467000
4,2,1580,7300,4,7,1580,0,405100
3,2,1750,9239,3,8,1410,340,420000
4,2.5,3180,10105,4,9,3180,0,960000
2,1,590,8717,3,6,590,0,240000
3,2.25,1990,7340,3,8,1990,0,445000
3,1.75,2280,7800,4,8,1360,920,750000
4,1.75,1790,10186,4,8,1790,0,380000
3,2.5,1360,3188,3,7,1360,0,419500
2,1,620,4760,3,6,620,0,265000
2,1.75,1840,7230,3,7,1570,270,245000
3,1.5,1740,12000,3,9,1740,0,539000
2,1,1670,6212,4,7,1670,0,425000
3,1.5,2400,10275,4,8,1540,860,510000
4,4.5,4225,284011,4,11,4225,0,1.01E+06
3,2,1230,11413,3,7,990,240,400000
3,1,1180,7537,3,7,1180,0,400000
6,2.75,4430,6440,3,10,2680,1750,1.49E+06
3,2.5,2990,9413,3,10,2990,0,659950
3,1.75,1830,7371,3,7,1830,0,544950
4,2.5,2672,4297,3,8,2020,652,700000
2,2,1180,3200,4,6,590,590,360000
3,1.75,1090,6775,4,7,850,240,680000
4,2,1500,3659,3,7,830,670,470000
3,1.5,980,7770,4,7,980,0,463800
4,3.25,3440,35021,3,10,3440,0,1.05E+06
4,3.5,3010,3600,3,9,2370,640,1.28E+06
4,3.5,4170,9748,3,11,4170,0,1.20E+06
3,1,1080,6250,2,5,1080,0,115000
5,3,4780,20440,4,10,3660,1120,2.58E+06
4,3.25,4700,9160,3,11,2520,2180,1.40E+06
3,1.75,1590,7810,4,7,1590,0,255000
7,3.25,4340,8521,3,7,2550,1790,419000
3,3,2450,211266,3,8,2450,0,530000
2,1.5,1430,8137,3,7,1130,300,403250
4,1,1470,5450,3,7,1470,0,700000
4,3,2760,13113,4,8,1760,1000,550000
2,1,820,5100,3,6,820,0,195000
3,1.75,1780,35233,4,8,1420,360,250000
4,2,2510,38141,3,9,2510,0,600000
4,2.75,2220,11925,3,7,1560,660,825000
4,2.75,3250,5600,3,8,3250,0,570000
4,1.5,1970,4590,3,7,1970,0,690000
4,2.25,3330,21785,3,9,3330,0,555000
2,1,820,4200,3,7,820,0,480000
3,1.5,1220,6000,3,7,1220,0,177500
3,1.75,1830,2417,3,7,930,900,348000
4,1.5,1220,3780,3,7,1220,0,483000
3,2.25,1750,9353,3,7,1210,540,434000
4,3.25,3910,7500,4,11,2550,1360,2.00E+06
2,1,1250,5880,3,6,900,350,425000
4,4,3650,18223,3,9,3330,320,799900
4,2.5,3860,5130,3,8,2930,930,681000
1,1,1020,7920,3,7,1020,0,269000
5,2.75,2710,4500,3,8,2710,0,419354
4,1,2410,6975,3,7,1510,900,325000
8,3,3840,15990,3,7,2530,1310,575000
2,1,980,1600,3,8,980,0,447000
3,1.75,1530,6300,3,6,1530,0,412500
3,1,1150,12877,4,6,1150,0,350000
3,1,1050,6300,3,6,1050,0,220000
3,2.25,3020,43560,3,10,2720,300,955000
4,2.25,4220,24186,3,8,2600,1620,775000
5,4.25,4720,18741,3,11,3210,1510,875000
3,2,2350,6000,4,8,1990,360,875000
2,1.75,1950,10766,4,6,1160,790,669000
4,2.25,2140,10943,3,7,1550,590,502000
4,2,1980,23625,3,8,1980,0,659000
3,1.75,1780,7567,3,7,1290,490,442573
5,2.25,2660,8400,5,7,2660,0,305000
3,1.5,1050,5525,5,6,1050,0,195000
3,1.75,1500,10230,2,7,1500,0,315001
3,2.5,1480,1165,3,8,1480,0,520000
2,1.5,1960,6000,3,8,1210,750,680200
3,1.75,2260,11781,4,8,1520,740,714000
6,3.75,3190,4700,3,8,3190,0,359500
3,1,1250,7280,3,7,1250,0,221000
2,1,940,15450,4,6,940,0,252000
3,1,1500,3920,3,7,1000,500,606000
3,3,3200,35782,3,8,2360,840,350000
3,2.5,2520,10012,3,10,2520,0,720000
2,1,890,6430,3,6,890,0,199990
4,2.5,2300,19250,4,7,2300,0,450000
3,2.25,1650,10336,3,7,1500,150,290000
3,1,1800,7650,5,7,1800,0,265000
4,2.5,2050,9015,4,7,2050,0,290000
3,2.5,1340,8867,3,8,1340,0,432500
2,1,1030,3060,4,7,790,240,480000
3,1.75,1930,8442,4,7,1930,0,825000
3,2,1740,3600,5,7,990,750,677915
3,2,1600,4510,3,7,990,610,510000
3,3,2990,9773,4,8,2990,0,849950
3,2.25,2420,31497,4,8,1750,670,390000
3,2.25,2675,40910,3,8,2675,0,660000
4,2.5,3090,9238,4,8,1680,1410,940000
4,2.5,2810,6481,3,9,2810,0,340000
3,1,1320,5250,5,7,1320,0,526000
4,2.25,2680,4673,3,7,2680,0,475000
4,2,1590,9100,3,7,1040,550,330000
4,1.75,2280,7840,3,7,1280,1000,312500
3,1.75,1490,9844,4,7,1190,300,411000
5,2.5,2900,6650,3,7,1450,1450,352000
2,1.5,1100,1107,3,8,1100,0,420000
5,2.75,2890,22547,4,10,2150,740,1.10E+06
3,2.5,2190,7904,3,8,2190,0,269100
3,2.5,2080,7749,3,8,2080,0,550000
2,2.25,1420,1246,3,8,1420,0,335000
3,2,1210,9926,4,7,1210,0,335000
4,4.25,5540,15408,3,11,4280,1260,2.58E+06
3,1.75,1840,7200,4,7,1220,620,301000
4,2.5,3230,40319,4,10,3230,0,699000
4,2.25,2400,8592,3,8,2400,0,335000
3,1.75,1900,5000,4,7,950,950,515000
4,2.5,2270,8391,3,8,2270,0,643000
2,2.25,1230,1058,3,7,1160,70,325000
3,2.25,1320,1800,3,7,1320,0,540000
3,2.25,1920,7738,3,8,1520,400,250000
3,1.75,1370,8719,3,7,1370,0,247200
4,4.75,3970,9778,4,11,3390,580,2.30E+06
2,1.5,1140,1058,3,7,1140,0,466000
4,1,1520,7298,3,7,1520,0,160000
3,3.5,1540,1427,3,7,1360,180,216650
3,1,1280,10500,4,5,1280,0,291000
3,1.75,2330,6000,4,7,1630,700,605000
4,2.5,2610,3277,5,8,1920,690,1.00E+06
6,2.5,3610,12033,3,8,3210,400,610000
3,1,1210,3720,4,8,1210,0,640000
5,4,4180,12042,3,10,4180,0,1.26E+06
5,2,1730,7375,4,6,1730,0,249950
4,3.25,3940,27591,3,9,3440,500,725000
4,2.5,1840,5550,3,8,1840,0,300000
4,1.75,2330,5000,4,7,1510,820,687500
3,1.75,2160,5760,4,8,1260,900,670000
3,2.5,3310,21096,3,9,3310,0,419000
3,1.75,1900,7680,3,7,1260,640,220000
4,3.25,4160,47480,3,10,4160,0,1.05E+06
3,2.5,2010,11618,3,7,2010,0,279000
3,3.25,3610,59677,3,10,2440,1170,777000
3,2.75,1370,1193,3,8,1370,0,560000
2,1.5,1160,1269,3,7,970,190,453000
3,2.25,1650,4859,3,7,1650,0,370000
2,1,1060,3036,4,6,1060,0,435000
3,2.5,1850,1499,3,9,1790,60,535000
4,2.5,2820,5056,3,9,2820,0,428900
2,1.5,1010,10005,3,7,1010,0,310000
3,3.5,2710,3475,3,8,1650,1060,627000
3,1.5,1400,7582,3,7,1400,0,285000
3,2.5,1570,1551,3,8,1570,0,414950
4,2.5,2620,8312,3,9,2620,0,749950
2,1,770,8149,3,6,770,0,277000
3,2,1630,10723,5,7,1630,0,360000
5,2.5,2390,8775,4,7,1270,1120,358000
3,2.25,1810,12000,3,7,1810,0,257000
4,2.75,3550,6558,3,9,3550,0,952990
4,2.5,2891,6499,3,9,2891,0,415000
2,1.75,1350,6315,3,8,1350,0,429000
3,1.75,1370,10050,4,7,1370,0,268000
3,2,1540,1827,3,8,1540,0,402000
4,4.25,4470,5884,3,11,3230,1240,2.95E+06
1,1.75,1440,4920,3,7,720,720,390000
3,1.75,2330,7200,4,8,1320,1010,650000
4,4.25,2360,57514,4,8,2360,0,590000
4,2.5,2990,9614,4,9,1740,1250,514500
3,1.75,1790,7485,4,8,1330,460,263000
4,1.75,2060,9828,4,8,2060,0,640000
5,1.5,2420,43560,3,8,1500,920,332000
2,1,2160,7439,4,6,1300,860,625500
4,1.5,3120,7680,3,8,1660,1460,976000
5,2,1430,5600,3,6,1430,0,440000
4,2.5,2105,6093,3,8,2105,0,330000
1,1,830,3200,3,7,830,0,525000
4,2.5,3340,34238,4,8,2060,1280,655000
3,2.5,2420,8244,3,10,2420,0,640000
3,2.5,2714,17936,3,9,2714,0,465000
3,1.75,2100,3264,5,7,1350,750,625000
4,2.5,2990,9643,3,9,2990,0,772000
2,1,840,3860,4,6,840,0,361500
2,1,880,4814,4,5,880,0,208500
2,2.5,1860,6359,3,7,1860,0,314950
3,1.5,1320,9750,3,7,1320,0,260000
3,1,910,10575,4,7,910,0,190000
3,2.5,2100,9040,3,8,1700,400,506400
3,2,3000,22040,4,8,2470,530,887000
4,2.5,2210,7722,3,9,2210,0,640000
3,1,1200,15843,3,7,1200,0,299000
3,1,1300,9880,4,7,1300,0,205000
3,1.75,2050,6720,3,7,1050,1000,324950
5,2.75,1990,3750,4,7,1990,0,852000
3,1,1490,10650,3,7,1150,340,460500
2,1.75,1670,10725,3,7,1670,0,325000
4,2.5,2160,9750,3,8,2160,0,518000
4,1,1210,6250,3,7,1210,0,175000
4,4,3610,12811,3,10,3610,0,870000
2,1.5,1240,1331,3,7,1050,190,379900
3,2.5,2020,7512,4,8,2020,0,744000
2,1.5,1320,10800,4,8,1320,0,467000
2,2,1480,6075,5,7,740,740,276000
3,1.75,1650,12940,4,7,1650,0,438000
5,2.75,2880,8364,3,9,2880,0,525000
5,3,2110,10766,3,7,2110,0,315000
2,1.5,901,1245,3,7,901,0,435000
4,2.5,2920,5500,3,10,2030,890,1.25E+06
3,2,1463,868,3,7,1463,0,390000
4,1.75,1890,10550,5,7,1010,880,372000
3,1.75,1850,9655,3,7,1100,750,373000
3,1.75,2080,6554,3,7,1040,1040,325000
4,2.75,2420,11201,3,8,1420,1000,712500
4,2.5,2800,5000,3,9,2800,0,375000
4,2,2520,7334,3,7,1600,920,303697
4,2.5,2770,8642,4,9,2770,0,907500
1,1,550,1279,3,7,550,0,353000
2,1.75,1760,4600,4,7,850,910,355000
2,1,1080,3500,3,7,1080,0,525000
2,1,980,3600,3,6,980,0,595000
3,1,1150,10196,4,7,1150,0,383000
4,2.25,3310,8540,4,9,1660,1650,1.10E+06
2,1,1050,7500,4,6,1050,0,521000
2,1,1010,7740,3,6,890,120,289000
3,2.5,1639,2710,3,8,1479,160,450000
6,1.75,2540,8400,3,8,1340,1200,317500
6,2.75,3240,5750,4,6,2160,1080,370000
3,1.75,1630,5999,4,7,1630,0,265000
4,3.5,4130,77832,3,10,4130,0,775000
4,2.5,2910,9131,3,10,2910,0,1.04E+06
3,1,1320,11090,3,7,1320,0,275000
3,2.5,2830,56628,3,11,2830,0,1.08E+06
4,2.5,1540,1860,3,8,1540,0,491234
5,3.5,4010,8510,5,9,2850,1160,1.40E+06
5,3.75,3880,8370,4,7,3880,0,506000
3,2.5,2080,3920,3,8,2080,0,448500
4,2.25,2730,35100,3,8,2730,0,500000
3,1.75,2610,5544,3,8,1680,930,750000
4,2.25,1570,499571,4,7,1570,0,350000
4,2,1710,8814,5,7,1030,680,295000
5,2.25,2910,9454,3,8,1910,1000,788000
2,2.75,1910,1369,3,9,1910,0,609850
4,2.25,2460,8001,4,8,2460,0,818000
4,2.5,4700,49658,3,10,4700,0,1.18E+06
3,2.5,1430,1056,3,8,1430,0,443600
2,2.25,1180,2090,3,7,1180,0,447500
2,1,970,12500,3,6,970,0,261000
4,2.25,2220,6953,4,8,2220,0,350000
4,2.5,2940,35996,3,9,2940,0,530000
3,1.75,1850,6869,5,6,1100,750,459950
3,1.75,1740,11547,3,7,1740,0,245000
3,2,1180,1800,3,8,1180,0,425000
3,2.75,2430,14861,3,9,1530,900,495000
5,2.75,3847,17654,5,9,2299,1548,810000
4,2.5,2880,8061,3,9,2880,0,440000
3,2,1320,1298,3,7,1320,0,350000
5,2,2400,3500,3,8,1900,500,650000
3,1,1240,4800,3,7,800,440,525000
4,3.5,4220,5817,3,9,2910,1310,633000
4,2,2840,13367,3,7,1420,1420,945000
3,3.5,3520,35512,3,8,2760,760,470000
5,1.75,2350,7800,4,8,1510,840,754000
3,1.5,2100,10000,4,7,2100,0,245000
2,1.5,982,846,3,8,806,176,250000
3,1.5,1170,4080,5,6,1170,0,360000
3,2.5,2990,6771,3,7,1550,1440,373000
3,1.75,1700,8534,4,7,1700,0,985000
4,3.5,3860,6543,3,10,3860,0,900000
3,1.75,1700,51649,5,6,1700,0,545000
4,2.25,1970,8941,3,7,1970,0,400000
3,2.5,2190,2658,4,9,2190,0,770000
3,1,1600,12566,4,7,1600,0,240000
3,2.25,1790,231303,3,7,1250,540,413100
1,1,730,6890,4,4,730,0,140000
3,1,1010,8906,5,7,1010,0,234000
2,1.5,1990,6000,3,6,1430,560,580000
2,1,700,5200,5,5,700,0,199950
3,2,2220,6641,4,7,1220,1000,875000
3,1,1020,8484,3,6,1020,0,307000
3,2.5,4040,8653,3,9,2900,1140,565000
3,2.25,2230,9053,4,9,2230,0,600000
5,1.75,2130,19180,3,8,1500,630,1.30E+06
3,3.5,2490,2722,3,8,2020,470,616950
3,2.5,1350,1186,3,8,1120,230,468500
3,1.75,920,3600,4,6,820,100,589000
3,1.75,1680,3000,4,6,840,840,425000
3,1.75,1540,12600,4,7,1160,380,272500
4,1.75,2100,3400,5,7,1100,1000,750000
3,1,1250,4620,4,7,1150,100,712000
2,1,1040,13920,3,6,1040,0,182500
4,2.25,2490,9864,4,8,1290,1200,824000
4,2.75,2850,3000,3,9,2530,320,1.19E+06
3,1.75,1920,8775,3,7,1920,0,380000
3,2.5,2550,6021,3,7,2550,0,353000
3,1.75,1800,7763,3,6,1470,330,270000
4,2.5,2210,9875,3,9,2210,0,639000
2,1,760,6141,2,6,760,0,162500
4,1.75,2340,9100,3,8,1610,730,700000
2,2.5,1830,2856,3,7,1830,0,524950
4,1.75,2180,9726,4,9,2180,0,875000
3,2.5,2380,9719,3,8,2380,0,299999
3,1.5,1560,20251,5,7,1200,360,577000
2,1,1430,4000,3,7,930,500,230000
5,1,1920,19040,3,7,1160,760,230000
4,3.5,3610,6345,3,9,2370,1240,603000
3,1.5,1870,15685,3,7,1470,400,460000
4,3.5,3980,209523,3,9,3980,0,810000
1,1,960,2640,3,7,760,200,332000
3,2.5,1750,4076,3,7,1750,0,312000
3,2.5,2320,3980,3,8,2320,0,580500
4,1,1140,13440,2,5,1140,0,340000
4,3.5,5220,15411,3,11,3550,1670,1.48E+06
3,1.75,1230,12000,3,6,1230,0,179900
3,2.5,1770,1235,3,8,1600,170,436110
2,2.25,1570,1269,3,9,1280,290,500000
3,2.25,1940,217800,3,9,1940,0,529000
3,2,1870,9527,4,7,1870,0,832500
4,3.5,3890,3600,3,9,2860,1030,1.60E+06
4,3.25,2820,13059,4,8,2820,0,432000
3,1.5,1270,1416,3,8,1270,0,461000
4,2.25,2000,9000,4,8,2000,0,318989
2,1,700,8174,3,5,700,0,175000
3,1.5,960,4600,3,6,960,0,500000
2,1.75,1830,7200,4,7,1070,760,585000
1,1,590,833,4,7,590,0,202000
4,2.5,1830,7762,3,8,1830,0,325000
4,2.5,1940,4517,3,8,1190,750,425000
2,1.75,1560,3200,5,7,880,680,600000
4,2.5,2620,4050,3,8,2620,0,399963
4,1.5,1890,6052,4,7,1890,0,359000
3,1.75,1520,7439,4,7,1520,0,345000
3,1,2230,3200,3,8,1630,600,770000
4,2.5,2790,15653,4,10,2790,0,950000
4,2.25,2530,24700,3,7,2530,0,340000
2,1,1430,3000,3,7,1300,130,620000
3,1.75,1030,4800,3,6,930,100,277284
3,1.5,1760,9600,4,7,1760,0,272000
4,3,3710,20000,5,10,2760,950,2.54E+06
3,2.25,1400,3825,3,7,1400,0,270000
2,1,740,7680,4,6,740,0,350000
4,2.25,2680,35218,3,8,2680,0,390000
3,1,1080,8580,3,6,1080,0,192500
2,1.75,930,7080,3,6,930,0,275000
3,1.75,2100,5058,3,7,1340,760,605000
4,2.5,2689,5724,3,9,2689,0,368000
5,4.5,4690,6705,3,10,3450,1240,932808
5,1.75,1610,15246,3,6,1610,0,393000
4,1.5,1770,5750,3,7,1770,0,440000
2,2.5,2170,6750,3,8,2170,0,765000
4,1,1780,4310,5,6,1780,0,336000
2,1,2110,4920,3,7,1460,650,425000
3,1,1530,9465,4,7,1530,0,252000
5,2.5,2260,10087,3,8,1520,740,632000
4,3.5,4300,108865,3,11,4300,0,1.45E+06
4,3,2120,3600,4,8,1830,290,1.32E+06
5,2,2300,7897,4,8,2300,0,500000
3,1.5,1240,7735,4,7,1240,0,523000
4,2.5,3220,15600,5,9,1680,1540,1.25E+06
3,2.25,2390,4590,3,8,2090,300,980000
3,1,1400,10403,4,6,1400,0,232000
4,3.25,3500,5960,3,9,3500,0,840000
3,1.75,1820,8028,3,7,1220,600,389000
2,1,2550,21675,4,7,1610,940,446000
4,1.5,1200,11163,4,6,1200,0,178000
3,3,1571,2017,3,8,1571,0,366750
4,3,2040,7145,3,8,1490,550,284000
4,2,1560,7500,4,7,1560,0,439000
3,1.75,1760,8266,5,7,1760,0,449900
4,2.5,2750,7200,3,8,2750,0,430000
4,2.25,2060,44431,3,7,2060,0,500000
4,2.25,1750,6120,3,7,1150,600,605000
2,1,1140,23779,3,6,1140,0,582500
3,2.25,1420,990,3,8,1420,0,467000
4,3.5,3190,6875,3,8,2120,1070,675000
3,1.5,2270,8187,4,8,1420,850,410000
4,2.75,2100,7236,3,8,1400,700,491500
3,2.5,1690,7165,4,7,1690,0,270000
2,1.75,2050,4000,3,8,2050,0,825000
4,2.5,2130,3420,4,7,1730,400,725000
3,1.75,1420,6984,4,7,980,440,240000
4,1.75,1960,6177,4,8,1960,0,275000
3,3.5,3190,6776,3,10,3190,0,780000
3,2.25,1450,4040,3,7,1450,0,275000
4,2.5,3840,16619,4,10,3840,0,1.12E+06
3,2.5,2140,4126,3,8,1960,180,554000
4,1.75,2340,5940,3,8,1290,1050,650500
4,1,1360,7132,3,6,1360,0,235000
3,2.5,2560,9825,4,9,2560,0,823000
4,2.5,2020,5100,3,7,2020,0,319000
4,3,3330,6990,5,9,2330,1000,1.24E+06
3,2,2700,6120,4,8,1350,1350,910000
3,1.75,1430,16200,4,7,1430,0,427500
3,2.5,1590,1937,3,8,1590,0,580000
4,2.5,2310,9624,3,8,2310,0,597750
5,3,3650,16600,4,9,1860,1790,1.31E+06
3,1.5,1740,9038,4,7,1740,0,472000
4,2.5,2430,4747,3,8,2430,0,585000
3,1,960,27442,4,6,960,0,137124
2,2,1370,3827,3,7,1020,350,535000
2,1,900,8374,3,7,900,0,325000
3,1.75,1260,1111,3,8,1260,0,350000
3,2.25,1422,3677,3,7,1422,0,245000
2,1.5,960,1000,3,8,920,40,450000
4,2.5,2960,26742,3,8,1480,1480,1.16E+06
3,1,1510,9100,3,7,1510,0,199000
3,2.75,2090,8354,3,8,2090,0,403000
4,3,1990,6180,3,7,1990,0,273000
6,2.25,4910,6600,5,10,3580,1330,1.68E+06
4,1.75,1920,7665,4,8,1500,420,341000
4,1.75,2140,8000,4,8,1410,730,594000
2,1.75,1240,6417,5,7,1240,0,471000
4,3.75,3890,22000,3,10,3890,0,850000
2,1,1410,3600,4,7,1310,100,760000
4,2.5,2680,4548,3,8,2680,0,750000
4,1,1480,3750,4,7,1480,0,770000
4,2.5,3030,13068,3,9,3030,0,680000
3,2.5,1660,1458,3,9,1660,0,559950
3,2.25,1820,15000,3,7,1480,340,480000
3,1.5,1360,13496,4,8,1360,0,345000
2,1.75,1950,8200,3,8,1950,0,255000
2,1,1280,4635,3,6,840,440,230000
2,1.5,1078,1263,3,7,1078,0,240000
4,2.5,2250,50155,3,8,2250,0,476500
6,1,2330,5000,4,7,2330,0,950000
4,2.25,2060,8470,3,8,1440,620,655000
3,1,1050,5233,5,5,1050,0,206000
3,1.75,2050,3520,4,7,1070,980,568000
3,2.5,1800,1120,3,8,1800,0,391000
3,1.75,1460,9998,3,7,960,500,446000
2,1,1300,6731,3,7,1300,0,337500
3,1.75,1900,11165,4,7,1900,0,557500
4,2,2320,12000,3,7,1720,600,299000
3,2.75,2770,54707,3,8,2370,400,470000
3,2,1350,10200,3,7,1350,0,366000
5,3.5,3290,5880,3,9,2670,620,762500
4,2.75,2570,7264,3,8,1720,850,254500
4,2.75,2700,9882,3,7,2700,0,520000
3,2.25,1760,16418,3,7,1190,570,419000
3,2.5,1570,5113,3,7,1090,480,256000
4,1.75,1790,45738,3,8,1410,380,455000
3,2.25,3370,11757,4,9,3370,0,998000
2,1,1090,5265,4,7,1090,0,577000
4,1.75,1950,13320,4,8,1370,580,635000
4,1.75,1980,8400,3,7,1330,650,425000
3,2.25,1900,7800,4,8,1390,510,280000
4,2,2360,7080,5,6,1180,1180,459000
4,1,1660,4690,3,7,1260,400,560000
2,1,1110,26051,3,6,1110,0,250000
4,2.75,3190,8737,3,9,3190,0,587000
3,2.25,1720,9600,4,7,1220,500,550000
5,5,4490,10279,3,10,3930,560,1.80E+06
2,2.5,1320,48787,3,8,1320,0,361000
4,2.5,2480,5100,3,8,2480,0,480000
3,1,1300,8316,4,6,1300,0,225000
2,1,740,6250,3,6,740,0,114975
4,2.5,2689,6688,3,9,2689,0,425000
2,1.75,1460,7926,4,7,1460,0,237950
4,2,2208,5000,5,8,2208,0,650000
4,3.5,3290,8059,3,9,3290,0,801000
4,2,1580,8000,3,7,1040,540,245000
2,1,1380,1800,3,7,1080,300,570500
3,3.5,1590,1102,3,8,1590,0,518500
6,3,2480,12000,3,8,2480,0,725000
4,2.5,3720,105850,4,10,3720,0,864000
3,2.5,2740,7923,3,9,2740,0,441000
2,1,1140,23030,3,8,1140,0,160000
2,1,1040,4600,4,6,1040,0,299000
4,2.25,2070,7500,4,7,2070,0,465000
3,2.5,3310,5300,3,8,2440,870,670000
4,2.5,2650,6366,3,9,2650,0,352000
2,2.25,1060,1209,3,8,940,120,505000
2,1,960,8153,3,6,960,0,300000
8,2.75,4040,20666,4,9,2020,2020,1.65E+06
4,2,1380,4048,4,7,1380,0,560000
5,3.25,4320,32840,3,12,4320,0,1.60E+06
3,1,1850,5775,3,6,1740,110,330000
3,3.25,3730,13264,3,9,3730,0,1.07E+06
4,2.25,2380,7700,4,8,2380,0,365650
3,2.5,1650,4777,3,8,1650,0,424950
3,2,1670,7757,3,8,1670,0,289950
5,5,8000,23985,3,12,6720,1280,5.35E+06
4,1.5,1440,3200,4,7,960,480,589500
3,1.75,1370,2800,5,7,800,570,563250
4,2.25,2280,7229,4,8,2280,0,653675
3,1.75,1270,8422,3,7,1270,0,340000
4,2.5,2880,8400,3,8,2050,830,775000
4,1.75,1730,7245,4,7,880,850,423000
4,2.5,3510,24604,3,10,3510,0,782000
4,2.25,2230,6000,3,8,1810,420,740000
3,1,1570,5510,4,7,1070,500,495000
4,3.25,1860,4356,3,9,1860,0,967000
4,1,1710,6050,3,7,1410,300,715000
4,1,1920,13787,4,7,1220,700,170000
4,2.5,3420,115434,3,9,3420,0,570000
3,2.5,2170,9900,3,7,1690,480,242050
5,2,1870,13970,4,7,1120,750,455000
3,1.5,1370,7500,3,7,1080,290,203000
3,2.75,3010,1842,3,9,3010,0,785000
3,2,1570,4625,5,8,1570,0,835000
2,1,1570,4704,3,8,1570,0,502000
7,4.75,5310,8816,3,10,3650,1660,2.30E+06
2,1,860,9000,4,6,860,0,216000
3,1.5,1170,7645,4,7,1170,0,760000
3,1.75,2720,4720,4,7,1580,1140,685000
4,4,4270,6002,3,10,3180,1090,1.30E+06
3,2,1270,3600,3,7,1270,0,349500
4,2.25,2120,7700,4,7,1490,630,426000
3,1.75,1550,1905,3,7,1550,0,242500
5,3.75,4270,7500,3,10,3210,1060,1.60E+06
5,3.25,3290,6422,3,9,3290,0,810000
4,2.75,2580,3560,5,7,1710,870,937750
3,2.5,950,1110,3,8,950,0,475000
3,1.75,1480,8163,3,7,1040,440,865000
4,1.5,1480,47045,5,6,1480,0,283000
