3,1,960,7314,5,6,960,0,205000
4,1.75,2090,4300,4,7,1250,840,494000
4,3,3120,157875,4,8,3120,0,790000
2,1.5,1070,1236,3,8,1000,70,401750
4,1,1540,8400,3,7,770,770,278500
2,1,1300,39639,4,6,1300,0,295000
4,2.75,3320,8653,3,8,3320,0,679990
3,1,1320,9000,3,7,1320,0,196500
3,1,1350,7553,3,6,1350,0,280000
3,2.5,2750,37096,3,9,2750,0,375000
3,1.75,1790,6775,3,8,1790,0,485000
3,2.25,1960,6500,4,8,1960,0,450000
3,1,800,2296,4,6,800,0,370000
3,2,1460,6250,4,7,1460,0,705000
2,1,1430,7819,3,7,1110,320,380950
5,2,2600,3750,4,6,1400,1200,580000
4,3,2940,5763,5,8,1640,1300,640000
3,1,1520,8600,3,6,1040,480,210000
4,1.75,1250,7400,5,6,1250,0,445000
2,1,770,8149,3,6,770,0,220000
3,2.5,1960,3540,3,8,1960,0,342000
3,2.5,2090,12027,3,8,2090,0,327500
3,1,980,7000,3,6,980,0,330000
3,1,1010,10215,3,6,1010,0,180000
4,2.5,2620,6114,3,9,2620,0,675000
4,2.5,1930,8040,3,7,1380,550,513000
5,2.5,2990,9240,3,8,2990,0,357000
3,2.5,1330,2180,3,8,1330,0,539950
3,1.5,1630,82764,4,6,1630,0,300000
3,1.75,1070,9000,4,7,1070,0,361500
2,1.75,1400,865,3,8,1110,290,358500
3,2.5,1660,1091,3,9,1530,130,729500
4,2.5,3220,14463,3,8,3220,0,630000
3,1.75,2330,12141,3,7,1390,940,535000
5,2,2280,5750,4,8,1140,1140,383000
3,2.25,2000,8030,4,8,1000,1000,420000
4,1.5,2180,22870,4,6,1280,900,273000
3,2.75,2250,9600,4,9,1830,420,765000
3,1.75,1170,8182,3,7,1170,0,352500
4,2.75,3500,7200,3,9,3500,0,788600
3,2.25,1960,1585,3,7,1750,210,300000
1,1.5,1900,40600,5,9,1450,450,550000
3,2.25,1640,1204,3,8,1640,0,772000
4,2.5,4040,25752,3,10,4040,0,765000
3,2.75,2200,3885,3,8,2200,0,572000
3,2.25,1980,8775,3,7,1290,690,437000
4,1.75,1730,11890,2,7,980,750,425000
3,2.5,2370,15375,3,9,2370,0,420000
2,1,1210,18700,4,7,1210,0,198900
4,1.75,2180,13529,3,7,1090,1090,405000
4,2.5,2190,7294,3,8,2190,0,349000
3,1.5,1980,10203,4,7,1680,300,570000
3,2.25,1520,7199,4,7,1520,0,275250
4,1,1780,5000,3,8,1780,0,654500
3,2.5,1530,2890,3,7,1530,0,250000
3,1,1370,4000,4,8,1370,0,593500
2,1,780,5300,3,6,780,0,130000
4,2.5,2380,13435,3,10,2380,0,648000
4,2.75,2600,5390,4,8,1300,1300,855000
4,2,2100,12620,4,7,2100,0,500000
4,1,1150,5217,3,7,1150,0,489000
4,2.5,2520,7253,3,9,2520,0,442000
2,1,1320,4520,3,6,1320,0,451555
3,1,1250,17380,4,7,1250,0,345000
2,2.25,1470,1101,3,8,1340,130,510000
3,2,1360,9688,4,7,1360,0,244000
3,1.5,2440,5750,3,8,1320,1120,875000
3,1.5,1680,8712,3,8,1680,0,356000
5,2.75,3080,5752,3,9,3080,0,579950
3,2.5,1580,12250,3,8,1580,0,267000
3,2.5,1620,2640,4,7,1620,0,498000
3,1,1360,5840,4,5,1360,0,253200
5,3.5,3520,5400,3,9,2400,1120,1.50E+06
2,1,840,863,3,8,840,0,291000
6,1.75,2120,3801,4,7,1220,900,493000
3,2.5,1830,8133,3,8,1390,440,510000
4,2.5,2280,4534,3,8,2280,0,570000
2,1.5,1210,5000,5,6,1210,0,615000
3,2.5,3380,9528,3,10,3380,0,751000
4,2.5,2470,77550,4,7,2470,0,635000
4,2.25,2390,57599,3,8,2390,0,589000
2,1,1160,8504,4,7,1160,0,345000
2,2.25,1890,5400,5,8,1610,280,750000
4,2.5,2250,11349,3,8,2250,0,572650
3,2.5,2400,7478,3,9,2400,0,489950
3,1.75,1300,9856,4,7,1300,0,242000
3,2.5,2120,4780,3,7,2120,0,575000
3,1.75,1240,4550,4,7,1240,0,505000
2,1,1270,3700,3,7,1270,0,404500
3,2,2010,7017,3,7,2010,0,775000
5,2.5,2830,25958,5,8,1610,1220,700000
3,1,1040,8645,4,7,1040,0,198400
2,1.75,1350,4286,3,8,1350,0,455000
4,2.5,2490,4751,3,7,2490,0,360000
3,1.5,2710,47419,3,7,2170,540,442500
3,1.5,1590,6750,3,7,1080,510,357000
2,2,1550,435600,2,7,1550,0,330000
4,2.25,2190,15491,3,8,2190,0,524000
3,1.5,1720,8100,3,8,1720,0,667000
3,2.25,2480,15022,3,9,1330,1150,1.05E+06
4,2.5,3880,14550,3,10,3880,0,762300
2,1.5,1280,8710,3,7,1280,0,252500
3,2.75,2670,3738,3,10,1720,950,798800
3,2,1540,7210,4,7,1540,0,252000
2,1,790,4000,3,6,790,0,399000
3,1,860,11725,4,6,860,0,210000
3,2.5,3370,36218,4,9,3370,0,699950
3,1.5,1730,9509,3,8,1270,460,563000
4,2.75,2360,7716,3,7,1390,970,405000
6,2.5,2420,11662,4,7,1420,1000,376000
4,1.75,2430,14000,4,7,1580,850,602000
3,2.5,1650,6684,3,7,1650,0,268000
4,2.25,1880,6160,3,7,1880,0,272000
3,2.5,1790,2700,3,8,1790,0,509900
3,2.25,1580,39189,3,7,1180,400,425000
3,1.5,1910,21374,1,8,1910,0,1.50E+06
4,3,3110,4408,4,10,2510,600,1.42E+06
3,1.75,1340,7473,4,7,1340,0,223000
3,1,1350,10000,4,7,1350,0,450000
3,1.75,1420,6289,3,7,1100,320,329922
3,2.5,2020,3000,4,6,1010,1010,400000
3,1,1920,6862,3,7,1120,800,325000
3,2.5,2340,4273,3,7,2340,0,459950
4,2.25,1800,9350,3,8,1800,0,225000
4,2.5,2130,9013,3,8,2130,0,310000
3,1.5,1410,3600,3,7,1410,0,626700
3,2.5,1550,8134,3,7,1550,0,268000
4,3.25,4290,12103,3,11,2690,1600,1.40E+06
4,2.5,2020,7200,4,6,2020,0,319950
4,1.75,1900,10588,5,6,1900,0,265000
4,2.75,2700,35362,5,8,2700,0,669000
3,2,1940,3800,4,7,1050,890,627000
4,2.5,3030,7187,3,9,3030,0,815000
4,1.75,1870,16549,3,8,1870,0,419950
3,2,1730,12219,4,7,1730,0,625000
2,1,1200,12856,4,6,1200,0,546000
3,1,2320,6750,3,7,1160,1160,335000
5,3,2240,18265,4,8,2240,0,805000
3,1,1260,4080,4,7,1260,0,565000
3,1,1120,8549,3,7,1120,0,750000
3,1.5,2540,9520,3,8,1500,1040,690000
4,2.5,2460,7800,3,8,1500,960,261500
3,1,1790,3876,5,7,1090,700,615000
3,2.25,2140,6720,3,8,1440,700,524000
3,1.5,2020,11358,4,6,1190,830,465000
3,2.5,1710,2875,3,8,1710,0,590000
4,2.5,1800,8432,4,7,1200,600,375000
4,3.75,1980,4095,3,9,1980,0,912000
3,2.5,2600,10183,3,8,1300,1300,748000
4,2.5,2320,3974,3,7,2320,0,485500
3,2.5,1940,9000,4,7,970,970,576000
3,1.5,1060,9711,3,7,1060,0,291850
4,2.25,2160,8817,3,7,1460,700,335000
3,1,1150,4825,4,6,1150,0,240000
5,1.5,1750,12491,3,6,1390,360,465000
5,4,4360,8030,3,10,4360,0,1.29E+06
2,1,1060,1600,3,7,1060,0,353250
4,2.25,2160,8811,3,8,1360,800,260000
3,2.5,1630,1587,3,8,1630,0,557000
2,1.5,1010,1968,5,5,1010,0,440000
2,1,1010,6000,4,6,1010,0,302000
2,2.25,1060,1208,3,8,940,120,499950
4,3,2460,9606,3,8,2460,0,280000
3,1,1060,8097,4,7,940,120,420000
4,3.25,2690,7200,3,9,1720,970,635000
3,1.75,1850,5100,3,7,1020,830,580000
4,2,1610,4770,4,7,1230,380,495000
3,1.75,1510,6597,4,6,950,560,410000
2,1,1010,3916,4,6,810,200,400000
3,1.75,1830,9720,3,7,1150,680,550000
3,2,1890,14040,3,7,1890,0,395000
3,1,1250,10094,4,6,1250,0,255000
4,2.5,1910,7201,3,7,1210,700,340000
4,2.5,4600,67369,3,10,4600,0,800000
4,3.75,4740,126759,4,10,4740,0,1.05E+06
4,2.75,3140,7258,3,10,3140,0,920000
3,2.25,2540,7216,3,8,2540,0,265000
2,2.5,1450,1213,3,9,1110,340,659000
2,1,670,6000,5,6,670,0,415000
4,2,1930,3976,4,8,1930,0,650000
3,3,3760,188760,4,10,2640,1120,555000
3,3.25,5290,224442,4,11,4540,750,1.69E+06
1,2.25,2060,10600,3,7,1560,500,360000
3,1.5,1210,7247,4,7,1210,0,208000
5,3,2840,7199,3,7,1710,1130,292050
3,2.25,2780,6000,4,9,1670,1110,834500
4,3.5,2870,3225,3,9,2070,800,460000
3,2.5,1980,6922,5,8,1980,0,370000
3,2,1300,22605,3,7,1300,0,469000
3,1,1520,2500,3,8,1520,0,550000
3,2.25,3170,5000,5,10,2230,940,1.60E+06
4,2.5,2310,5100,3,9,2310,0,685000
2,1,880,2400,3,6,760,120,376000
4,2.25,2030,11585,4,7,1590,440,545000
4,2.5,2810,6146,3,9,2810,0,301000
2,1.75,1250,2890,4,7,790,460,450000
3,2.25,2280,200811,3,7,2280,0,410000
3,1.5,1300,3348,3,7,1300,0,435000
3,2,1390,8245,2,7,1390,0,204900
4,2.5,2820,33750,4,9,2820,0,369900
4,1.75,1440,6144,5,6,720,720,339888
3,2.25,2380,6000,5,9,1650,730,886000
4,2.25,2860,40284,3,10,2860,0,872000
5,3,2200,6380,3,7,1440,760,559900
5,3,2170,2440,4,8,1450,720,750500
3,1,1060,10050,4,7,1060,0,335000
3,1,1040,7500,4,6,1040,0,172500
3,2.5,2370,11172,3,9,2370,0,640000
3,2.5,1720,6200,3,7,1720,0,255000
3,3.25,2260,3727,3,8,1880,380,795000
4,3.25,4400,16625,3,11,4400,0,1.05E+06
4,3,2430,11670,4,7,1330,1100,518000
3,1.75,1740,9500,4,8,1150,590,585000
5,1,1340,11198,3,8,1340,0,345950
2,1,1000,5375,3,7,1000,0,420000
4,2.75,3555,6565,3,9,3555,0,895990
3,1.5,1760,6723,3,7,1160,600,470000
3,1.5,1320,1250,3,8,1320,0,580000
4,2.5,1984,32400,3,8,1564,420,380000
4,2.75,2500,5995,3,8,2500,0,350000
2,1,1000,16524,3,5,1000,0,115000
3,2.25,2190,7149,4,8,1240,950,539950
4,4,3770,8899,3,10,2940,830,1.10E+06
4,2.75,4030,10240,3,8,3310,720,835000
3,3,3180,2758,3,11,2240,940,1.33E+06
2,1,2160,12960,3,7,1360,800,305000
4,3.5,4230,20377,3,11,4230,0,2.08E+06
4,3.5,3510,9084,3,10,3510,0,695000
3,1.75,1880,8706,3,7,940,940,395900
6,3.5,4860,11793,3,11,3860,1000,1.07E+06
4,2.5,2780,6837,3,9,2780,0,1.09E+06
4,1.75,2510,5800,4,9,1830,680,880000
1,1.75,1010,10900,4,6,1010,0,283700
3,1.75,1620,7330,4,7,1090,530,459000
5,2,1760,21562,3,8,1560,200,647500
3,1.75,1720,7200,3,7,1420,300,622200
3,1.75,1890,7560,3,8,1430,460,475000
4,2.5,2660,5608,3,9,2660,0,729000
3,1,1080,10200,4,7,1080,0,207000
3,2,2080,7020,4,7,1040,1040,555000
2,1,1610,19965,3,7,1610,0,255000
3,1.5,2240,7227,3,9,1440,800,700000
3,1.5,1520,6805,4,7,1040,480,265000
4,2.5,2160,6223,3,8,2160,0,383000
5,2.75,2400,8050,3,8,2400,0,327000
2,1,1010,3885,4,7,1010,0,500000
4,2.5,2830,13760,3,8,2830,0,518000
4,1,1200,6000,3,6,1200,0,220000
3,2.5,1680,1620,3,9,1120,560,629950
3,2.75,2310,1850,3,10,2020,290,713000
2,1.75,1880,7208,3,7,940,940,340000
3,2.5,2360,8093,3,8,2360,0,339999
3,1.5,1470,14821,4,7,1470,0,264000
4,3.25,2760,4104,3,8,1900,860,641000
2,2,930,1662,3,7,670,260,368000
4,2.75,2470,7200,5,7,1350,1120,525000
3,2.25,2750,219542,3,7,1870,880,510000
4,2.25,2500,4046,4,7,1520,980,669500
3,2.5,2090,4590,3,7,2090,0,300000
3,1,1560,4500,3,7,1560,0,415000
3,1,1160,11776,3,7,1160,0,305000
3,1,1380,9875,3,7,1380,0,245000
3,1.5,1800,6250,3,8,1420,380,580000
4,2.5,1252,25002,3,8,992,260,352000
4,2.25,3300,15375,3,8,2820,480,1.25E+06
2,1,740,9003,3,5,740,0,157500
3,2.5,1510,1618,3,8,1330,180,453000
3,2.5,1340,3011,3,7,1340,0,230000
3,1.75,1490,8000,3,8,1490,0,275000
3,2.5,2280,10255,4,8,2280,0,380000
3,2.75,2610,5000,4,7,1710,900,608000
4,2.75,3010,3400,3,9,2240,770,925000
3,1,910,8658,3,7,910,0,306000
3,1.5,990,8925,4,7,990,0,158000
4,3.25,3730,4560,3,9,2760,970,595000
3,2,1640,7201,3,8,1640,0,405000
3,2.25,3360,7108,3,10,2770,590,2.19E+06
4,1,1730,36356,4,6,1730,0,319000
3,2.5,2420,11953,3,9,2420,0,570000
4,2.25,2670,9040,3,8,2170,500,339950
3,1.5,1410,8415,4,7,780,630,215000
3,2.25,1720,17235,4,7,1440,280,286900
3,2,2020,7260,3,7,1180,840,317000
3,2,1510,10827,3,7,1510,0,390000
5,2.75,2530,9375,5,7,1530,1000,355000
4,4,4000,9309,3,9,4000,0,688000
3,1,1700,4750,4,6,1200,500,570000
4,2.25,1860,7000,3,8,1120,740,239900
4,2,1530,5250,3,7,1110,420,381800
4,2.5,2240,5624,3,7,1520,720,469000
4,2.5,2110,10100,3,8,2110,0,981000
4,2.75,1500,7036,3,7,1060,440,262500
3,2,2390,6888,5,8,2390,0,1.10E+06
3,2.5,1650,1838,4,7,1270,380,453000
3,3,2500,8304,3,8,2500,0,364900
4,2.5,2340,8955,3,9,2340,0,645000
3,1.75,1220,7250,3,7,1220,0,251000
2,1,750,5534,3,7,750,0,325000
3,1,1030,10480,4,7,1030,0,397500
4,2,1400,3600,3,7,1100,300,485000
5,4,4500,8130,3,10,4500,0,750000
5,1.75,2000,8713,3,7,1000,1000,620000
4,2.5,2070,8685,3,7,2070,0,262000
3,2.25,2770,57745,3,8,2770,0,653000
3,1.75,1330,6301,3,7,1330,0,236000
3,1.75,1260,17000,3,7,1260,0,335000
2,1,840,12750,3,6,840,0,150000
3,1.5,1980,4000,3,8,1980,0,707000
4,3,1840,7510,5,8,1840,0,268000
3,2.5,2280,7417,3,8,2280,0,320000
3,3,1800,5000,3,8,1500,300,606400
4,2,1710,7455,3,7,1030,680,234000
3,3.5,4660,21164,3,12,4660,0,1.64E+06
2,1,800,8125,3,6,800,0,145000
4,2.25,1950,9800,3,8,1330,620,560000
5,2.25,3320,11350,5,8,1660,1660,989900
2,1,720,5820,5,6,720,0,350000
3,2.5,1920,4534,3,8,1920,0,475000
2,1,1180,7200,4,6,1180,0,336000
3,2.5,1470,1571,3,8,1180,290,420000
4,2.5,3910,8442,3,9,2710,1200,489000
4,2,1780,5336,5,6,930,850,315000
3,2,1420,16000,3,7,1420,0,324450
3,2,1970,3420,5,8,1970,0,812000
3,2.25,1830,13477,4,7,1170,660,439000
3,2,1350,8587,3,7,1350,0,244000
4,3,3040,11651,3,10,3040,0,691000
2,1.5,1480,15641,4,7,1480,0,490000
2,2,1690,4200,3,7,1690,0,462500
3,1.5,2240,3800,3,8,1370,870,510000
3,3,1280,1085,3,8,1280,0,533000
2,1,910,9753,3,5,910,0,85000
3,2.25,1740,9682,5,8,1740,0,425000
3,2.5,2040,14071,3,7,2040,0,330000
3,2.5,1880,5502,3,8,1880,0,485000
3,2.5,1710,4920,3,7,1710,0,415000
3,1.75,1820,9875,4,8,1820,0,539950
3,3,2780,6000,3,9,2780,0,594866
2,1,1050,9000,4,7,1050,0,219000
3,2.75,3290,11441,4,10,3290,0,515000
3,2.5,1740,30886,3,8,1740,0,379000
2,1.75,1700,5000,3,6,850,850,511718
3,2.5,1980,13964,5,7,1980,0,760000
4,1.5,2340,5000,3,8,2100,240,730000
3,2.5,1820,16300,4,7,1220,600,453000
4,2.5,3020,4950,4,9,2020,1000,975000
3,2.25,1430,4777,3,7,1430,0,355000
2,1,1600,8961,4,7,1390,210,218500
3,2.25,2270,8876,3,7,1380,890,332000
3,2.5,2570,3600,3,9,2570,0,680000
4,1,1440,7215,3,7,1440,0,355000
3,3,2350,1620,3,9,1560,790,1.20E+06
5,2.5,2620,8050,3,8,1520,1100,550120
4,1.5,2130,8800,3,7,1100,1030,260000
2,1,940,4264,5,7,940,0,416000
2,1,890,7250,3,7,890,0,285000
3,2.5,1910,3075,3,8,1910,0,595000
4,3.25,2630,2550,3,10,2030,600,855000
3,0.75,1040,15000,3,6,1040,0,230000
3,2.5,1740,13750,4,9,1740,0,645000
3,4,1390,1569,3,9,1150,240,458000
5,3.25,4300,9270,3,10,2910,1390,1.40E+06
3,2.5,2610,7301,3,8,2610,0,575000
3,2.25,2210,5742,3,8,1460,750,590000
3,2.75,3176,13391,4,9,2726,450,819000
4,2.25,2160,9525,3,8,1080,1080,750000
4,2.5,3830,13800,4,9,2030,1800,1.10E+06
3,2.5,1950,4345,3,7,1950,0,425000
3,3.5,4380,6350,3,8,2780,1600,740500
4,2.75,2310,5650,3,8,1330,980,450000
4,2.25,2010,7575,3,7,1220,790,440000
3,2.25,2610,3357,4,7,1980,630,1.05E+06
4,2.75,2390,6979,3,8,2390,0,625000
3,1,1400,7066,3,8,1400,0,349950
5,3.5,3430,6872,3,10,2830,600,473000
3,3.5,1690,1765,3,8,1370,320,622000
3,2,2250,8000,4,9,2250,0,998800
3,1,1000,9170,3,7,1000,0,329950
2,1,800,5080,3,7,800,0,404500
4,2.5,2650,8685,3,9,2650,0,424000
3,2.25,1400,1078,3,8,940,460,430100
3,1,1530,2400,4,7,890,640,575000
3,1.75,1520,7137,3,5,1520,0,198500
3,1.75,1560,10919,3,7,1560,0,236000
3,1,1680,7910,3,7,1680,0,599950
3,1.5,1860,9003,3,7,1490,370,415000
2,2,1430,3880,4,7,1430,0,545000
3,1.5,1430,11173,1,7,1430,0,380000
3,1.75,1590,2500,4,7,1190,400,556000
4,2.75,1690,6090,3,7,1400,290,550000
4,2.75,2100,4480,4,7,1780,320,679000
4,2.5,2420,5244,3,9,2420,0,449950
3,2.75,3400,7200,3,9,2470,930,530000
4,4,4360,12081,3,10,4360,0,1.98E+06
3,2.5,3520,237402,3,9,3520,0,905000
3,1,960,9624,3,7,960,0,234000
2,2,1540,6804,5,7,1020,520,582500
3,2.25,2110,8000,3,8,2110,0,385000
3,1.5,1240,1221,3,8,1050,190,320000
3,2.5,2010,57934,3,7,2010,0,495500
4,2.75,2414,7693,3,8,2414,0,292000
4,2.75,3010,7427,3,8,3010,0,800000
4,1.5,1850,7547,4,7,1850,0,245000
4,2.25,2190,9020,3,8,2190,0,320000
4,1.75,2230,7957,4,7,2230,0,537000
2,1,1010,3400,3,7,1010,0,470450
3,2.25,1600,39848,4,8,1600,0,380000
4,2.25,1720,7803,3,8,1350,370,336750
4,2.5,2660,22050,3,9,2660,0,629000
3,1.75,1397,18000,3,7,1397,0,257000
5,2.5,2920,5568,3,8,2320,600,875000
5,2.25,2640,14959,4,7,1770,870,1.40E+06
0,2.5,1490,7111,3,7,1490,0,320000
4,2.25,2130,8640,3,7,1430,700,530000
1,1,540,10125,3,5,540,0,345000
2,2.25,3950,3938,3,10,2910,1040,1.31E+06
3,2,2064,46173,5,7,2064,0,567035
4,3.25,2885,33671,4,8,2885,0,605000
4,2.75,3320,5559,3,9,3320,0,850000
3,2.5,1880,5290,3,8,1250,630,355000
3,1,1290,6380,3,7,1290,0,790000
4,2.5,2650,12001,4,9,2650,0,870000
3,2.5,1670,5146,3,8,1670,0,540000
3,1.75,1630,1404,3,8,1020,610,540000
4,2.25,2190,3746,3,8,2190,0,294000
4,2.5,2460,4425,3,8,2460,0,693000
4,2.75,2470,5500,3,9,1570,900,1.21E+06
4,3.5,4370,37193,3,8,2780,1590,473000
3,1,860,7632,3,6,860,0,278000
3,2.25,2680,175982,3,9,2680,0,635000
4,1.75,1360,7700,4,7,1360,0,260000
4,2.5,3420,6845,3,9,3420,0,757500
4,2.25,2630,4000,5,9,1810,820,1.05E+06
3,3,1880,2200,3,8,1520,360,630000
4,2.25,2310,36136,4,9,2310,0,760500
3,1.75,1720,5899,3,8,1220,500,514000
3,1.75,1850,6000,3,8,1650,200,819000
3,2.5,1510,1178,3,8,1060,450,515000
4,2.5,2570,11473,3,8,2570,0,356500
4,1.5,2130,5000,4,8,2130,0,749000
3,2,1900,8002,3,7,1900,0,252500
4,2.25,1790,7311,3,7,1790,0,402000
4,2,2210,5572,3,7,1760,450,510000
4,2.5,2090,7434,3,7,1090,1000,325000
4,1.5,1850,3600,3,8,1660,190,920000
3,2.5,2120,4310,3,7,2120,0,559950
5,2.75,3150,7119,3,9,3150,0,819900
3,1,990,8012,4,7,990,0,225000
2,1,1470,5400,3,8,1470,0,865000
3,1.75,1680,3420,3,7,960,720,526000
4,3.5,3120,5086,3,9,2480,640,953007
4,2.5,2700,6515,3,9,2700,0,426500
3,2.25,2010,4400,3,7,2010,0,350000
5,2.5,3100,10189,3,8,3100,0,540000
5,2.5,2380,91476,4,8,1580,800,529000
3,2.25,2890,5000,3,9,2890,0,930000
3,1.75,1220,1450,3,6,620,600,385000
3,1.75,1540,13002,2,8,1200,340,492450
2,2.75,730,5000,3,7,730,0,464000
4,1.75,3220,7392,4,8,2010,1210,485000
3,1.75,1730,9334,3,8,1220,510,499990
2,1.75,1620,113862,3,7,1620,0,439000
3,2,1630,7800,5,7,1630,0,376500
4,1.75,1980,7840,4,7,990,990,416000
3,2,3030,9374,4,7,2100,930,590000
4,2.5,2910,5776,3,8,2910,0,589000
4,2.5,2330,7064,4,8,1780,550,595000
4,1.75,1870,5200,4,7,1200,670,594000
2,2.25,1610,1968,4,7,1610,0,293000
4,2.25,3260,4640,5,9,2360,900,1.33E+06
3,2.5,1810,7200,5,7,1310,500,827500
2,1,820,6400,4,7,820,0,361280
3,2,1240,12285,3,7,620,620,248500
3,2.5,1740,4960,3,8,1740,0,477000
2,1,840,6720,3,7,840,0,355000
3,2,1170,5360,3,6,1170,0,335000
2,2.25,1350,1493,3,8,1050,300,395000
3,2.5,2120,3600,3,9,2120,0,680000
4,3.75,4130,12320,3,11,4130,0,1.07E+06
3,1.75,1920,7400,4,8,1260,660,605000
2,2,1180,9265,3,7,1180,0,257500
3,2.75,2480,209199,3,8,1870,610,408506
4,4.5,3130,5126,3,10,2450,680,1.33E+06
4,1.5,2040,8800,4,7,1020,1020,510000
4,2.5,3280,209088,3,10,3280,0,925000
2,1,740,5000,4,6,740,0,255000
3,1,940,5650,3,6,940,0,260000
4,3.25,3080,4120,3,9,2380,700,1.28E+06
3,2.5,2000,8424,4,7,1300,700,470000
4,2.5,2980,4930,3,9,2890,90,750000
0,0,3064,4764,3,7,3064,0,1.10E+06
4,2,1930,6600,4,7,1030,900,268000
3,2.25,2520,6690,5,8,1700,820,835000
2,1,920,5029,4,7,920,0,600000
4,1,1480,8321,3,7,1080,400,425000
2,1.75,1480,4000,4,6,740,740,409000
5,3.25,4110,7920,3,9,3150,960,1.88E+06
3,1,1720,9830,4,7,1720,0,950000
3,1,960,9563,5,7,960,0,215000
4,2.5,3180,21904,3,9,3180,0,736500
3,1.75,1930,7210,3,7,1110,820,434500
5,2.5,2860,68519,5,8,2860,0,670000
3,2.5,1590,1431,3,8,1060,530,480000
4,3.5,3370,5000,3,8,2470,900,900000
3,2.5,1800,8518,3,7,1800,0,325000
4,2.75,2475,4000,3,7,2475,0,329900
3,2,1890,12017,3,8,1890,0,1.43E+06
3,2.5,2410,9916,4,10,2410,0,700000
2,1,1140,5400,5,7,1140,0,549000
3,1,1030,7200,3,6,880,150,335000
3,1.75,1160,6120,3,7,1040,120,450000
4,2.5,3170,47502,3,10,3170,0,1.04E+06
2,1,930,3100,3,6,930,0,390000
5,2.75,3010,12611,3,10,3010,0,837700
2,1.75,1660,11747,3,7,830,830,452000
5,4.5,4440,9784,3,10,4440,0,600000
3,1,1070,9497,3,7,1070,0,315000
4,2,2050,4000,5,7,1210,840,495000
3,2.25,1720,9435,4,7,1220,500,210000
1,1,680,1638,1,6,680,0,252000
3,1.75,1680,4240,4,7,1680,0,540000
3,2.5,1920,144619,3,8,1920,0,465000
4,2.25,2390,11250,3,9,2390,0,359500
3,2,1270,6760,5,7,1270,0,386100
3,2.5,2780,275033,3,10,2780,0,950000
4,4,2680,6000,3,7,1380,1300,777000
4,3,3720,14125,4,9,1930,1790,875000
3,2,1824,7120,3,9,1824,0,375900
3,2.5,2160,6000,4,8,1880,280,990000
4,2.75,2720,6427,3,8,1650,1070,469950
4,2.25,2350,10664,2,7,1510,840,800000
3,1.75,1700,8432,3,8,1230,470,475000
3,2.25,1440,10500,3,8,1130,310,246000
2,1.75,1340,1050,3,8,1340,0,360000
5,2.75,2520,4643,4,8,2120,400,1.10E+06
2,1,1450,9150,4,7,1450,0,355000
3,2.25,2180,6850,3,7,1750,430,455000
4,2.75,2030,56192,3,8,1550,480,440000
3,1.75,1520,9605,3,7,1520,0,530000
2,1,1060,6120,3,7,1060,0,826000
3,1.75,1470,6018,3,8,1470,0,479000
4,2.5,2700,37431,4,8,1600,1100,680000
3,3.25,3130,28001,3,9,2210,920,595000
4,2.5,2570,7221,4,8,1570,1000,626000
2,1,2180,9300,4,7,1090,1090,490000
4,2.5,4570,16015,3,11,4570,0,1.06E+06
3,2.25,2430,8327,4,9,1430,1000,690000
5,2.25,2370,15512,4,9,2370,0,913888
4,2,2090,40419,4,7,2090,0,460000
4,1.75,1870,8663,5,7,1870,0,460000
4,2.5,2500,5831,3,8,2500,0,350000
5,2.75,3220,8160,3,9,3220,0,384000
3,1,1390,21262,3,7,1390,0,199000
4,2.75,2320,4344,3,8,2320,0,449950
3,2,1460,3600,3,7,1460,0,591000
3,3.25,1510,1850,3,8,1230,280,465000
3,2.75,3180,3680,4,9,2190,990,850000
3,1.5,2220,4830,3,9,1790,430,1.10E+06
3,3,1820,4300,4,8,1620,200,775000
4,2.5,2310,7800,3,8,2310,0,375000
2,1,1220,5040,3,7,1220,0,555950
3,3.5,2100,2479,3,9,1450,650,555000
4,2.5,3220,35400,3,9,3220,0,690000
4,2,1790,7800,5,8,1790,0,570000
3,1,1200,6561,3,6,1200,0,263700
3,1.5,2000,7350,3,8,2000,0,560000
4,1.75,3000,42200,3,7,1500,1500,585000
4,2.75,2240,27820,4,8,2240,0,580379
3,2.5,1600,6510,3,7,940,660,439500
3,2.75,2220,5000,3,7,2220,0,400000
2,1,980,3800,3,7,980,0,390000
3,1.75,1120,10187,3,7,1120,0,240415
5,3,3040,6604,3,9,3040,0,538900
4,1.5,1130,7840,4,7,1130,0,210000
3,2.75,2670,4800,3,8,2670,0,408000
4,1.75,1570,3250,5,8,1570,0,535000
4,2,2760,21465,4,9,2120,640,459950
4,2.5,2120,57050,3,9,2120,0,475000
4,2,1980,15354,3,7,1980,0,395000
5,3.5,2390,6600,5,7,2390,0,267500
5,3.5,2980,5809,3,8,2980,0,750000
3,1.75,1960,43995,3,7,1960,0,480000
2,1,700,3000,4,6,700,0,310000
4,2.5,3140,14421,3,10,3140,0,780000
5,3.5,4510,16305,3,10,2820,1690,960000
4,3.75,2690,4000,4,9,2120,570,800000
3,1.75,2040,22693,4,8,2040,0,355000
3,1.75,1650,10250,5,8,1650,0,710000
4,1,1350,3333,3,7,1350,0,429000
2,1.5,1295,1093,3,9,1105,190,487028
4,2.25,2290,5350,4,9,2120,170,975000
4,1.75,1630,3000,3,7,930,700,313000
5,3.75,6810,7500,3,13,6110,700,2.48E+06
4,2.5,2500,10215,3,9,2500,0,635000
5,2.5,2690,5557,3,7,2690,0,279000
2,1,880,1753,4,7,880,0,330000
4,2.25,3240,12930,4,9,2730,510,1.07E+06
3,1.75,1290,7210,3,7,1290,0,205000
4,1,1400,6739,3,7,1000,400,325088
3,2,1910,5040,3,8,1910,0,430000
4,2.5,1990,3980,3,7,1990,0,328000
2,1,1030,5000,5,6,1030,0,455000
3,1.75,1990,9594,3,8,1190,800,507500
4,2.25,2660,11200,4,8,2660,0,425000
2,2,1440,8425,4,6,1440,0,327200
3,1.5,1090,7698,5,7,1090,0,249950
3,2.5,2450,3582,3,9,2450,0,552500
3,1,1410,7700,3,7,980,430,225000
4,4.25,4285,9345,3,10,4285,0,1.89E+06
3,2,1108,1128,3,7,1108,0,369500
3,1,1810,7200,4,7,1130,680,287500
3,2.25,1550,5511,3,8,1550,0,481015
3,2,1500,2506,3,7,870,630,395000
5,3,2480,10090,3,7,1300,1180,372500
3,2,1420,4080,3,7,1420,0,485000
2,1,1470,3864,4,7,1170,300,548000
3,2.5,1480,7210,3,7,1180,300,276200
4,3,1540,4140,5,7,1540,0,624000
3,3.5,2050,2020,3,8,1520,530,761000
2,1,2180,12875,3,7,1480,700,275000
2,1,1290,3383,3,7,1290,0,305000
5,1.75,1400,5071,3,5,1400,0,425000
5,2.75,2220,4000,3,7,1230,990,427000
4,2.5,2800,8494,3,8,2800,0,426000
4,1.75,2350,6200,4,7,1410,940,555000
3,2.25,1540,5338,5,7,770,770,312000
1,1,620,5100,3,6,620,0,385000
3,1,1330,6900,3,7,1330,0,209000
3,2,1870,8442,5,7,1060,810,456000
3,1,860,6664,3,6,860,0,219900
4,2.5,3430,7200,3,9,3430,0,1.29E+06
4,2.5,2960,41656,3,10,2960,0,883000
4,2,2380,4500,3,6,1470,910,455000
3,1,1020,55756,3,7,1020,0,310000
2,1,960,20954,3,7,960,0,255000
4,2.5,1750,8476,4,7,1240,510,335000
4,2.5,2740,11975,4,8,2740,0,730000
3,2.5,2160,15817,3,8,2160,0,354000
3,1.75,1500,6000,5,7,850,650,700000
3,1.5,2040,6000,3,7,1340,700,335000
5,3.25,2680,3011,3,9,1870,810,1.03E+06
4,2.5,3200,7500,5,8,1860,1340,1.18E+06
3,2.5,2050,8172,3,8,2050,0,394950
4,1.75,1440,8114,4,7,1440,0,323000
3,1,1560,7552,4,6,910,650,320000
3,1,1100,8560,3,6,1100,0,199990
3,2.5,1560,5845,3,7,1560,0,296000
3,2.25,1810,5107,3,8,1810,0,626000
3,1.75,1690,7953,3,7,1690,0,259900
4,4,3430,35102,4,10,2390,1040,832500
4,3.75,3280,6000,3,9,3280,0,928950
3,1,1570,4000,5,8,1570,0,700000
3,2,1440,3218,3,7,850,590,380000
3,1,1170,9730,3,7,1170,0,252000
3,2.25,1710,7134,4,7,1130,580,172040
3,2.25,1440,9806,3,7,1440,0,253000
3,1,1060,9123,3,7,1060,0,641200
4,1.5,1200,10890,5,7,1200,0,226000
3,2,1610,8400,3,8,1610,0,225000
4,2.5,1950,7350,3,7,1150,800,385000
4,2.5,4040,9630,4,9,2020,2020,1.40E+06
3,2.5,1500,2255,3,7,1500,0,348000
4,2.25,2030,8517,4,8,1380,650,500000
4,3,3400,5100,3,9,3400,0,585000
3,1.75,1430,10816,3,7,1430,0,185000
3,1.75,1950,15037,3,7,1950,0,323000
2,1.75,1240,3000,3,7,1240,0,483000
4,3.25,3450,5000,3,8,3450,0,445000
4,3,2160,4400,5,7,1320,840,665000
4,2.5,2150,12028,4,8,2150,0,639000
3,2.25,1620,7350,3,7,1170,450,460000
3,1,1220,8119,4,7,1220,0,940000
5,2.5,2490,9639,4,8,1610,880,868500
3,2.5,3780,35273,3,10,3780,0,930000
3,1.75,1260,12750,3,7,1260,0,399900
2,1,1060,7200,4,6,1060,0,299995
4,2.75,2600,4674,3,8,1560,1040,750000
3,1.5,1070,5150,4,6,1070,0,249000
2,1.75,1180,900,3,10,780,400,664950
3,1,1210,9473,5,7,1210,0,453000
3,1.75,2130,20423,3,9,2130,0,667500
4,1.75,1560,9000,5,7,1560,0,544300
3,1.75,1490,9493,4,8,1490,0,312500
5,2.5,2400,4548,3,7,2400,0,335000
4,2.75,2640,6240,3,9,2640,0,650000
3,2.5,2990,6725,3,9,2990,0,525000
5,3.25,4590,12793,5,11,3590,1000,2.80E+06
3,1.5,1580,3172,4,8,900,680,524500
5,1,1460,11726,3,6,1290,170,180000
3,2.75,2100,10362,3,9,1510,590,525000
3,2.5,2270,7866,4,10,2270,0,716000
3,2.5,3240,60840,3,7,3240,0,654000
2,1.75,2130,6574,3,8,1500,630,450000
4,2.5,3120,5001,3,9,3120,0,380000
3,0.75,1030,12700,4,5,1030,0,229950
3,3,2420,13959,4,8,1740,680,330000
3,2.5,1870,3439,3,7,1870,0,300000
2,1.5,1090,1183,3,8,1090,0,306000
4,2.5,2420,3825,3,8,2420,0,298000
4,2.5,3040,20682,3,7,3040,0,468000
3,2.25,1650,10000,3,7,1650,0,266750
3,1,1330,15678,3,7,900,430,405000
3,2.5,1660,8125,3,7,1150,510,295000
3,1.75,1570,15570,3,7,1570,0,209950
4,2.5,3780,6800,3,8,3780,0,549950
4,1.75,2440,7350,3,8,1610,830,330000
3,2.25,2390,2750,5,8,1580,810,915000
4,2.5,2660,8469,3,10,2660,0,751305
3,1.75,2000,7480,3,8,1320,680,410000
3,2.5,2840,216493,3,9,2840,0,560000
5,3.5,4600,8764,3,10,3180,1420,880000
3,2.25,1720,4000,4,7,1450,270,620000
3,2.5,1780,1729,3,8,1080,700,660000
3,2.5,1400,4400,3,7,1400,0,399950
3,1,920,4875,4,7,920,0,152000
3,1.75,1480,4800,4,7,1140,340,585000
2,1.75,1210,1040,3,8,1210,0,357186
2,1,780,8160,4,6,780,0,254922
3,2.25,1490,9600,4,7,1170,320,287000
4,2.75,2140,9920,3,8,2140,0,354450
2,1,1050,5000,5,7,1050,0,515000
3,3.25,3530,4920,3,9,2660,870,1.55E+06
3,1,1000,12000,3,7,1000,0,217000
4,2,1480,8625,4,7,1480,0,260000
3,1.75,1880,13300,3,7,1380,500,725000
3,1,1960,7955,4,7,1260,700,375000
4,2.5,2190,4866,3,7,2190,0,418500
4,2.75,3030,117378,4,8,1680,1350,455000
2,1,810,8494,3,6,810,0,237500
2,1,880,12000,3,7,880,0,334550
3,2.5,1560,3987,3,7,1560,0,435000
3,2,1380,9000,2,7,1380,0,215500
5,2,2280,5400,4,7,1340,940,712500
4,2.25,2350,7210,4,7,2350,0,500000
3,1.5,1030,8223,4,7,1030,0,267000
3,2.5,2430,5866,3,7,2430,0,471500
2,2.5,1340,1263,3,8,1340,0,425000
4,2.75,2475,4000,3,7,2475,0,319900
1,0,690,23244,4,7,690,0,484000
3,1,1250,8800,3,7,1250,0,230000
3,1,1250,8000,3,7,1250,0,234900
4,1.75,1830,11090,3,7,1060,770,383000
4,2,2750,5527,3,8,2130,620,865000
3,1,1080,4120,3,7,980,100,818900
3,1,840,3000,3,5,840,0,135000
2,1,1340,6380,3,7,890,450,520000
3,1,1120,9656,5,7,1120,0,435000
4,2.5,2810,10433,3,8,2810,0,350000
2,1,1440,33747,3,7,1440,0,803000
2,1.5,1190,3400,3,7,990,200,441000
4,2.5,2910,8881,3,10,1940,970,1.10E+06
4,2,2190,14439,4,7,1180,1010,280000
3,1,1050,7500,3,6,1050,0,440000
3,1,1130,11250,3,7,1130,0,354000
3,1.75,2620,38350,4,8,1320,1300,525000
2,1,800,5150,4,6,800,0,350000
3,2,3570,30456,3,8,2070,1500,2.20E+06
3,2.5,3940,10360,3,9,3110,830,933399
4,2.75,3840,10004,4,9,2110,1730,1.14E+06
4,2.5,2660,65340,3,8,2660,0,523000
3,2.5,1600,2610,3,8,1600,0,384500
4,1.5,1790,3420,4,7,1020,770,560000
3,1,990,10723,5,7,990,0,284950
4,2.5,2280,9874,3,9,2280,0,560000
2,1.75,1740,5100,3,6,580,1160,205000
3,3.5,1340,1168,3,8,1080,260,370350
4,2.5,2180,7210,3,7,1190,990,330000
3,3.25,2200,7440,4,7,1710,490,525000
3,1,1010,9750,5,7,1010,0,202000
3,1.75,1260,10065,3,7,1260,0,475000
4,1,1000,7134,3,6,1000,0,165000
4,1.5,1430,8775,3,7,1030,400,215000
4,2.25,2730,7506,4,8,2730,0,435000
4,1.75,2020,8800,4,8,2020,0,245000
3,1,1410,7200,4,6,1410,0,700000
6,1.5,2140,36509,4,8,2140,0,230000
4,2.5,2303,3680,3,8,2303,0,329995
3,2.5,2180,5496,3,8,2180,0,612000
3,2.5,3180,7904,3,8,1810,1370,439000
3,1.75,1200,8034,5,7,1200,0,243000
4,2.5,3300,28433,3,9,3300,0,725000
3,2.5,2370,55321,4,8,2370,0,860000
4,1.75,1850,5712,3,7,1850,0,352000
4,2,2230,4635,5,7,1510,720,700000
2,1,1120,3220,4,7,1120,0,500000
5,3.25,2820,3275,3,8,2230,590,461500
4,2.5,2290,3777,3,7,2290,0,278000
4,2.5,2040,4443,3,8,2040,0,265000
3,2.5,1660,1545,3,9,1400,260,700000
3,1,1120,12500,4,7,1120,0,615000
2,1,1000,4179,5,5,1000,0,189900
3,1.75,1170,8239,3,7,1170,0,205000
4,2.5,2000,6921,3,8,2000,0,380000
4,3,5430,108900,4,10,5430,0,1.36E+06
4,2.75,3360,9100,4,8,1760,1600,945800
2,1,770,5160,3,6,770,0,265000
3,1.75,1950,19747,3,7,1150,800,440000
3,1,990,8100,3,6,990,0,250000
3,1.75,2150,3503,3,8,1870,280,950000
5,1,2150,262231,3,7,2150,0,550000
3,1.75,1680,4800,4,7,1400,280,550000
6,3.25,4250,23326,3,10,2150,2100,465000
4,2,1640,7200,3,7,1640,0,370000
3,2.5,2400,9601,5,7,1390,1010,505000
3,1,1180,8400,3,7,1180,0,425000
3,1.75,1460,7226,3,7,1460,0,220000
4,2.5,2460,45738,4,8,1650,810,607500
3,3.5,1600,1431,3,8,1240,360,460000
4,2.75,2760,5670,3,10,2760,0,847093
3,2.5,1660,3990,3,7,1660,0,324500
4,2.5,2470,5100,3,8,2470,0,337000
4,2.25,1880,3000,3,8,1760,120,616500
2,1.75,1440,4660,3,8,1440,0,445000
2,1,850,4650,3,7,850,0,460000
3,2,1420,11325,3,7,1420,0,510000
3,1.75,2200,14630,3,8,2200,0,1.23E+06
3,2.75,2090,9620,3,8,1340,750,310000
4,2.75,3220,4392,4,9,2320,900,880000
5,2.5,2590,7084,3,8,2590,0,779380
5,2.5,3370,4850,3,9,3370,0,540000
2,1,1300,11400,3,7,1300,0,170000
4,2.5,2950,7024,3,10,2950,0,921800
3,1.5,1860,17640,4,7,1860,0,350000
4,2.5,2190,8100,4,8,1250,940,297500
2,1,720,5000,5,6,720,0,280000
4,1,2100,9288,4,7,1050,1050,305000
4,3,2630,5772,3,9,2630,0,731688
3,2.25,2370,10289,4,9,1590,780,790000
2,1.5,1870,12960,4,6,1350,520,390000
3,1.5,2230,6000,3,8,1260,970,585000
4,2.75,2130,8560,3,7,1560,570,283000
3,2.5,3400,12442,3,9,3400,0,815000
4,2.25,1860,3766,3,8,1860,0,535000
3,1,920,6612,3,6,920,0,210000
3,1,1030,3000,3,7,830,200,385000
2,1,1280,4840,3,7,1200,80,649000
3,1.75,1770,9000,3,7,1090,680,286000
3,2.25,1920,8412,3,8,1460,460,625000
3,1,970,5922,3,7,970,0,354950
3,2,1990,3990,5,7,1130,860,760500
3,1.75,1900,10225,4,8,1220,680,350000
3,3,4380,6320,5,10,3580,800,1.45E+06
3,2.5,2350,4975,3,8,2350,0,700000
1,1,720,2500,3,7,720,0,438600
5,4,4510,15175,3,10,4510,0,1.87E+06
2,1,1570,4400,4,8,1570,0,998500
4,2,1540,5110,3,7,1540,0,262500
3,2.5,2390,47480,3,9,2390,0,460000
2,1,950,4000,3,6,950,0,320000
3,2.5,2100,17882,4,8,2100,0,505000
3,2.5,1840,6985,3,7,1290,550,380000
2,1,770,8149,4,6,770,0,310000
2,2.25,1290,1334,3,8,1290,0,489000
3,2.75,2210,4000,3,8,2210,0,660000
4,2.5,2410,55931,3,9,2410,0,449500
3,2.5,1690,3068,3,7,1690,0,482500
3,1.5,1180,8545,3,8,1180,0,816000
3,1.5,1390,8300,4,7,1390,0,317000
3,2.75,1910,15508,3,8,1210,700,300000
2,1,870,7227,3,7,870,0,312500
4,2.5,2260,5164,3,8,2260,0,419950
3,2,1270,1323,3,8,1270,0,360000
2,1,1790,15783,4,8,1360,430,560000
4,2.75,2660,9547,3,8,1930,730,1.44E+06
3,2.5,1930,6180,3,7,1330,600,375000
2,1.75,1050,6500,4,6,1050,0,295000
3,2.5,3410,41022,3,11,3410,0,725000
2,2,2640,13939,5,8,1640,1000,850000
3,2.5,2380,16080,4,9,1340,1040,986000
2,1,1120,4800,3,7,770,350,363000
3,1.75,1580,11455,4,7,1200,380,315000
4,2.5,2180,5367,3,7,2180,0,339995
3,2.25,2520,12000,3,10,2520,0,598500
3,2.25,1400,11400,3,8,1400,0,374500
4,2.75,4140,24190,3,11,4140,0,657500
3,2.25,1280,959,3,8,1280,0,355000
3,1.75,1480,800,3,8,1000,480,469000
4,2.5,1890,12236,3,7,1230,660,378000
4,3.5,3450,6873,3,10,2750,700,590000
5,1.5,1930,7480,3,7,1930,0,270000
2,1.75,1440,4225,3,8,1440,0,437000
3,1.75,1680,14630,3,8,1680,0,425000
5,2.5,2890,13104,3,8,2890,0,518000
4,2.5,2790,9910,3,8,2790,0,518000
2,2.5,1280,940,3,8,1060,220,350000
3,1,1490,15850,3,7,1490,0,225000
4,2.25,3530,5500,3,8,2860,670,1.66E+06
3,2.5,1580,1321,3,8,1080,500,705000
4,2,2790,8793,4,8,1640,1150,723000
3,1.75,1610,6205,4,7,1210,400,270000
3,1.75,2620,8280,4,7,1330,1290,615000
3,1.75,2450,2691,3,8,1750,700,937000
3,1.5,1680,17409,3,7,1680,0,500000
3,2.5,2140,7641,3,8,1290,850,339950
3,1.75,1580,14400,4,7,1580,0,225000
4,2.25,1990,8548,3,8,1990,0,435000
5,2.75,2830,6137,3,9,2830,0,820000
3,2,1310,7349,3,7,870,440,241500
5,2.5,1760,10200,3,6,1760,0,220000
2,1,940,9330,3,6,940,0,255000
3,2.25,1200,2845,3,7,1200,0,342000
4,2.5,3260,10032,3,8,1960,1300,538000
3,1,800,3060,4,6,800,0,465000
3,1.5,1320,2625,3,7,1320,0,269000
6,1.75,1820,6250,3,7,1130,690,545000
3,1,1100,5734,4,7,1100,0,178000
3,2,1690,6750,3,7,1210,480,217000
2,1,790,8424,4,6,790,0,268500
4,2.5,2425,9017,3,9,2425,0,447500
3,1,1470,32670,3,7,1020,450,238000
4,2.75,2310,7851,4,8,1790,520,592100
3,1.75,2020,8970,4,7,1180,840,475000
4,2,1760,7800,3,8,1760,0,690000
2,2,1680,6194,3,8,1680,0,575000
4,1.75,1850,7500,3,7,1850,0,181100
2,1,820,8370,4,7,820,0,324000
2,2,1440,4666,3,8,1440,0,439950
4,2.5,2434,4400,3,8,2434,0,285000
2,1,950,8100,3,6,950,0,200000
4,4,4050,9517,3,11,3360,690,1.20E+06
4,2.5,1720,5805,3,8,1720,0,295700
3,2,2100,31550,3,8,2100,0,399000
3,2,1710,7920,3,8,1260,450,237000
4,3.5,4680,12495,3,10,3040,1640,1.35E+06
3,2.75,3230,75889,3,7,3230,0,1.15E+06
4,2.25,2670,14255,4,8,1610,1060,437850
4,2.5,2770,5612,3,7,2770,0,650000
3,1.5,1400,9087,3,7,1400,0,320000
5,2.5,2850,209523,4,7,1930,920,450000
4,2.5,3140,94525,4,8,2280,860,401500
4,1.75,1760,4080,4,8,1760,0,810000
3,3.25,3190,5283,3,9,3190,0,757000
3,1,1260,7500,3,6,1260,0,120000
4,2.25,2260,11900,3,9,2260,0,605000
3,1,1600,6380,3,7,1400,200,490000
3,2.5,2120,3757,3,7,2120,0,400000
2,2.25,2080,11285,4,8,1180,900,530000
3,2.25,2510,6339,5,8,1810,700,994000
4,2.25,2200,7150,4,7,2200,0,339950
4,2.5,2730,10281,3,9,2730,0,780000
4,1.75,2250,10108,4,8,2250,0,605000
4,1.5,1550,3000,3,7,1350,200,458000
5,2.75,2910,36250,3,8,1590,1320,585083
4,2.5,2890,15067,3,9,2890,0,515000
4,2.5,2700,9320,4,8,2700,0,837500
3,2,1700,4080,4,7,850,850,652000
4,1.5,1870,7220,3,7,1870,0,325000
4,2.75,3320,10574,5,8,2220,1100,665000
3,1.5,1490,6604,4,6,1490,0,255000
4,2.5,2690,6099,3,9,2690,0,340000
3,3,2940,4622,4,9,2230,710,1.07E+06
4,2.5,2160,5298,4,9,2160,0,842500
4,2.25,2060,10070,3,7,2060,0,439000
2,1.5,1010,825,3,7,1010,0,286000
5,2.75,2580,9242,4,8,1720,860,713000
5,1.75,1550,10500,3,7,1100,450,405000
4,2.25,2130,5337,3,7,2130,0,389000
2,1,640,2500,4,6,640,0,426000
3,3,2630,4896,3,9,2630,0,738000
3,1,1030,7620,3,7,1030,0,330000
4,2,2310,31850,4,8,2310,0,640000
3,1,1150,18200,5,7,1150,0,465000
4,2.5,2170,6000,3,7,1630,540,445000
2,1,910,5000,4,6,910,0,450000
3,1.75,2110,7129,3,8,1280,830,540000
5,4.25,3350,3600,3,10,2260,1090,1.43E+06
4,1.5,1550,5053,4,7,1180,370,433000
3,1,1170,62290,3,5,1170,0,315000
3,2.25,2270,23900,3,9,1820,450,680000
3,1.5,1090,8400,4,7,1090,0,415000
3,3.5,3820,145054,3,9,2870,950,830000
4,2.5,2800,6820,4,7,2800,0,365000
3,1.75,1640,4590,5,7,1640,0,700000
3,3,2240,10479,4,7,1710,530,399000
2,1,1320,8380,3,7,1320,0,447000
3,1.75,2080,12522,5,6,2080,0,249900
2,1,770,7554,3,6,770,0,385000
3,2.5,3320,12840,3,10,2600,720,792000
3,2.25,1780,8784,3,7,1230,550,470000
2,2.5,980,1020,3,8,980,0,329000
2,1,1150,5664,3,7,870,280,515000
4,2,1850,7560,4,7,1540,310,250000
3,2.5,1530,762,3,8,1050,480,450000
3,1.75,2820,8879,5,7,1540,1280,456700
4,2.5,1980,5000,3,8,1980,0,410500
3,1.75,1420,8738,4,7,1420,0,234000
6,2.5,3596,13700,5,8,1798,1798,580000
2,1,800,1200,3,7,800,0,269500
2,2.5,2720,16637,3,10,2160,560,1.44E+06
2,1.5,750,2964,5,5,750,0,258305
4,2.5,2390,7056,3,9,2390,0,360000
3,1.75,1660,8160,4,7,1660,0,315000
5,2.5,2250,10400,3,8,1280,970,370000
4,1.75,1850,7350,3,7,1050,800,270000
4,2.5,2580,5787,3,9,2580,0,775000
3,2.5,2770,9136,3,10,2770,0,860000
3,1.75,1460,10128,3,8,1460,0,601500
4,1.5,1580,6200,3,6,790,790,159075
4,2.5,2230,64438,4,7,1230,1000,464950
3,1.5,1380,12196,4,7,1380,0,285000
1,1,690,6825,4,5,690,0,142500
4,1.5,2120,46173,3,7,2120,0,316000
3,1,860,10426,3,6,860,0,82000
3,1,1400,4914,3,7,1400,0,470000
4,2.25,2460,7620,3,7,1230,1230,325000
4,2.5,2190,6578,3,7,2190,0,435000
4,2.5,1960,8540,3,7,1220,740,355950
6,1,1730,2760,3,7,1250,480,563000
4,3.75,3490,5625,3,9,2610,880,1.31E+06
3,2.5,2790,31798,5,8,1650,1140,640000
2,1,1140,75132,3,7,1140,0,380000
4,3.25,3530,8589,3,10,3530,0,963000
3,1.75,1200,55321,5,7,1200,0,213000
4,1.75,1550,9899,4,7,1550,0,229900
4,2.5,2940,12600,4,8,1850,1090,590000
2,1,930,7742,3,6,930,0,160000
3,1.75,1930,7267,4,7,1330,600,279950
4,1.5,1360,8100,3,7,1360,0,201000
4,2.5,1900,9775,5,7,1900,0,620000
6,2,2400,7684,3,6,1200,1200,387500
3,1.75,1320,12528,4,7,1320,0,207500
4,1.75,2440,16730,3,7,1390,1050,484000
3,3.25,1540,1428,3,9,1540,0,690000
3,2.5,1530,2978,3,7,1210,320,635000
3,2.5,2075,39553,3,7,2075,0,430000
3,2.5,2430,15264,3,8,2430,0,362300
3,1.5,1260,10350,3,7,1260,0,465750
4,2.5,2460,4166,3,9,2460,0,653750
3,2,1080,5077,3,7,1080,0,379950
3,2.5,2432,9391,3,9,2432,0,427000
4,3,3180,4649,4,9,2070,1110,1.13E+06
2,2,1650,8975,5,6,1650,0,265000
4,2.5,2640,8055,3,9,2640,0,383000
3,1.75,2020,215622,4,7,2020,0,490000
4,1,1730,7350,4,6,1730,0,152500
4,2.75,2840,4227,3,9,2840,0,784950
6,3,2510,5310,4,7,1460,1050,440000
4,2.5,2350,6624,3,9,2350,0,561600
3,2.25,1520,1245,3,8,1520,0,405000
3,1,1190,7000,3,7,1190,0,517500
2,1,1080,9435,3,6,1080,0,230000
3,2,2590,3750,5,7,1790,800,885000
3,1.5,800,8850,4,6,800,0,191000
5,1.75,1750,8325,5,7,1750,0,269900
3,2,1760,6875,4,8,1760,0,400000
3,2,2730,15677,3,9,2730,0,565000
3,1.75,1510,3600,5,8,1230,280,800000
3,2.25,1646,12414,3,7,1646,0,305000
3,2,1540,8316,5,6,1540,0,202500
2,1,1260,3960,3,6,690,570,412000
4,2.5,2030,3974,3,8,2030,0,544000
3,2.25,1670,9500,3,7,1170,500,425000
2,1.5,1068,1758,3,7,1068,0,243000
3,1.75,1710,8767,4,8,1710,0,630000
3,1,3180,27586,3,8,1400,1780,340000
3,1.75,1420,13187,4,7,1420,0,293000
4,2.5,2130,11733,5,7,1330,800,395000
3,2,1160,7217,3,7,1160,0,306000
3,2.5,1530,3296,3,8,1530,0,570000
5,2.25,2690,10800,4,8,2020,670,1.30E+06
4,4.25,4070,13860,3,10,4070,0,2.30E+06
4,1.75,2080,7200,4,7,1050,1030,198000
4,3.75,4350,7965,3,10,4350,0,2.07E+06
3,2.5,1660,2415,3,7,1660,0,165000
4,2,2450,4400,3,7,1450,1000,800000
4,2.25,2500,8866,4,9,2500,0,808000
5,2.5,3190,6178,3,8,3190,0,535000
3,4,2080,2250,3,8,2080,0,780000
4,2.5,2370,10513,4,8,2370,0,688100
5,3.5,2770,9305,3,9,2770,0,804000
3,2,1300,2250,3,7,1300,0,422500
3,1.75,2030,9032,4,7,2030,0,660000
4,2.25,2430,7490,3,8,2430,0,330000
3,2.5,1850,8770,3,8,1850,0,280017
2,2,1200,3900,3,8,1200,0,408000
4,2.75,1580,3770,3,7,1080,500,315000
2,1.75,1660,6000,3,7,1160,500,484000
2,2,1300,2983,3,8,1300,0,412250
4,2.25,1990,4600,4,8,1420,570,661000
2,1.5,1260,6660,4,7,1260,0,531000
5,2,1930,9747,4,7,1020,910,400000
4,2.5,2740,8400,3,8,2740,0,315000
3,2.25,2070,15002,3,8,2070,0,560000
4,2.5,3000,5548,3,9,3000,0,675000
3,1,1510,15022,3,7,1510,0,239000
4,2.5,2340,5420,3,8,2340,0,354000
2,1,1747,12250,4,6,1747,0,267500
3,1,1140,27760,4,6,1140,0,243800
3,1,940,10500,4,7,940,0,342500
3,2.25,1510,36224,3,8,1510,0,415000
4,2,1450,8175,4,7,1450,0,205000
6,2,2220,8797,3,7,2220,0,260000
4,3,4460,6833,3,10,3140,1320,1.91E+06
4,1.5,1980,113691,3,7,1980,0,400000
3,2.5,2120,22482,5,7,1360,760,329500
4,3,1960,5160,3,7,1170,790,277000
4,2.5,1930,8336,3,8,1930,0,319000
4,2.5,2090,12833,3,7,1220,870,465000
4,3.75,4100,22798,5,11,2540,1560,2.03E+06
4,1,1300,6075,5,7,1300,0,378000
3,2,1510,3413,3,7,1510,0,230000
4,2.25,2440,9450,3,7,2440,0,700000
4,2.5,1830,5331,3,7,1830,0,353000
3,2,1510,43560,3,7,1510,0,450000
4,2.75,1920,7102,3,7,1130,790,250000
4,2.5,2632,4117,3,8,2632,0,349950
4,2.5,3140,8455,3,8,3140,0,529888
5,3,3340,10796,3,9,2120,1220,1.33E+06
4,1.5,1780,5100,3,7,1320,460,580000
3,2.5,1700,3150,3,8,1700,0,534500
3,2.5,2600,10092,3,9,2600,0,625000
3,1,1440,11250,3,7,1440,0,290000
3,2,1410,4303,4,7,1410,0,415000
4,3.5,5830,131116,3,11,5830,0,1.58E+06
3,2.5,3090,10940,3,10,3090,0,938000
4,2.5,1950,3000,3,7,1950,0,299000
3,2.5,1658,2700,3,8,1658,0,263900
3,2.5,1520,6298,3,7,1520,0,260000
3,1,1230,4380,3,6,1230,0,200000
5,3.5,3730,16679,3,10,2760,970,775000
4,2.75,3120,20031,4,9,1980,1140,1.58E+06
3,1.5,1420,9081,4,6,1420,0,202000
3,1,900,6099,3,6,790,110,225000
2,1,840,9000,5,6,840,0,220000
4,1,1590,7085,3,6,1590,0,365000
4,3.5,2840,4637,3,8,2840,0,685000
3,2.5,1950,4949,3,7,1950,0,430000
4,2.25,2180,7297,3,8,2180,0,610750
3,1.5,1250,8700,4,7,1250,0,306000
3,1,1530,8498,3,7,1530,0,147500
4,2.5,2430,3249,3,8,2430,0,427500
3,1.5,1670,3852,4,8,1670,0,1.24E+06
5,2.25,2570,13054,3,8,1470,1100,519000
3,2.25,1960,12350,4,7,1960,0,525000
4,1.75,1850,7730,5,7,1100,750,450000
3,1.5,1690,9708,5,7,1690,0,430000
3,1.75,1540,8223,4,7,1070,470,257000
1,1,520,4800,3,5,520,0,275000
3,1,1810,13068,4,7,1360,450,329500
3,3.5,3530,3610,3,10,2370,1160,1.50E+06
3,2.25,1820,9150,3,7,1320,500,438000
4,3.5,3400,5222,3,9,3400,0,515000
3,1.5,1060,9225,4,7,1060,0,212000
3,1,1160,3750,3,7,1160,0,390000
5,2.25,4320,7620,3,7,2880,1440,1.10E+06
4,2.5,3120,5137,3,7,3120,0,653000
4,1,1030,5750,3,7,1030,0,310000
3,1,910,8008,3,7,910,0,305000
4,1,1870,4992,4,7,1670,200,730000
4,3.25,2790,5420,3,9,1130,1660,970000
3,2.5,1860,3150,3,8,1860,0,495000
3,1.75,1160,257875,2,7,1160,0,361550
4,3.5,3390,3979,3,9,2610,780,1.05E+06
3,1.75,1590,41550,3,6,1290,300,295500
2,1,1050,5900,3,7,1050,0,245000
3,3,1520,1884,3,8,1520,0,399000
4,2.25,1970,7532,3,8,1390,580,475000
3,1,1200,13100,3,6,1200,0,165000
4,1.75,2200,8545,4,7,1100,1100,414950
3,2,2130,8225,4,8,2130,0,397500
3,1,1500,4100,3,7,1370,130,485000
2,1,1270,5000,3,8,1090,180,615000
4,2,2260,8457,3,9,2260,0,635000
4,2.5,2310,7555,3,9,2310,0,495000
4,4.5,5420,101930,3,11,3890,1530,1.23E+06
3,1.75,1960,15681,3,7,1960,0,247500
4,2.5,2880,7386,4,9,2880,0,440000
3,2.25,1890,9646,3,8,1890,0,325000
3,2,2330,3600,4,7,1580,750,549000
3,2.25,1470,7518,3,7,1160,310,220000
5,3,1810,3000,3,7,1810,0,362000
3,1.75,1750,7200,3,7,1750,0,445000
1,1,700,5621,4,6,700,0,403500
5,3.5,3250,4800,3,9,2410,840,705000
3,1.75,1270,8470,4,7,1270,0,237000
4,2.75,3680,5000,3,9,2480,1200,1.60E+06
4,2,1710,7490,3,7,1320,390,353750
3,2.5,1860,5025,3,8,1860,0,294900
4,3.5,2770,8049,3,9,2770,0,820000
3,2.5,1490,8102,4,7,1490,0,260000
4,1.75,1440,8536,4,7,1440,0,472500
4,2.5,3440,56192,3,9,3440,0,785000
4,2.5,1840,15496,3,8,1840,0,390000
4,3.25,3020,4000,5,8,1920,1100,1.27E+06
4,2.25,2520,2370,3,8,1690,830,480000
3,1.75,2270,7156,3,7,1370,900,292000
3,2.5,2050,4976,3,8,2050,0,535500
4,1.75,2100,4400,5,7,1720,380,445000
4,2.5,2560,12760,4,7,1760,800,790000
3,1,1070,4800,3,6,970,100,265000
3,2.5,1430,9044,3,7,1430,0,220000
3,2.25,1550,4411,3,7,1550,0,324000
4,2.5,2500,9654,3,8,1830,670,241500
4,2.25,2120,9680,4,8,2120,0,369160
3,1.75,1480,6592,4,7,1080,400,235000
2,1,830,5610,3,6,830,0,275000
3,1,1752,14626,3,8,1752,0,249000
4,2.5,2658,3960,3,9,2658,0,411605
3,1.75,1850,7056,4,8,1850,0,445000
3,2,1230,8450,3,7,1230,0,383610
3,1,1110,6250,3,7,1110,0,345000
3,1,1000,19969,3,7,1000,0,725000
5,1.75,3380,20021,4,8,1690,1690,1.35E+06
4,2.5,2230,8624,4,8,1430,800,565000
4,2.5,2090,9702,5,7,1320,770,465000
3,1,1090,3315,4,6,1090,0,143000
3,3,1730,2940,3,7,1730,0,490000
3,1.5,1270,1067,3,8,1270,0,325000
3,2.5,1690,1618,3,8,1150,540,372977
3,1.5,1480,21320,4,7,1480,0,369300
3,3.5,1690,1432,3,7,1360,330,499000
4,2.5,2310,3866,3,8,2310,0,600000
5,1.75,2330,14322,4,7,1180,1150,350000
4,3.25,4200,210394,4,10,4200,0,1.65E+06
3,1.75,1650,8254,5,7,1060,590,370000
3,1.75,1830,10954,3,7,1830,0,346950
4,3.75,2930,3200,5,9,2130,800,1.10E+06
2,1,960,4400,4,7,960,0,319000
2,2,1540,5000,3,8,1540,0,269000
3,1.5,1100,33600,3,7,1100,0,215000
4,3.25,3720,6765,3,9,3720,0,955000
3,2.25,2730,10675,3,9,2730,0,678000
5,2.5,2730,17240,5,7,1660,1070,545000
4,3.25,3444,5166,3,8,2714,730,430236
3,2.5,1670,5797,3,7,1670,0,260000
5,6.25,8020,21738,3,11,8020,0,3.30E+06
4,2.5,2370,15200,3,8,1660,710,585000
4,2.5,2540,6491,3,8,2540,0,750000
3,3,2260,2400,3,7,2260,0,512500
2,1,1220,3000,3,7,920,300,499000
3,1.75,1980,6760,4,8,1980,0,530000
2,1.5,950,676,3,7,850,100,304000
2,1,1480,5325,4,7,1120,360,215000
3,2.5,1930,1348,3,8,1300,630,439990
4,2.25,2240,12650,4,8,1730,510,415000
2,1.25,1240,2150,3,8,1240,0,545000
4,1.75,2080,8750,4,8,1330,750,300000
3,1.75,2500,36947,3,9,2500,0,662000
3,2.25,1770,7667,3,8,1270,500,370000
3,2,2080,12094,4,8,2080,0,424240
3,1.5,1080,2940,4,7,1080,0,395000
3,2.5,2660,13367,3,10,2660,0,1.90E+06
2,1.5,680,772,3,7,680,0,239000
3,1,1780,7470,3,7,1050,730,229500
4,3.25,3020,13457,5,9,3020,0,808100
3,1.75,1490,9120,5,7,1490,0,310000
4,3,3290,10783,3,9,3290,0,449950
3,2.5,1780,7859,3,7,1780,0,309000
4,2.5,2150,4000,3,7,2150,0,339950
5,2.25,2960,7680,5,8,1550,1410,1.05E+06
3,2.5,2196,7475,3,8,2196,0,333500
2,1,750,6380,3,7,750,0,319000
4,2.75,2640,8400,3,8,1440,1200,610000
4,3.5,4200,14353,3,12,3640,560,1.46E+06
3,1,1240,4080,3,7,1240,0,625000
2,1,1180,9350,3,6,1180,0,160000
4,1.75,1520,5250,3,6,1520,0,450000
4,2.5,3070,34412,4,9,2070,1000,1.92E+06
2,2.5,1140,1181,3,8,1140,0,467000
4,3.5,3710,10400,3,8,2290,1420,552500
3,1,2280,4600,3,8,1250,1030,850000
4,2.5,2360,43017,3,9,2360,0,595000
3,1,1000,6947,3,7,1000,0,390000
3,2,1260,1125,3,7,810,450,249000
3,2.5,1460,7573,3,8,1460,0,450000
4,2.5,1860,3840,3,7,1170,690,715000
4,2.5,2480,12688,4,9,1820,660,1.01E+06
3,2.25,1050,572,3,7,740,310,250000
4,2.25,2770,5320,3,9,2440,330,950000
3,1.75,1400,18002,3,6,1400,0,322000
5,3,2430,8000,4,7,1370,1060,506000
5,2.75,2000,9276,4,7,2000,0,300000
2,1,1220,2500,3,6,770,450,255000
3,1.75,1720,13104,4,7,1720,0,285000
5,2,1820,5054,4,7,910,910,393000
4,2.25,2170,7007,3,8,1540,630,562000
4,2.75,2700,49428,4,9,2700,0,357000
4,2.25,1490,956,3,7,1020,470,507000
4,2.5,2890,9045,3,8,2890,0,550000
4,2.5,1900,7000,2,7,1420,480,305000
2,1,1090,10481,2,7,780,310,405000
3,2.5,1484,1761,3,7,1484,0,365000
2,1,970,10423,3,7,970,0,345000
3,2.25,1440,7673,3,7,940,500,249000
3,1.5,1310,9471,4,8,1310,0,524000
4,2.25,1930,6508,3,8,1930,0,360000
2,1,920,5850,4,6,920,0,285000
3,2.5,1990,4040,5,8,1390,600,579000
3,2.5,1690,4533,3,7,1690,0,314950
3,2.75,1820,9490,3,7,1820,0,488500
3,1.75,1530,6743,3,7,1410,120,575000
3,2.5,2670,10496,3,9,2670,0,657500
3,1.5,1320,4400,3,6,1320,0,350000
2,1.5,1090,847,3,8,1090,0,319000
3,2,1440,9220,3,7,1440,0,250000
4,2.5,3250,6933,3,8,3250,0,535000
4,2.75,2000,9083,4,7,2000,0,323000
3,1.75,1980,13503,4,9,1320,660,810000
4,1.75,1500,8400,3,7,1200,300,289950
4,2.5,3710,7491,3,9,3710,0,846450
3,1.75,1530,14633,3,7,1100,430,500000
3,2.5,2480,8676,4,8,2480,0,555000
4,2.5,1670,5116,3,8,1670,0,550000
5,2.75,3210,8001,3,9,3210,0,924000
5,2.5,2750,6000,3,8,1750,1000,980000
2,1,760,4746,3,5,760,0,110000
3,2,2620,10107,3,7,2620,0,394250
4,1.5,1820,12327,4,7,1380,440,365000
3,1,1280,5100,3,7,1280,0,296500
3,2.5,3070,5871,4,8,2510,560,340500
4,2,2140,6360,3,7,1840,300,615750
5,1.75,2000,10246,3,7,1200,800,465000
3,1,1340,4000,4,7,1340,0,621000
2,2.75,1370,1140,3,8,1080,290,369950
4,1.75,1900,22896,3,7,1360,540,257000
4,2.25,1970,7902,3,8,1310,660,442500
4,1.75,1690,7794,3,7,1090,600,548000
3,2.5,3160,24437,3,11,2160,1000,1.15E+06
4,2.5,2130,9268,4,8,2130,0,355000
6,4.5,3390,7200,3,8,2440,950,303500
3,1,1220,4800,3,6,1220,0,385000
3,1,1240,7194,3,6,1090,150,310000
3,1.75,1070,8030,3,7,1070,0,542000
4,3.5,3440,5000,3,11,2560,880,1.31E+06
2,2,1240,9119,4,7,1240,0,727500
3,1,910,5250,4,6,910,0,244000
3,1.75,2150,4333,3,7,1200,950,430000
3,1.75,960,8106,3,7,960,0,375000
3,2.5,1650,2787,3,8,1650,0,433190
3,2.5,1260,1102,3,8,1260,0,445000
4,2.75,2050,3960,4,7,1180,870,480000
3,1.5,1090,9605,4,6,1090,0,185000
2,1,830,5100,4,7,830,0,350000
3,1.75,1540,8100,4,7,940,600,430000
2,2,920,1201,3,8,800,120,363000
4,2.5,2540,5930,3,9,2540,0,990000
3,2,1200,5029,3,6,880,320,420000
3,1,1660,7650,3,7,1350,310,250000
4,1.5,1810,7998,3,8,1210,600,495000
3,1,1040,7490,3,7,1040,0,339888
3,2,2290,11200,3,9,2290,0,572500
4,2.5,2050,5787,3,7,2050,0,256000
2,2,1510,6516,3,8,1510,0,479950
3,1.5,1300,12240,3,7,1300,0,365000
5,2.5,2140,15950,4,8,1370,770,621500
4,3.5,2840,5900,3,10,1920,920,986000
3,1.5,1530,7500,3,7,1530,0,265000
3,1,1260,7980,3,7,1260,0,380000
4,1,1140,7208,3,7,900,240,410000
4,2.5,2575,4725,3,8,2575,0,359000
3,1.75,1840,7350,3,8,1310,530,432100
4,2.5,3010,3120,3,8,3010,0,728725
3,2,1930,12443,3,7,1930,0,390000
2,1,750,6480,3,6,750,0,238000
3,1,880,9035,4,6,880,0,230000
4,3.5,4610,12500,3,11,4610,0,1.65E+06
4,3,1984,4460,3,7,1984,0,292000
4,3,2800,9127,3,9,2800,0,770000
3,2.25,1580,11580,4,8,1580,0,602000
3,2.5,1950,6871,3,8,1950,0,375000
4,2.5,2300,7314,4,8,1420,880,465000
1,0.75,930,29258,3,6,930,0,190000
2,1,880,2970,3,7,880,0,492000
3,2.5,1610,4611,3,8,1610,0,505000
4,2.5,2730,12261,3,9,2730,0,612500
4,1.75,1450,3750,4,7,950,500,471000
4,2.25,2470,7800,3,8,1470,1000,515000
4,1.5,1580,8468,4,7,1580,0,265000
5,1.75,1890,5000,3,7,1090,800,523460
2,1,820,2723,3,7,820,0,475000
3,2.5,1590,9736,3,7,1590,0,285000
3,1.5,2200,7620,4,7,1130,1070,515000
4,3.5,2490,5500,3,9,1780,710,899000
4,3.5,3110,6829,3,8,3110,0,600600
2,1,860,7250,3,6,860,0,305000
3,1.5,1320,7560,3,6,840,480,325000
2,1,1220,75794,4,7,1220,0,300000
4,3.5,4460,16953,3,9,2550,1910,1.80E+06
4,3.5,3840,85728,3,11,3840,0,840000
3,2.5,2210,7557,3,9,2210,0,330000
3,2.5,4930,77536,3,9,3930,1000,600000
3,1.5,2040,3960,5,8,2040,0,857500
3,2.5,2680,5860,3,8,2680,0,549950
3,1.5,1050,57499,3,7,1050,0,378000
5,4,5190,14600,3,11,5190,0,2.90E+06
4,2.5,2260,3713,3,9,2260,0,560000
4,2.5,3274,4950,3,9,3274,0,478830
3,2.5,2670,12806,3,9,2670,0,430000
3,1,1590,7759,4,7,1590,0,323000
3,2,1590,87120,3,8,1590,0,399950
3,0.75,850,8573,3,6,600,250,132500
4,1.75,1540,7200,3,7,1260,280,221000
4,2.5,2360,9647,3,8,1530,830,260000
4,1.5,1820,17918,4,8,1190,630,429900
4,3.5,3510,6005,3,8,2750,760,540000
4,2,1700,6375,4,7,850,850,420000
3,1,1470,7680,3,7,1220,250,248000
1,0.75,1040,6034,3,7,580,460,272000
5,4.25,4110,42755,3,10,2970,1140,734000
3,1,1240,239144,3,6,1240,0,234000
3,1.75,1760,10780,3,8,1760,0,554000
11,3,3000,4960,3,7,2400,600,520000
2,2,1130,1148,3,9,800,330,411000
3,1,1480,6550,4,6,1480,0,398000
4,2.5,3090,7112,3,9,3090,0,775000
7,3,2940,8624,3,8,1690,1250,420000
4,2.5,2420,7200,3,9,2420,0,771000
3,1.75,1050,5850,3,7,1050,0,260000
4,3.5,4410,36200,3,11,4410,0,1.32E+06
3,1,1150,3000,5,6,1150,0,430000
3,2.5,1690,4500,4,8,1690,0,719000
4,1.5,1570,6717,5,6,1570,0,229950
4,1.75,2250,16000,3,8,1450,800,280000
5,2.5,2720,8120,3,7,1360,1360,429000
3,1.75,1970,10270,4,8,1970,0,268000
3,2.5,1970,12205,4,8,1970,0,402000
3,1.75,1340,12800,3,7,880,460,315000
3,2.5,1270,1180,3,8,1270,0,445700
4,2.5,3140,12591,3,9,3140,0,464000
3,2.5,1800,9000,3,7,1800,0,258500
4,2.5,2210,213008,4,7,1210,1000,415000
3,1,1010,8800,4,7,1010,0,308000
3,1.75,3670,11884,4,9,1950,1720,920000
4,2.5,2020,32710,3,7,1070,950,340000
4,2.5,2830,10954,3,8,2830,0,569000
4,1.5,1450,5530,4,6,1450,0,175409
3,1.5,1390,10530,3,7,1390,0,450000
3,1.75,1660,10000,3,7,1660,0,331292
2,2.25,1170,1011,3,7,1170,0,336750
4,1.75,2330,8364,4,8,2330,0,390000
4,2.5,2020,9600,4,7,2020,0,689000
4,2.75,2500,5100,4,7,1420,1080,319500
3,3.5,3190,10223,3,10,2560,630,795000
3,1.75,1150,10466,5,7,1150,0,464500
2,2,1380,5840,3,7,1380,0,335000
4,3,3590,8249,3,9,3590,0,515000
3,0.75,1040,42180,2,6,1040,0,170000
6,3,2470,9328,3,8,2470,0,630000
4,2.5,3720,30649,3,10,3720,0,899000
2,1,810,8424,4,6,810,0,170000
4,2.75,3140,7928,3,9,3140,0,869950
3,1,950,13475,3,7,950,0,305000
3,3,2440,2076,3,8,1930,510,459000
4,2.5,2510,4349,3,8,2510,0,490000
3,3.5,3200,10344,3,10,3200,0,699000
5,2.5,2560,46786,3,8,2560,0,655000
3,1.5,2090,11895,3,7,1790,300,461550
4,2.5,3270,9578,3,9,3270,0,785000
3,3.25,2730,9588,3,10,1900,830,981000
3,1,950,3621,4,6,950,0,390000
3,2.25,1820,6000,4,7,1120,700,455850
4,2.25,2550,12918,3,9,2550,0,703770
5,3.25,5180,19606,3,11,2610,2570,1.20E+06
4,2.5,2630,5701,3,7,2630,0,385000
2,1,1120,7440,4,7,1120,0,335900
4,2.5,2100,7920,4,6,1400,700,429000
2,1,1260,5100,4,7,1120,140,528000
3,2.5,1714,3240,3,8,1714,0,305000
4,2.5,3070,5936,3,9,3070,0,731000
3,1.5,1670,8230,5,7,1670,0,227950
2,1,960,2700,3,6,780,180,345000
3,1.75,2770,39927,4,8,1580,1190,492000
3,2.5,1880,7000,3,8,1880,0,315000
4,2.5,2760,5750,3,8,2760,0,799500
4,3,3100,15480,3,8,2400,700,563000
3,1,990,9950,5,7,990,0,269950
4,2.5,2100,19680,3,6,2100,0,207000
3,1.75,1300,1237,3,7,1060,240,308000
4,3,2010,7426,5,7,1090,920,310000
3,1.5,1200,8560,4,7,1200,0,370900
3,2.25,2120,13090,3,8,2120,0,340000
4,2.5,3000,10392,3,9,3000,0,740000
3,1,1600,7500,3,7,1600,0,325000
3,3.25,4030,12765,4,9,2800,1230,890000
3,1.5,1770,30689,3,9,1770,0,729000
4,1.75,1440,13296,4,8,1440,0,1.04E+06
3,3.25,2650,7819,4,8,1760,890,410000
4,2.5,1840,4593,3,7,1840,0,429000
4,2.5,2310,6320,3,8,2310,0,330000
4,2.5,2880,9003,3,10,2880,0,1.26E+06
4,2.75,3090,6200,3,9,3090,0,908950
3,1.5,1600,9072,4,7,1600,0,267500
4,2,1880,7500,5,6,980,900,212000
3,1,1340,11070,4,7,1340,0,206135
3,2.5,1970,6291,4,7,1970,0,306500
4,1.75,2420,37800,4,8,1880,540,602000
2,1,860,8308,4,7,860,0,330000
3,2.25,1770,7667,3,8,1270,500,520000
4,2.5,1630,5361,3,7,1630,0,327000
4,2.25,1400,7341,3,7,1300,100,294450
4,3.5,5844,10766,3,11,5844,0,1.28E+06
4,2.25,2360,7650,3,8,1640,720,499900
3,1.5,1320,13200,3,7,1320,0,327000
4,1.75,1650,7088,3,8,1650,0,559500
4,3.75,3770,4000,5,9,2890,880,1.50E+06
3,2.5,2880,10126,4,10,2880,0,720000
3,2,1240,10800,3,7,1240,0,297950
4,3.5,4360,24603,3,12,4360,0,1.45E+06
3,4,5120,4600,3,11,4490,630,1.55E+06
2,1,1380,5484,3,8,1030,350,543115
4,1.75,2120,15920,4,7,1060,1060,425000
4,2,2220,5821,4,7,1380,840,610000
3,3,2060,3200,3,8,2060,0,800000
2,1,830,5720,4,6,830,0,225000
4,2.5,3220,20251,3,10,3220,0,2.38E+06
4,3.5,3273,5115,3,8,2671,602,485000
3,2.5,2235,43560,5,7,990,1245,337000
2,1.75,1910,3376,3,8,1910,0,230000
4,3.25,3530,20012,3,11,3530,0,995000
3,2.75,2580,5200,3,8,2580,0,437000
3,2.5,1700,4000,3,7,1700,0,384000
4,2.5,1850,8310,3,7,1200,650,383000
3,3,1370,1001,3,8,1370,0,327000
3,2.5,3316,11447,3,9,3316,0,490600
3,2.5,1920,7229,3,8,1920,0,295000
4,3.75,3300,4545,3,10,2600,700,1.74E+06
3,1.5,1560,8314,3,7,1560,0,273500
2,1,1250,4320,4,7,850,400,575000
4,4.75,3700,11000,4,7,1840,1860,599000
3,3.25,1550,1444,3,8,1550,0,430000
3,2.5,1570,9292,3,7,1110,460,284200
4,3,3810,217800,3,9,3810,0,900000
3,2.75,1890,3930,3,8,1890,0,375000
4,1,1380,7110,3,6,1380,0,253750
3,2,2470,8800,3,9,2470,0,850000
4,2,2400,12753,4,7,2400,0,585000
3,2.5,2750,226512,3,9,2750,0,819000
4,2.5,2320,5375,3,7,2320,0,451000
3,2,1660,7509,3,7,1660,0,343500
2,1,1080,3899,4,8,1080,0,195000
3,1,1460,10200,4,7,1460,0,220000
2,1,980,4108,3,7,980,0,415000
4,2.25,2220,4200,5,8,1310,910,862000
2,1,1000,31838,3,7,1000,0,286300
3,2,1560,32137,5,7,910,650,250000
6,2.25,2820,15600,5,7,1970,850,543200
3,2.5,2680,9750,4,8,1610,1070,653000
3,2.5,2390,15669,3,9,2390,0,660000
4,2.5,2040,7260,4,7,2040,0,475000
4,3.25,3450,6184,3,9,3450,0,852880
4,2.5,2840,6268,3,9,2840,0,580000
3,1,1350,7560,4,7,950,400,240000
3,1,1250,7820,3,7,1250,0,225000
4,4,1550,6596,5,7,1550,0,707500
3,2.5,2790,21043,3,9,2790,0,750000
4,2.5,1520,3370,3,8,1520,0,517500
4,2.75,2170,5988,3,8,2170,0,551000
4,3.5,2780,3100,3,8,2120,660,870000
2,1,770,9497,3,6,770,0,257000
3,1.5,1240,12400,3,7,1240,0,415500
4,2.25,2100,8050,3,8,2100,0,283500
4,2.75,2440,69415,4,8,1910,530,785000
3,2.5,2490,4343,3,9,2490,0,705380
1,2.25,2140,10350,3,7,1470,670,458000
4,2.5,3650,7090,3,10,3650,0,861111
4,2.5,3310,6500,3,8,3310,0,555000
4,1.5,1560,6534,4,7,1560,0,430000
4,2.5,1910,8947,4,8,1160,750,515000
5,2.75,3010,4919,3,9,3010,0,831548
3,1,1220,8573,4,7,1220,0,672000
4,2.25,1780,8820,4,8,1480,300,310000
3,2.75,2080,16740,3,8,1580,500,600000
3,2,1400,218252,3,7,1400,0,330000
3,2.5,1430,9240,3,7,1430,0,429000
5,2.75,2550,5040,5,8,2550,0,650000
4,2,1757,19370,5,7,1757,0,375000
3,2.5,1370,4400,3,8,1370,0,394000
6,3.25,3560,21400,4,9,3560,0,1.07E+06
4,2.5,2870,6658,3,8,2870,0,564000
2,2,1450,989,3,9,1450,0,680000
3,2.5,2330,9160,3,9,2330,0,710000
3,2,1800,5000,5,7,1600,200,575000
3,1.75,1680,2552,4,7,840,840,480000
2,1,1010,7338,4,7,1010,0,315000
4,3,2450,10117,5,8,1580,870,610000
3,1,1400,9460,3,7,1060,340,265000
4,2.75,2890,5000,3,8,1990,900,898500
3,2.5,1460,1319,3,8,1460,0,400000
5,3.5,3500,10155,3,10,2570,930,905000
4,3.25,2830,4000,3,9,1910,920,1.03E+06
4,1.75,2800,5400,3,9,1400,1400,863000
3,2.5,2420,198198,3,9,2420,0,692500
3,1,920,4875,5,6,920,0,179950
4,2.5,2910,20946,4,8,2350,560,705000
3,1.75,1820,8813,3,7,1820,0,299500
3,2.5,1300,1362,3,8,880,420,375000
3,1,1040,7405,4,6,1040,0,204000
5,2.75,2730,5820,3,8,2730,0,565997
4,2.5,3010,7953,3,9,3010,0,600000
3,1.75,1560,9514,4,7,1560,0,285000
3,3,1420,991,3,8,1040,380,615000
5,3.75,3580,14275,3,10,3190,390,765000
3,2,1550,4000,3,7,940,610,545000
3,2,1320,7200,5,7,1320,0,251750
4,2.5,2960,20240,4,10,2960,0,1.25E+06
4,2.75,2080,9600,3,8,1240,840,436000
3,1.5,1350,81549,2,7,1350,0,170000
3,2.5,1320,2614,3,7,1320,0,300000
3,1,1300,9000,3,7,1300,0,305240
5,2.5,2670,16777,4,7,1620,1050,585000
2,1,1280,5400,3,7,1280,0,500000
5,1.75,2440,15143,4,8,1740,700,765000
2,1,1200,6014,4,6,600,600,395000
4,2.5,2590,6474,3,8,2590,0,569888
3,1,860,5060,3,7,860,0,320000
4,5.25,6110,10369,3,11,6110,0,1.32E+06
4,2.5,1800,4338,3,8,1800,0,515000
3,2.25,2010,11817,4,8,2010,0,530000
3,3.25,1680,1478,3,8,1360,320,399000
4,2.5,2630,5379,3,8,2630,0,454200
3,2.5,1960,4400,3,7,1960,0,410000
6,6.5,6260,10955,3,11,4840,1420,1.18E+06
4,1.5,1440,8680,3,7,1440,0,352000
4,1.75,1880,9600,5,7,1020,860,240000
4,2.75,1920,4627,3,8,1010,910,353000
3,1.5,1480,7000,3,7,1000,480,160000
3,1.75,2840,9800,4,7,1420,1420,270000
3,2.25,3400,12825,3,9,3400,0,951000
3,2,2070,10023,3,8,1220,850,490000
4,2.75,2200,16288,3,7,1290,910,475000
3,1,1110,6000,3,7,1110,0,550000
3,2.5,2030,7770,3,8,2030,0,430000
4,1.75,1580,6396,4,6,790,790,359000
3,2.5,2040,13590,3,8,2040,0,350000
3,2.25,3190,324086,3,9,3190,0,765000
3,1.75,2130,4400,3,7,1430,700,675000
2,1,820,10450,4,7,820,0,173000
3,1,920,7500,4,7,920,0,203000
4,2.5,2370,6557,3,9,2370,0,369000
4,1.75,2230,6838,3,7,1320,910,560000
3,2.25,2360,14950,4,9,2360,0,431000
2,1,1350,368517,3,6,1350,0,355000
3,1.75,1670,8511,3,7,1340,330,260000
5,2,2540,11750,3,7,1480,1060,385000
3,2,2240,5200,3,7,1630,610,375000
3,2.25,1580,7034,4,7,1180,400,284000
4,3.5,3790,6874,3,9,3790,0,875000
5,2,1720,9972,4,8,1720,0,845000
3,2.5,2360,4080,3,7,2360,0,550000
3,1.5,2380,14500,4,7,1850,530,370000
2,1,730,7528,3,7,730,0,378500
3,1,1540,9450,4,7,1540,0,227500
2,2.5,2540,7089,3,9,2540,0,945000
2,1.5,1280,1256,3,8,1200,80,422250
4,2.5,2240,5105,4,8,2240,0,325000
3,2.5,1580,2407,3,8,1580,0,375000
3,2.5,2070,4132,3,8,2070,0,535000
3,2.75,2740,5735,3,9,2740,0,675000
3,2,1350,11805,3,7,1350,0,325000
3,1.75,1660,9673,3,7,1130,530,375000
4,1.75,1650,7276,3,7,1010,640,470000
3,2,1540,10931,3,7,1540,0,324000
3,1,1910,8190,4,7,1010,900,490000
3,1,1200,9936,4,6,1200,0,225000
4,2.5,2730,4385,3,8,2730,0,712000
3,2.5,3430,10177,3,10,3430,0,2.21E+06
2,1,910,4600,3,5,910,0,265000
4,2.75,2780,6978,3,8,2780,0,710000
3,1.75,1340,8250,3,7,1100,240,230000
2,1,2280,37500,3,7,2280,0,280000
2,1,1010,3000,4,7,1010,0,280000
4,2.5,2890,7798,3,9,2890,0,795000
2,1,970,4284,3,7,970,0,495000
3,1.75,1940,7313,4,8,1440,500,685000
4,1.75,2040,5000,4,9,2040,0,1.27E+06
3,2.25,2110,7665,4,7,1360,750,305000
3,1,1100,10125,3,7,1100,0,168500
3,2.75,2260,4000,4,8,1540,720,705000
3,2.5,1620,79993,4,6,1620,0,299000
3,2,1640,8395,4,7,1640,0,269500
2,1,720,212137,3,5,720,0,150000
3,2.5,2090,8653,3,8,2090,0,455000
3,2.25,1322,1796,3,8,1087,235,350000
3,1.75,1370,3850,5,7,770,600,850000
3,1.75,1940,167125,4,7,1480,460,635000
4,2.75,2360,15100,3,8,2360,0,535000
3,2.75,2600,10874,3,9,2600,0,425000
4,1.5,1100,3300,1,7,1100,0,441000
2,3.25,1570,2031,3,8,1310,260,349950
4,2.5,2400,7092,3,7,2400,0,442500
2,2,890,5000,3,6,890,0,207950
4,1,1660,4704,3,7,1260,400,548800
3,2.25,2100,43560,4,8,1330,770,483000
4,2,2340,10507,4,6,2340,0,220000
3,2.5,2710,13120,3,10,2710,0,1.25E+06
4,2.5,2120,4558,3,7,2120,0,329950
4,2.5,3270,24750,4,8,1690,1580,560000
3,1,1580,5000,3,7,1580,0,749000
4,3,3720,15048,3,7,3720,0,500000
3,1.75,1640,18730,4,7,1640,0,775000
4,2.75,3270,12880,3,9,3270,0,939000
4,2.5,2800,4000,3,9,2800,0,1.47E+06
4,2.5,2480,15411,3,8,2480,0,665000
3,2.25,1500,9656,3,7,1170,330,329500
3,2.25,1210,1250,3,8,1210,0,520000
4,3,3330,4000,3,8,1790,1540,850000
4,2.5,2880,8833,3,7,2880,0,536000
5,3.5,3420,8000,3,10,3420,0,1.44E+06
2,1,740,6380,3,6,740,0,407000
4,2,1820,8400,5,7,1300,520,378950
3,2.75,3200,6699,3,9,3200,0,712000
3,1,1260,5000,4,6,1260,0,300000
4,4.25,4645,7757,3,10,3855,790,1.60E+06
4,2.75,3250,10000,3,9,3250,0,689000
2,1,710,9000,5,6,710,0,153000
9,4.5,3650,5000,3,8,2530,1120,1.28E+06
4,2.5,2750,4800,3,9,1960,790,1.03E+06
2,1.5,1320,73600,3,7,1320,0,350000
3,1.5,1400,6865,4,7,1400,0,252000
2,1,720,5040,3,6,720,0,205000
4,2.25,2420,9000,5,9,2000,420,945000
4,2.5,2790,5602,3,8,2790,0,505000
3,1,1320,7000,4,7,1320,0,206000
4,1.75,1950,13440,4,6,1950,0,335000
3,2,1480,6698,4,7,1080,400,300000
5,2.5,3004,5700,3,9,3004,0,398000
3,1,1340,4120,4,7,1040,300,409500
5,1.75,1240,8936,3,7,1240,0,333000
3,2,2330,4950,3,6,1430,900,325000
3,1.75,3020,360241,3,8,3020,0,617000
4,1.75,2720,7810,3,8,1510,1210,599950
3,1.5,1400,8840,4,6,1400,0,357250
3,2.5,3440,18167,3,11,3440,0,610000
3,1.75,1370,10780,3,7,1370,0,170000
5,2.5,2360,10081,4,7,1180,1180,525000
3,1.75,2320,7875,3,8,1620,700,364808
5,2,3920,5250,5,7,2560,1360,760000
3,2.25,1570,9500,4,7,1070,500,478000
4,3,3690,9892,3,10,3690,0,865000
3,1.75,1200,24805,3,6,1200,0,250000
1,1,460,4120,3,4,460,0,247000
4,2,1720,6099,4,7,860,860,525000
3,1,2460,4000,4,7,1370,1090,563225
5,3.75,3630,6000,3,9,2470,1160,1.18E+06
4,3.5,3020,12750,3,10,3020,0,845800
3,3.25,1860,2218,3,8,1860,0,387500
4,1.75,1720,7455,4,7,1020,700,246000
3,1.75,1680,10500,4,8,1680,0,675000
3,1,1040,8925,4,6,1040,0,200000
3,3.5,2670,3000,3,9,1870,800,825000
4,2.5,1850,5880,3,8,1850,0,277000
4,2.5,2510,5258,3,7,2510,0,410000
3,0.75,1240,4000,4,7,1240,0,699999
4,2.75,3150,38865,3,10,2480,670,854000
3,3,2110,7794,3,6,2110,0,243500
3,1.75,1470,4000,3,7,1070,400,415000
3,2,1870,7080,4,7,1210,660,432000
3,2.5,1350,2053,3,8,1350,0,477000
4,1,1280,8316,3,6,1280,0,239000
3,2.25,1520,1221,3,8,1520,0,565000
4,2.75,2140,8100,4,7,2140,0,304400
3,2.25,1650,2958,3,7,1650,0,233500
2,1,1390,5544,3,7,930,460,510000
2,2.5,809,940,3,7,809,0,219000
4,1,1260,7645,3,6,1260,0,425000
5,2.5,3160,8000,4,7,1580,1580,820000
5,3,2380,5000,5,7,2380,0,705000
5,3.25,3400,4499,3,8,2740,660,510000
4,3.75,4040,14212,3,11,4040,0,1.12E+06
3,2.5,2590,21494,4,8,2590,0,815000
3,1.5,1730,7800,3,7,1330,400,394999
5,3.25,4050,35600,3,12,4050,0,1.01E+06
3,2.5,1800,7318,3,8,1800,0,495000
2,2.5,1630,1368,3,7,1280,350,295000
5,3.25,4240,226097,3,8,3410,830,442500
3,2.5,2480,5082,3,7,2480,0,470000
3,2.25,1840,3500,5,8,1540,300,785200
4,2.5,2990,8640,5,8,2100,890,1.11E+06
2,2,1750,2731,3,8,1750,0,394000
3,2,2050,3933,3,8,1180,870,724800
3,1.75,1950,10080,4,7,1950,0,485000
3,2.5,1820,8722,3,7,1820,0,287000
4,1,1330,7980,3,6,1330,0,249950
3,2.5,2220,6049,4,8,2220,0,325000
3,1,1340,7191,3,7,1340,0,399000
2,1,1250,5650,4,7,1250,0,463000
4,2,2350,9329,3,8,2350,0,659000
3,1.75,1530,4000,3,8,1530,0,725000
5,5.5,7400,18898,3,13,6290,1110,2.98E+06
2,1,850,6213,3,6,750,100,370000
4,2,1420,9301,4,7,1420,0,400000
3,2,1700,4250,3,6,890,810,410000
4,1.75,1910,8775,3,7,1210,700,475000
2,1.75,1220,2268,4,6,610,610,257000
3,1.75,1950,17400,3,7,1210,740,484000
3,3.25,1340,1151,3,7,1340,0,349000
4,2.5,1870,16200,5,8,1250,620,664000
3,2,2060,4080,5,7,1060,1000,607000
4,2.25,2340,217014,4,8,2340,0,404950
3,2,1810,11456,3,7,1810,0,290000
5,3,2640,5096,3,10,2640,0,910000
3,1.75,1890,10292,4,8,1890,0,800000
4,1,1390,9023,3,7,1390,0,342000
5,3.5,2100,5107,3,7,1410,690,295000
4,2,1540,5920,5,7,1540,0,442500
3,3.25,3710,38509,3,10,3710,0,935000
3,1,970,6828,3,6,970,0,315000
3,2.5,2500,51836,3,9,1510,990,650000
3,2.75,2390,9966,5,8,1360,1030,565000
2,2.5,1380,1329,3,8,1050,330,457000
4,1.5,1370,9957,3,7,900,470,370000
3,3.25,1876,1531,3,9,1876,0,613500
4,2.25,2350,8140,4,8,1430,920,555000
3,1.75,2200,7706,3,7,2200,0,485000
6,4.5,3500,8504,3,7,3500,0,592500
3,1.5,1860,8505,4,7,1860,0,217000
3,1,960,8556,3,7,960,0,319000
3,2.25,2880,9750,3,10,2880,0,820000
3,2.25,1740,11040,3,8,1740,0,400000
3,1.75,1340,2805,3,7,1340,0,475000
3,2,1500,8086,3,7,1060,440,425000
3,2.5,2100,7587,3,9,2100,0,317000
3,1.75,1370,10866,4,6,1370,0,225000
2,3,2560,982278,3,8,2560,0,790000
3,2.5,1480,4729,3,7,1480,0,516500
3,2.5,2830,9972,3,9,2830,0,539000
4,3.25,2800,5291,3,7,2800,0,325000
3,2.25,2120,15003,3,7,2120,0,345000
3,2.75,2130,1400,3,9,1080,1050,525000
1,1.5,1048,4800,3,7,1048,0,199950
2,1.5,1160,1118,3,8,1020,140,487000
3,1,1000,16376,3,7,1000,0,228000
3,2.5,2620,11056,3,9,2620,0,557500
4,2.75,3650,6982,4,9,2530,1120,1.21E+06
4,2.75,2350,5589,3,7,2350,0,426950
3,2.5,1800,2731,3,8,1800,0,408474
3,2,2220,5000,4,7,1110,1110,576750
3,2,1810,4064,3,7,1810,0,550000
5,1,1500,3978,3,7,1500,0,549000
3,2.5,1608,4000,3,8,1608,0,274950
3,1.5,1750,12632,4,7,1750,0,475000
4,2,2530,15520,5,8,2220,310,813500
4,2,1300,7200,3,7,1300,0,428000
3,1.75,1400,9546,4,7,1400,0,217500
4,2.25,2400,17842,4,7,2400,0,275000
4,3.5,3260,110579,3,10,3260,0,715000
4,2.5,1820,3134,3,7,1820,0,349950
2,1,720,6050,2,5,720,0,338500
4,2.75,3650,48351,4,8,3650,0,697000
5,1,1690,3240,3,7,1690,0,544500
4,3.25,4350,112750,3,9,2200,2150,850000
4,2.5,2240,4447,3,7,2240,0,410000
3,2,1310,7000,4,7,1310,0,196500
4,2.25,2240,11034,3,8,2240,0,980000
3,1,840,9480,3,6,840,0,86500
4,2.5,2750,9949,3,10,2750,0,1.05E+06
4,2.25,2580,2875,3,9,2580,0,673000
2,1,680,4800,3,6,680,0,365000
4,2.5,2880,3091,3,9,1940,940,635000
4,2.5,2650,11520,3,8,2110,540,720000
3,3.25,1560,1345,3,8,1260,300,448000
2,1,770,8636,2,6,770,0,197000
5,2,2360,19899,4,7,2360,0,355500
4,2.5,1990,2175,3,8,1680,310,595000
4,2,2280,6010,3,7,1140,1140,628000
4,3.5,3200,6420,3,9,3200,0,490000
4,2.5,2390,9600,3,7,2390,0,314500
3,1,1320,9520,3,7,990,330,294000
3,1,1320,9239,4,7,1320,0,206000
2,1,880,3000,5,7,880,0,405000
4,2.5,3280,7100,3,10,2180,1100,2.30E+06
4,2.75,3100,3773,3,8,2000,1100,742500
4,2.25,2230,6791,3,8,2230,0,340000
2,2.75,1760,4139,3,8,1760,0,420000
4,2.5,4280,12796,3,11,3400,880,1.20E+06
3,1,1090,11292,4,7,1090,0,406000
4,1,1450,8800,4,7,1450,0,435000
3,1.5,1500,5111,5,8,1500,0,765000
3,1.75,1400,8364,4,7,1400,0,274000
3,1,1230,7020,3,7,1090,140,410000
3,2.5,1495,936,3,8,1405,90,400000
2,0.75,1392,43710,4,7,1392,0,350000
3,1.5,1340,6000,4,7,1340,0,550000
2,2.75,2090,23962,4,8,2090,0,649000
2,1,1070,189486,3,6,1070,0,299000
3,2.5,1610,8064,4,7,1160,450,680000
4,1.75,2250,8580,4,7,1330,920,468000
3,2.5,2080,7877,3,9,2080,0,400000
2,2,1340,4447,3,8,1340,0,381000
3,2.75,2160,4086,3,7,1380,780,528000
3,2.25,1430,1383,3,8,1430,0,397500
4,2.75,3030,21780,3,8,3030,0,608250
5,1.5,1510,9078,4,7,1510,0,248000
2,1.75,2860,59612,3,8,1510,1350,503000
3,2.75,1990,9600,3,8,1530,460,575000
4,2.75,2210,13235,3,8,1730,480,200000
3,2.5,2120,2374,3,8,1770,350,470000
4,2.5,2960,10760,3,9,2960,0,695000
4,2.5,1960,11798,3,8,1960,0,298000
3,1.5,1180,12324,3,7,800,380,372500
3,2.25,1570,8410,3,7,1180,390,252000
3,1.5,1660,8000,4,7,1120,540,241000
5,2.5,2960,8968,4,8,1640,1320,654000
4,3.5,4120,7304,3,11,3070,1050,968933
3,2,1670,6824,3,7,1300,370,223000
4,2.75,2190,9209,4,8,2190,0,335000
4,2.5,2100,10750,4,8,2100,0,352500
2,1.5,2700,7225,3,8,1660,1040,1.26E+06
3,1.75,1850,10920,3,6,1850,0,257000
3,1.75,1720,9775,3,8,1720,0,279950
3,2.5,1560,4200,3,7,1560,0,295000
4,2.5,3020,7035,3,9,3020,0,715000
3,1.75,1930,10183,4,8,1480,450,583000
8,2.5,2280,3000,3,7,1210,1070,700000
3,2,1250,8636,5,7,1250,0,320000
3,1,1590,5400,3,8,1280,310,579000
3,1.5,1670,5060,5,7,1670,0,715000
2,1,1150,30184,3,6,1150,0,129000
3,2.5,2740,18455,4,10,1510,1230,699000
4,2.75,3790,10669,3,10,3790,0,875000
3,2,2250,7757,3,8,2250,0,342000
3,2.5,1680,8512,3,7,1680,0,272000
3,2.5,1440,4473,3,7,1440,0,465000
3,1,1050,9876,3,7,1050,0,310000
4,2.5,2100,6783,3,8,2100,0,303000
3,2.25,1670,7416,4,7,1220,450,580000
3,1.75,1860,48076,4,8,1860,0,407185
4,2,1750,5202,4,6,1070,680,330000
3,2,1160,3441,4,6,580,580,394000
3,2.25,1990,10260,4,8,1990,0,675000
3,2.5,2320,6775,3,8,2320,0,728050
3,3.25,1380,1120,3,8,1380,0,482000
2,1,1070,6100,3,6,1070,0,406650
3,2.5,2920,34527,4,9,1800,1120,1.02E+06
4,2,1670,5200,4,7,1030,640,229999
2,1.5,1070,937,3,8,1070,0,350000
3,2.25,2060,9953,5,8,1070,990,648752
3,1.75,1770,8050,4,7,1020,750,538000
4,1.5,2500,9448,4,7,1250,1250,330000
3,2.25,2260,54014,3,7,1450,810,514000
3,2.25,2960,8330,4,10,2260,700,1.33E+06
4,3.5,2720,6781,3,8,2100,620,365000
3,1.75,1850,2797,3,8,1150,700,580000
4,3.5,2970,6587,3,8,2260,710,549995
4,3.5,2830,4000,3,7,1840,990,1.12E+06
3,1,1130,7200,4,6,1130,0,316000
7,4.5,4140,9066,3,7,2070,2070,565000
4,2.5,2490,11650,3,7,1390,1100,270000
3,2.5,1880,5000,3,7,1880,0,261950
3,2,1260,5460,3,7,1260,0,505000
3,1,960,7500,3,6,960,0,200000
3,2.25,1990,4331,3,7,1990,0,359000
4,2.5,2780,4688,3,9,2780,0,690000
3,1,1370,17859,4,7,1150,220,275000
3,2,2560,216777,3,8,2560,0,560000
4,2.25,1990,5948,3,8,1990,0,536000
4,2.5,2420,18470,3,8,920,1500,675000
3,2.25,1630,12295,4,7,1630,0,339950
2,1.5,1190,1265,3,7,1190,0,280000
4,2.5,2130,9100,3,8,1290,840,220000
3,1,1010,8581,4,6,1010,0,180000
3,2,1700,8160,3,7,1120,580,334500
3,2.25,1830,8276,3,8,1350,480,583000
4,3.5,2790,10125,5,8,2790,0,1.30E+06
4,2.5,2660,12672,4,8,1740,920,310000
3,1.5,1580,14040,3,7,1050,530,264500
3,2.5,1490,2478,3,8,1490,0,348000
3,1,970,8710,4,6,970,0,170000
5,3,3070,8474,3,9,3070,0,825000
2,1.5,1590,4500,4,7,920,670,490000
4,1.75,1970,12409,4,7,1220,750,396000
4,2.5,2090,7290,5,8,1420,670,600000
4,2.25,2880,8882,4,8,2480,400,725000
4,1.75,3420,7200,5,8,1770,1650,715000
3,2,1610,13309,4,7,1610,0,246700
3,2,1510,10215,4,7,1510,0,270000
2,1,833,143947,3,5,833,0,517534
4,2,1840,5419,4,7,920,920,639000
3,2.5,2030,6326,3,7,2030,0,275000
3,2.25,1670,5004,3,8,1670,0,484950
4,2.5,2470,4945,3,8,2470,0,669000
2,1.5,980,5000,3,7,980,0,134000
4,2.75,3350,5416,3,9,3350,0,790500
3,2.5,1970,23180,3,8,1100,870,1.18E+06
3,1.5,1510,16800,5,8,1510,0,415000
3,1.5,1470,6867,3,8,1470,0,401000
2,1,980,5393,3,6,980,0,128000
4,2.75,2690,5400,3,7,2210,480,721000
2,1,900,7500,3,5,900,0,144975
4,2.75,2840,8800,3,9,2840,0,718500
2,2.5,1560,5333,3,5,780,780,225000
6,1.75,2230,10080,3,7,1390,840,360000
3,2.5,1260,900,3,7,940,320,380000
3,1.75,1810,10463,4,7,1810,0,340500
4,2.5,1950,5000,3,8,1950,0,425000
3,2.75,1120,881,3,8,1120,0,265000
4,2.5,2260,6086,3,8,2260,0,339950
3,1.75,1900,11407,3,8,1900,0,360000
2,1,700,4800,3,7,700,0,430000
3,1.5,1430,7560,5,6,1430,0,195000
2,1,700,8301,3,6,700,0,248000
3,1.75,1640,10123,3,8,1340,300,471000
4,2.5,2650,7945,3,9,2650,0,699000
3,2.5,1860,10027,3,8,1860,0,625000
3,2.25,1610,11920,4,7,1110,500,277000
3,2,2150,7200,3,8,2150,0,626000
4,2.5,2190,12690,3,8,1170,1020,833000
4,2.25,1870,7700,3,7,1870,0,520000
2,1,1670,14695,5,7,1670,0,495000
5,2.5,3120,15593,3,11,3120,0,750000
3,1.5,1670,6988,3,7,1370,300,280500
2,1,880,9000,3,5,880,0,130000
4,1,1140,6250,3,6,1140,0,390000
3,2,1850,8250,4,7,1150,700,257200
5,2.5,3580,8921,3,9,3580,0,1.15E+06
3,2.5,2240,7565,3,8,2240,0,349950
2,2.25,1230,932,3,8,1020,210,479000
3,1,1230,4800,1,6,1230,0,125000
4,2.25,2190,9113,3,7,2190,0,245000
4,2.75,2640,35070,3,8,2640,0,395000
4,3.25,3980,10249,3,10,3980,0,1.77E+06
3,2.5,2350,4456,3,7,2350,0,410000
5,2.5,4310,28008,3,10,4310,0,1.13E+06
4,2.25,2020,5800,4,9,1760,260,1.23E+06
2,1,1440,7130,3,7,1210,230,500000
4,2.5,2460,5000,5,8,1620,840,965000
2,1.5,1190,1236,3,7,1190,0,277500
4,3.25,2720,4000,3,10,2070,650,846000
4,2,2750,9001,3,8,2750,0,333000
5,2,1840,9240,4,7,1540,300,435000
3,2.25,1590,3056,3,7,1590,0,310000
4,2.5,2430,6796,3,8,2430,0,412950
3,2.25,1440,3488,4,7,1440,0,313500
3,1.75,1380,4590,2,7,930,450,740000
3,2.25,1870,3230,3,7,1870,0,288400
3,2.5,1690,2890,3,7,1690,0,475000
4,2.25,3040,10283,4,8,1430,1610,540000
3,2.5,2280,2289,3,8,1880,400,535000
4,3.25,3090,9571,3,9,2370,720,751000
2,1,760,6380,3,6,760,0,361600
3,2.5,2430,7049,3,8,2430,0,443000
4,3,2170,4000,4,9,1610,560,831000
4,3,3560,4000,3,9,2970,590,1.05E+06
4,2.5,2770,5686,3,9,2770,0,700000
3,2,1600,7350,4,7,1600,0,460000
4,1,1530,8890,3,7,980,550,352000
3,2,2050,9000,4,7,2050,0,713250
3,1,890,5200,3,7,890,0,315000
4,2.25,1920,8259,4,8,1920,0,625000
4,3.25,3310,8897,3,9,2380,930,429900
2,1,1070,6625,3,7,830,240,425000
4,2.25,2330,7220,3,8,1600,730,650000
3,2,1770,7200,4,7,1770,0,514000
3,1.75,2090,65558,3,8,1330,760,489500
3,2,1250,1306,3,7,1250,0,418000
3,1,1100,4046,4,6,1100,0,361000
3,1,1450,5378,3,7,1190,260,585000
3,1,1710,12000,4,7,1710,0,255000
4,2.5,2230,4372,5,8,1540,690,900000
3,2.5,1460,3044,3,7,1460,0,299880
4,2.25,2300,9100,3,7,1280,1020,265000
2,1,1657,5031,3,7,1657,0,546000
4,2.5,2300,6158,3,9,2300,0,775000
4,3,2490,5064,3,7,2490,0,449400
4,2.25,2080,15750,3,8,1460,620,440000
3,2.5,1730,3000,3,8,1730,0,665000
2,1,740,4459,3,5,740,0,295000
4,2.75,2300,18360,4,7,1560,740,315000
2,1.75,2080,8112,4,8,1040,1040,1.19E+06
3,2.75,3370,5350,4,7,2310,1060,675000
4,2.5,2920,7700,3,9,2920,0,515500
3,1.75,2630,6500,3,7,1330,1300,280000
3,2,1980,2674,3,8,1980,0,435000
3,2.5,2260,4165,3,7,2260,0,550000
4,3.5,1850,6519,3,7,1130,720,248000
4,2,1450,8940,3,7,1450,0,360000
6,2.75,2660,8400,5,8,1550,1110,603500
3,1,1630,16393,3,7,1630,0,437500
3,2.25,3000,18450,3,10,3000,0,850000
5,2.5,3480,74052,4,8,1980,1500,780000
3,2.25,1540,1561,3,8,1540,0,375000
1,1,570,6000,2,5,570,0,310000
3,3.5,2710,3290,3,8,1650,1060,600000
4,3,2240,5580,5,7,1830,410,530000
5,3.25,2820,6589,3,7,2320,500,408000
3,1.75,2420,14862,3,8,1380,1040,325000
4,1,1440,9600,2,7,1440,0,269950
2,1,1220,10000,5,7,1220,0,330000
3,2,1640,4714,3,8,1640,0,349950
5,2.5,4470,35124,3,11,4470,0,831500
5,1.5,1930,4500,3,8,1930,0,855000
3,1,1570,2280,3,7,1570,0,685000
1,1,640,4800,3,6,640,0,340000
3,2,1880,3800,5,7,1030,850,667500
4,2.75,3440,8150,3,10,3440,0,730000
4,1.5,1590,131551,4,7,1590,0,305000
3,2.5,1680,11312,3,7,1080,600,330000
3,1,1370,3500,3,7,1370,0,500000
4,3,2190,5085,4,8,2190,0,520000
3,1.75,2290,19000,4,9,1650,640,455500
3,1.5,910,25500,3,5,910,0,255000
3,1.75,1610,14000,4,7,1050,560,263500
3,2.25,1870,9000,3,7,1440,430,425000
4,3.5,3360,9767,3,9,2450,910,412000
4,2.5,3030,7800,3,9,1580,1450,799900
4,2.25,2820,5000,4,9,1800,1020,1.08E+06
3,1,1250,4590,3,6,970,280,555000
4,1.75,1890,8000,4,7,1250,640,375000
3,2.5,1630,2640,5,8,1630,0,800000
3,2.5,1800,3300,3,7,1690,110,399000
2,1,1140,15120,4,6,990,150,199000
3,2.5,1710,3795,3,7,1710,0,411753
2,1,880,4000,3,6,780,100,330000
4,2.5,2570,9086,3,9,2570,0,670000
3,1,1010,9450,4,7,1010,0,149500
3,3.5,1130,1449,3,7,1130,0,343000
4,3.25,3780,10099,3,11,2240,1540,1.18E+06
4,2.5,2470,5954,3,8,2470,0,550000
4,2.25,2380,35008,3,8,2380,0,594950
4,1.75,1880,7303,3,7,1010,870,423000
3,2.25,1490,1212,3,9,1040,450,735000
3,2.5,2250,7294,3,8,2250,0,308900
4,2.75,2160,7200,4,7,1220,940,445000
2,1.75,1490,4800,4,7,750,740,467500
4,3,5520,8313,3,9,3570,1950,1.27E+06
4,2.5,2050,3784,3,8,2050,0,540000
3,1.75,1820,34800,4,6,1820,0,377000
3,1.75,2300,41900,4,8,1310,990,320000
2,1,1070,8130,3,7,1070,0,505000
3,2.5,3420,79279,3,11,3420,0,1.23E+06
4,2.25,2050,12581,4,7,2050,0,305000
4,1,1260,4080,4,7,1260,0,618000
3,1,1200,9668,5,6,1200,0,146300
5,2.5,3260,24300,4,8,2310,950,755000
4,2.25,2230,8440,4,8,2230,0,449000
2,1,740,5995,4,7,740,0,304700
4,2.5,2610,4595,3,8,2610,0,535000
4,2.5,2290,10186,3,8,2290,0,650000
4,2.5,3240,10800,3,10,2260,980,1.29E+06
4,2.5,3220,4031,3,9,3220,0,760000
5,2.75,2330,8000,4,7,1550,780,665000
4,3.25,3440,7661,3,11,3440,0,905000
5,1.5,2170,8610,4,7,1230,940,497500
3,1.75,1420,1189,3,8,1420,0,455000
4,2.25,2180,10754,5,7,1100,1080,530000
5,3.75,3090,7415,3,8,3090,0,540500
3,2.75,3230,5200,3,9,2680,550,599832
3,1.75,1780,9689,3,7,1130,650,354950
3,1.75,1910,17003,4,8,1910,0,175000
4,2,1950,9940,4,7,1950,0,565000
4,1.5,1520,5910,3,7,1020,500,546800
3,2.25,1980,8000,4,9,1560,420,295000
5,1.75,2320,8100,4,7,1160,1160,315000
3,2.5,1870,3485,3,8,1870,0,575000
3,3.25,1770,1863,3,8,1430,340,450000
5,2.5,3270,6129,3,9,3270,0,485000
3,2.75,3270,39586,3,11,3270,0,875000
1,1,720,4800,3,6,720,0,190000
3,1,1500,2400,5,7,1500,0,614950
3,2.5,1690,3129,3,7,1690,0,442500
2,2.5,1950,2457,3,8,1950,0,565000
2,1,780,16344,1,5,780,0,78000
5,1.75,2220,6000,3,7,1420,800,607500
4,1,1020,11383,5,6,1020,0,364000
3,2.25,1654,8479,3,7,1654,0,314950
3,2,1210,6634,4,7,1210,0,237000
3,2.25,2410,9668,4,8,1540,870,715500
2,3,2330,3600,5,10,1870,460,1.05E+06
4,2.5,2980,16263,3,9,2980,0,1.01E+06
3,1,1060,52272,3,7,1060,0,250000
4,2,1920,4822,2,6,920,1000,200000
4,1.5,1380,7800,3,7,1080,300,477000
2,1.5,1300,2970,3,7,990,310,550000
4,3.25,3430,9870,3,9,3430,0,749995
2,1.5,1270,32175,4,7,1270,0,275000
2,1,1010,6000,4,6,1010,0,215000
4,2.75,2710,45963,3,9,2710,0,535000
4,2.5,3030,3841,3,9,3030,0,880000
3,1,1370,6450,3,7,1370,0,357000
3,2.5,2390,8102,4,8,2390,0,380000
4,2.75,3000,213008,4,8,3000,0,500000
3,2.5,1890,6560,3,7,1890,0,323000
5,2.5,2550,20875,4,9,1610,940,895000
3,2.5,1550,4486,3,7,1550,0,280000
3,2.25,2360,5504,4,8,2080,280,1.33E+06
4,2.5,4240,43995,3,10,4240,0,1.16E+06
4,2,1710,3875,4,7,1710,0,565000
4,2,2660,3900,4,7,1480,1180,886000
4,2.75,2210,8430,3,9,2210,0,587000
3,1,1400,9450,4,7,1060,340,279000
3,1.75,1680,28046,3,8,1180,500,620000
2,1,900,6400,5,6,900,0,205500
3,1,940,7590,4,6,940,0,435000
2,1,1430,13300,3,6,1230,200,425000
3,1.5,1150,8450,4,6,1150,0,265950
4,1.5,1370,7944,3,7,1370,0,219000
2,1,780,3910,3,6,780,0,380000
4,3.5,3906,9674,3,9,3906,0,549950
2,1.5,1090,4000,3,8,970,120,460000
4,3.5,2950,3737,3,10,2270,680,825750
3,1,960,12745,4,6,960,0,224975
3,2.25,1470,2500,3,8,1080,390,490000
3,2.5,1480,3851,3,8,1480,0,360000
4,2.25,2060,8400,3,7,1300,760,340000
3,2.75,2300,4637,3,8,2300,0,479500
4,1.75,1550,6000,5,7,1550,0,557800
3,1.5,1580,7200,4,7,1080,500,249000
3,2.5,3300,11525,5,8,1650,1650,360500
5,2,2740,3838,4,7,1370,1370,510000
5,2.75,2160,7200,3,7,1220,940,402000
3,2,1680,7000,4,7,1680,0,219200
3,1.75,1490,3800,3,6,700,790,510000
3,1.75,2000,12669,4,7,1200,800,367000
1,1.75,1020,4512,3,7,770,250,435500
4,3,2360,6250,3,7,1460,900,418000
3,3,2540,18900,3,7,1580,960,475000
3,2.25,1400,10436,4,7,1040,360,258900
4,2.5,2750,10351,3,10,2750,0,730000
3,3.25,5480,57990,3,11,5480,0,2.51E+06
3,2,1460,3696,3,7,1460,0,392137
3,1.5,1610,10291,4,7,1610,0,262500
4,2.5,2930,7806,3,9,2930,0,782500
4,3.5,4010,9654,3,10,4010,0,1.74E+06
5,3.5,4870,7700,5,10,3650,1220,1.74E+06
4,2,1950,8040,3,7,1950,0,392500
4,3.5,3290,5414,3,9,2360,930,899950
3,1.5,1310,8160,3,7,1310,0,365000
3,1.75,2040,81021,3,8,2040,0,580000
3,1,1100,8536,4,7,1100,0,277000
3,2.5,2550,5349,3,7,2550,0,394000
3,2.5,2530,8116,3,8,2530,0,450000
3,1.75,2140,9484,3,7,1290,850,650000
3,1,1240,7500,4,7,1240,0,324950
3,1.75,1560,4049,3,7,1000,560,451000
3,1.75,2200,7200,3,8,1270,930,265000
5,2.75,2470,19200,5,8,1250,1220,400000
3,3.5,2620,11148,4,9,2060,560,850000
3,1,1390,8333,3,7,1390,0,315000
3,1.5,1360,1167,3,8,1360,0,370000
3,1,1320,8100,3,6,880,440,268950
3,2.25,2910,15626,4,9,2510,400,1.81E+06
4,2.5,3290,6465,3,9,3290,0,716500
4,2.5,2150,9000,4,7,1360,790,317500
3,3.25,3140,5445,4,10,2240,900,1.64E+06
3,3.5,2480,10800,3,8,2480,0,640000
3,1.75,1790,7679,4,7,1790,0,382000
5,3.25,3240,6551,4,9,2500,740,1.23E+06
5,2.5,2130,7111,3,7,1330,800,360000
2,1,1100,27007,4,6,1100,0,303000
3,1,1590,4080,3,7,1590,0,630000
4,3,3320,5760,3,9,2120,1200,1.10E+06
3,1,910,5800,4,5,910,0,169900
3,2.25,1730,9516,3,8,1180,550,257000
5,3,2257,10117,3,8,1363,894,349950
4,1.75,1640,1480,4,7,820,820,450000
3,1.75,1600,19200,4,7,1600,0,510000
3,1.75,1870,12381,4,8,1870,0,314500
5,2,3530,9385,3,9,3530,0,930000
4,2.5,1830,7308,3,7,1830,0,358000
4,2.5,2620,9157,3,8,2620,0,885000
3,2,1710,5200,5,7,1030,680,230000
4,2.5,3810,13579,3,10,3810,0,920000
3,2,2190,5400,5,7,1260,930,769950
3,2.5,1270,9675,3,8,1270,0,280000
3,1.75,1630,15600,3,7,1630,0,522000
4,2,1780,5043,3,7,870,910,305000
5,2.5,2650,11455,3,7,1400,1250,565000
4,3.5,3830,7150,3,9,3830,0,989990
4,2.25,2340,5300,5,8,1700,640,665000
4,2.75,1990,7252,3,7,1270,720,270000
4,2.75,2520,6398,3,8,2520,0,642860
3,2.5,1850,7875,3,7,1250,600,260000
3,1,1400,8451,3,7,1400,0,348125
4,2.5,2310,5573,4,9,2310,0,525000
3,3,2100,2409,3,8,1660,440,515000
3,2.5,1370,1350,3,7,1010,360,368000
4,1.5,1810,7200,3,7,1810,0,430000
3,2,1860,13374,3,8,1860,0,560000
4,1.75,2370,5000,3,8,1770,600,870000
3,3.25,1860,1787,3,8,1860,0,379950
3,1,1160,7560,4,6,1160,0,254000
5,2,1750,8220,3,7,1750,0,340000
2,1,770,2500,3,6,770,0,203700
4,2.5,2170,11511,3,8,2170,0,377000
3,1,1360,5967,3,6,1360,0,265000
3,1,1010,14948,5,6,1010,0,265000
2,1,1280,12086,3,7,850,430,440000
2,1,1250,5208,3,7,1050,200,150000
3,2.25,1630,3817,3,7,1630,0,497000
3,2,1660,3600,3,7,1000,660,635500
3,1,890,9465,3,6,890,0,154500
3,2.25,2680,98445,5,8,2680,0,600000
3,2.75,2830,505166,4,8,1830,1000,999000
2,2.5,1590,2656,3,7,1220,370,305000
3,1,1010,10168,3,6,1010,0,300000
3,2,1410,7566,3,7,1410,0,239900
2,1,1030,5072,3,6,1030,0,397380
3,1.5,1640,2720,3,8,1640,0,475000
3,1,1010,6120,3,7,860,150,550000
3,1.75,1300,9079,3,7,1300,0,331000
4,2.5,3430,64441,3,8,3430,0,749950
2,1,770,6450,4,6,770,0,230000
2,2.5,1500,3608,3,8,1500,0,418000
2,1,1180,2160,3,7,940,240,600000
4,1.5,1650,2970,3,7,1650,0,752000
1,2.25,1940,2550,4,7,1100,840,315000
5,2.5,3370,5092,3,7,3370,0,405000
3,1,1630,3200,4,8,1630,0,925000
3,2,1850,8208,4,7,1180,670,245000
4,1.75,1670,9472,3,7,1100,570,335000
3,1,910,6000,2,6,910,0,219900
2,2,1960,4018,5,7,980,980,395000
3,2.5,2130,8022,3,8,2130,0,475000
4,2.5,2400,11640,5,8,1800,600,495000
4,1.75,2390,23899,3,7,1750,640,450000
4,2,2030,103672,4,7,2030,0,335000
3,1.75,1860,15681,4,7,1860,0,275000
3,1,1000,7800,4,6,860,140,400000
3,1,1630,5000,3,7,930,700,320000
4,2.75,1950,6192,3,8,1950,0,560000
4,2.5,2710,6583,3,9,2710,0,560000
3,2.5,2529,9653,3,7,2529,0,370950
3,1,1250,15603,4,7,1250,0,235000
3,1,920,5546,2,6,920,0,237000
4,2.5,1820,16103,3,7,1820,0,265000
2,1.5,1200,5773,3,7,1200,0,250000
4,3.25,3300,15907,5,10,3300,0,1.35E+06
4,2.5,2601,34335,3,9,2601,0,625000
3,2.25,1140,1557,3,8,1140,0,375000
5,1,1750,3861,3,7,1750,0,774900
2,1,790,7500,3,6,790,0,245500
3,3.25,5020,12431,3,10,3420,1600,3.60E+06
3,1.75,2300,16474,3,7,1220,1080,482000
3,1,1060,5600,4,6,760,300,345000
3,2.5,1370,7247,3,7,1370,0,231000
4,1,1750,68841,3,7,1750,0,322000
2,3,1460,1452,3,8,1140,320,437000
4,2.5,1983,6002,3,9,1983,0,345000
3,1,1260,9600,3,7,1260,0,320000
4,2,2060,6000,4,8,1370,690,705000
3,1,1020,8625,3,7,1020,0,245000
4,2.5,2350,63162,4,8,2350,0,649950
4,2.75,3520,19200,4,9,1950,1570,1.66E+06
4,1.5,1280,5460,5,7,1080,200,379000
5,3.25,5370,14091,3,10,3850,1520,3.00E+06
4,1,1750,9600,4,7,1750,0,420000
3,1.5,1160,1031,3,8,1160,0,459000
6,2,2040,10812,4,5,2040,0,300000
1,1,1660,5422,4,7,830,830,655000
4,1.75,1620,4240,5,7,1620,0,512500
3,1,2020,4120,4,7,1520,500,552500
3,2.5,2120,9653,3,8,2120,0,374950
2,1,1000,4000,3,6,1000,0,417200
4,1.5,3520,4933,4,8,2270,1250,589500
5,3.25,5570,9600,5,9,3860,1710,1.86E+06
3,1.75,2360,8290,4,7,1180,1180,753000
3,2.25,1560,35026,3,7,1290,270,299900
3,3.5,2490,3517,3,8,1720,770,533500
4,1.75,960,8863,5,6,580,380,255000
5,2.75,2960,28300,4,9,2160,800,1.25E+06
4,1,1170,4590,4,7,1170,0,564000
4,2.25,2250,12000,3,8,2250,0,287500
3,2.25,1840,5752,3,7,1840,0,465000
4,1.75,2020,7029,4,7,1430,590,532000
3,1.75,1840,9697,4,7,1500,340,235000
3,2.5,1450,1053,3,8,940,510,460000
4,2.75,2560,8956,4,7,1500,1060,485000
5,3,2230,4400,3,7,1730,500,920000
3,1,920,7276,4,6,920,0,125000
2,2,1700,3171,5,5,850,850,189000
3,2,1510,9153,4,7,1510,0,234950
3,2,1330,7419,3,7,1330,0,344950
3,2,1880,3000,4,8,1040,840,710000
4,2.25,2320,13114,5,8,2320,0,1.20E+06
4,3.75,3280,11000,3,10,2320,960,1.05E+06
3,2.5,2350,5100,3,8,2350,0,390000
3,2.75,1540,1251,3,8,1230,310,650000
3,1.75,2330,16300,3,9,2330,0,690000
3,2.5,2330,4160,4,8,2330,0,639900
3,2.5,2030,10958,3,8,2030,0,530000
4,1.75,2120,7680,4,7,1060,1060,379400
4,1.5,1840,7076,3,7,1840,0,210750
3,2.5,3060,9576,3,10,3060,0,1.27E+06
5,3,3670,9600,3,8,1980,1690,605000
3,2,1640,13249,3,7,1640,0,280000
1,1,750,4000,3,6,750,0,250000
3,1.75,1680,9460,4,7,1680,0,466000
3,2.25,1550,1919,3,8,1550,0,622000
4,2.75,2100,88426,3,6,2100,0,426500
4,2.5,2370,2971,3,9,2080,290,749950
5,2,2330,8586,4,7,1270,1060,362500
4,2.25,3240,11131,4,9,2080,1160,1.59E+06
3,2.5,3430,48993,3,9,3430,0,515000
3,2.5,2290,5089,3,9,2290,0,585000
3,2.5,2380,3332,3,9,2380,0,650000
5,4.75,5780,17004,3,11,4260,1520,2.32E+06
4,1.75,2040,53578,5,7,1160,880,545000
4,1,1340,22500,3,7,1340,0,275000
3,1.75,1550,7270,5,7,1550,0,453500
3,1,1400,9750,3,7,1400,0,253000
4,2.5,2680,4500,3,8,2680,0,379950
3,1,1320,3625,3,7,1320,0,464000
2,1,1070,2880,3,7,1070,0,350000
3,2.5,1270,865,3,7,1080,190,290750
3,2.5,2000,8057,3,8,1360,640,358500
4,2.75,2250,7345,4,8,1320,930,260000
2,2.5,2680,11214,3,9,2680,0,930000
4,2.75,2020,10720,4,8,1420,600,555000
6,3,2600,9350,4,8,1340,1260,600000
3,2.75,2730,11936,3,8,1530,1200,570000
5,2.5,2780,9652,4,8,1390,1390,290000
3,2.5,2270,9822,3,9,2270,0,766000
4,2.5,2630,8580,4,9,1700,930,710000
4,3.5,4910,9444,3,11,3110,1800,1.22E+06
3,3.5,3310,5558,3,9,3310,0,780000
4,2.5,3100,10000,3,9,3100,0,449950
6,1,1370,5080,3,6,1120,250,415000
3,1.75,1740,6800,4,7,1740,0,450000
3,1.5,1280,4366,4,6,1280,0,183000
3,2.5,2430,5400,3,8,2430,0,550000
4,1.75,2500,20868,3,8,1600,900,587500
2,1,1460,4200,4,6,880,580,415000
3,2.5,2200,6005,3,9,2200,0,606000
2,1,1440,6650,3,7,970,470,203000
3,1,980,9903,4,7,980,0,335000
4,2.5,2160,7000,4,9,2160,0,653000
5,5,5450,20412,3,11,5450,0,3.42E+06
4,3.5,3530,7202,3,9,2660,870,695000
2,2.5,1140,1182,3,8,1140,0,425000
5,2.5,2020,8250,4,8,1430,590,346500
4,2.25,2100,2500,3,8,2100,0,650000
3,1.75,1280,2147,4,7,1280,0,670000
9,3,3680,4400,3,7,2830,850,700000
3,2.5,2200,20000,3,7,1400,800,1.10E+06
2,1.75,1550,9230,3,6,970,580,349900
5,2,1910,5508,3,7,1020,890,485000
3,2.5,2075,16200,3,8,2075,0,433200
2,1,720,5880,3,6,720,0,184500
3,1.5,1030,8414,4,7,1030,0,301000
3,1.75,1530,8829,5,8,1530,0,500000
3,2,1800,11419,3,8,1800,0,205000
2,2.5,3180,9400,5,10,2610,570,1.41E+06
5,2.5,2840,9425,4,7,1590,1250,425000
3,2.75,2730,38869,3,9,1940,790,1.34E+06
3,1.75,2180,10221,4,7,1140,1040,705000
3,1,1430,4240,3,7,1430,0,650000
3,2.5,2010,4195,3,8,2010,0,463000
6,3.75,3160,5000,3,8,3160,0,848750
4,3.75,3210,7054,4,8,3210,0,690000
1,1,620,8261,3,5,620,0,148000
4,2.5,2110,7291,4,7,2110,0,670000
4,3.5,3810,9792,3,9,3810,0,825000
5,2.5,2010,3600,3,6,1510,500,475000
3,2.25,2450,42180,4,7,2450,0,450000
5,1,1590,6700,3,6,1090,500,185000
4,3.5,3660,14401,3,10,2660,1000,475000
2,1,800,2280,5,6,800,0,402500
2,1,1129,3840,3,7,1129,0,330000
6,4.5,3560,14010,3,7,3560,0,389000
2,1,1160,6911,3,7,1160,0,175000
3,1.75,1810,34500,3,8,1230,580,299500
6,3,2620,4350,3,7,1760,860,900000
3,2,1510,4560,4,7,1510,0,629000
3,1,1060,5200,5,6,1060,0,174950
3,2.5,1660,7388,3,7,1660,0,279000
3,2.5,1740,3082,3,8,1740,0,550000
5,1,1810,11205,3,7,1810,0,495000
2,2.5,2200,188200,3,8,2200,0,705000
3,1,920,14400,4,7,920,0,212500
5,4,4070,11334,3,10,4070,0,1.45E+06
4,2.25,2600,28600,3,8,1810,790,440000
3,2.5,3420,8700,3,9,2890,530,2.25E+06
4,2.5,2900,5505,3,8,2900,0,675000
4,1.75,1990,8900,4,8,1990,0,745000
3,2.5,2090,8505,3,8,2090,0,499000
5,6.75,9640,13068,3,12,4820,4820,4.67E+06
3,2.5,2690,4047,3,10,2690,0,979000
3,2.5,2270,4488,3,7,2270,0,480000
3,1.5,1320,3145,3,7,1320,0,402000
3,1.75,1560,7424,5,8,1560,0,592000
3,2.75,2380,5572,3,9,1930,450,1.16E+06
4,2.5,2030,10722,3,7,1100,930,595000
4,3.25,4580,4838,4,11,3080,1500,2.90E+06
4,3.25,3526,15958,3,10,3526,0,911000
3,2.5,3080,5598,3,8,3080,0,489000
4,1.75,1650,7200,3,7,1100,550,255000
4,2.5,2920,32219,5,10,2920,0,795000
3,2.5,1460,8800,4,7,1460,0,685000
3,2,1450,8928,3,7,1450,0,276000
3,1.75,3140,8571,4,8,1670,1470,345000
4,1,1870,14703,3,6,1090,780,230000
3,1,1140,8400,4,7,1140,0,294570
4,2.5,3280,27441,3,9,3280,0,699000
2,1,1180,10800,3,7,1180,0,400000
3,2.25,2430,73151,3,8,2430,0,524000
6,3.5,3000,8401,3,8,1500,1500,527000
3,2,1620,9566,4,7,1620,0,382880
4,2.5,3170,94855,4,9,1910,1260,799000
2,0.75,660,5240,4,4,660,0,100000
3,1.5,2000,7294,3,7,1520,480,375000
5,4,4720,493534,5,9,3960,760,745000
3,1,1130,7800,3,7,1130,0,250000
4,2.5,2100,8886,4,7,2100,0,485000
4,1.75,2130,5080,3,8,2130,0,955500
3,2.5,1608,4818,3,8,1608,0,280000
3,2.5,1690,2752,3,8,1690,0,431000
4,2.5,1970,8545,3,8,1970,0,438000
3,1,1730,7950,4,7,1180,550,216000
3,2.75,2940,12487,3,10,2940,0,795000
5,1.5,1730,9230,3,7,1010,720,287000
4,2.25,2130,11900,3,9,2130,0,649990
4,2,1560,8250,3,8,1320,240,400000
4,2.5,2360,9600,3,8,1630,730,840000
3,1.75,1250,8100,3,7,1250,0,330000
4,2.5,1930,9643,4,7,1930,0,315000
4,2.5,3170,4979,4,7,2570,600,748000
4,2.5,2090,3777,3,8,2090,0,374950
3,1.75,2220,11646,3,7,1270,950,320000
2,1.5,950,4625,4,7,950,0,430000
4,1.75,1920,7700,4,7,1920,0,415000
3,1,1160,10988,3,7,1160,0,360000
4,2.5,2260,5702,3,8,2260,0,325000
3,1,1090,3000,4,8,1090,0,535000
3,2.75,1970,2600,3,8,1970,0,780000
3,1,1260,10900,4,6,1260,0,190000
3,2,1490,9285,3,8,1490,0,289999
4,3,2620,35124,3,9,2620,0,443000
3,2.25,1700,9600,3,7,1700,0,294000
3,1,1300,9620,3,7,1300,0,219950
2,1,680,2550,4,5,680,0,365000
3,1,2020,8100,3,7,1170,850,450000
4,2.5,2100,8800,4,7,1240,860,630000
3,2.5,1770,6187,3,7,1770,0,245000
3,2.5,2110,3870,3,9,2110,0,590000
4,2.5,2190,7350,5,8,2190,0,925000
2,1,1170,8925,3,6,1170,0,175000
3,2.5,1820,1855,3,8,1570,250,320000
3,2.25,2150,30476,3,7,2150,0,335000
4,3.5,3820,13224,3,10,3280,540,1.24E+06
4,2.5,3340,8384,3,9,3340,0,810000
3,2.5,3000,8250,4,8,1760,1240,515000
3,2.25,1360,1041,3,8,1094,266,399950
3,1,1150,6000,3,7,1150,0,307000
4,1,1480,12675,4,7,1480,0,505000
4,2.75,1560,8820,3,7,1060,500,259900
4,2.25,2410,4000,5,8,1650,760,883000
4,3.5,2350,13402,3,8,1670,680,655000
3,2,1790,7212,4,8,1790,0,359950
2,1,1180,6552,4,6,1180,0,275000
4,2.75,3120,7898,4,8,1560,1560,1.96E+06
3,1,1400,7955,3,7,1400,0,194000
3,2,1860,7500,3,7,930,930,430000
3,2.5,1820,5280,4,7,910,910,515000
3,2,1880,3048,4,7,1880,0,449950
4,2.25,2080,8000,3,8,1390,690,500000
3,2.25,1470,8682,3,7,1160,310,160000
5,3,2190,9652,3,7,2190,0,419000
3,2.25,1970,2377,3,8,1680,290,415000
4,2.25,2570,11070,4,8,2570,0,479950
4,2.5,3150,5886,3,8,3150,0,580135
4,2.25,2060,8767,3,8,2060,0,543000
4,2.75,1300,9638,2,7,1300,0,273500
3,1.75,1400,6000,4,7,700,700,337000
2,2.5,1830,1988,3,9,1530,300,600000
4,1.75,2000,10890,4,7,1390,610,335000
4,2.5,2578,4554,3,9,2578,0,400950
3,1.75,1520,8625,3,8,1520,0,366000
4,2.25,2050,7700,3,7,2050,0,245000
2,1,1010,3600,3,7,1010,0,775000
3,1.75,1820,9545,3,7,1230,590,350000
4,2.5,2600,7787,3,8,2600,0,480000
4,2.5,2990,7928,3,9,2990,0,440000
3,1.5,1090,8160,3,7,1090,0,267000
4,2.5,2600,11542,4,9,2200,400,1.23E+06
4,2.5,2950,4836,3,7,2950,0,530000
3,1.75,1300,7735,4,7,1300,0,224500
3,2.5,2150,9375,3,8,1550,600,284000
5,4.5,4270,8076,3,11,3400,870,1.53E+06
4,3,3230,438213,3,9,3230,0,950000
3,1,1350,3090,5,6,1350,0,400000
3,1.75,1140,8558,4,7,1140,0,420000
3,1.75,1900,43700,4,6,1900,0,476800
3,2,1970,7000,3,8,1970,0,429800
3,1.5,1740,9046,3,7,1740,0,415000
5,2.5,3440,12350,4,9,1760,1680,549000
3,2,2783,11177,3,8,2783,0,840000
3,1.75,2270,11472,4,7,1370,900,645000
5,4.5,4140,7924,3,10,4140,0,1.06E+06
3,2,1300,3000,3,7,1300,0,480000
3,1,1050,4160,4,7,1050,0,540000
3,1.5,1900,9994,3,7,1120,780,278000
2,2.5,1290,1445,3,8,1290,0,350500
3,2.5,1870,8541,3,8,1870,0,299990
3,1.75,1200,4500,5,7,1200,0,430000
3,1.75,1510,15744,3,7,1510,0,330000
4,2.5,2820,8307,3,9,2820,0,690000
3,1.75,1950,7260,3,8,1520,430,360000
2,1,700,8100,3,6,700,0,254950
3,2.5,2320,32772,3,9,2320,0,630000
4,2.75,2110,8751,3,7,1510,600,435000
5,2.5,2950,72309,3,8,2950,0,599000
3,2.25,1470,7857,4,7,1180,290,312000
3,1.75,1840,17286,4,7,1440,400,325000
3,2.5,1720,3012,3,9,1720,0,500000
4,2.5,2300,9690,3,8,2300,0,329950
3,2.5,2580,4636,3,9,2580,0,698000
4,2.5,3360,15091,3,9,3360,0,740000
3,1,1180,9000,4,7,1180,0,215000
4,3,2500,6278,3,9,2500,0,395000
3,1,1370,7500,3,7,1370,0,307000
4,2.75,2200,122403,3,7,2200,0,522500
3,1.75,2560,4800,3,7,1280,1280,747000
4,3.25,2840,54400,4,8,2840,0,713000
3,1.5,1550,40752,5,7,1550,0,350000
3,1.75,1270,8991,3,7,1270,0,140000
2,3,2210,3917,3,10,1500,710,1.26E+06
1,1,690,1950,3,6,690,0,280000
3,1,1200,5650,3,7,1200,0,329000
5,2.75,2990,7420,3,8,2990,0,498500
3,1.5,2240,13288,3,7,2240,0,495000
4,2.75,2530,17856,3,8,2530,0,525000
2,1,820,8860,3,6,820,0,197500
2,1.75,1320,13052,3,7,1320,0,200000
3,2.25,2300,15952,4,8,1150,1150,1.00E+06
4,2.5,3160,13063,3,10,3160,0,693000
3,2,1540,3600,3,7,890,650,500000
4,2.5,2180,6500,3,7,1410,770,435000
4,2.25,2120,9921,3,8,2120,0,800000
3,2,1720,8145,5,7,1720,0,432500
4,3.5,3100,7600,3,10,3100,0,511000
4,1.75,1920,6000,4,7,960,960,455000
4,2.5,2330,45860,3,9,2330,0,585000
3,2.5,1890,6500,3,7,1890,0,409000
6,2.75,2850,15240,3,7,1850,1000,360000
4,3.25,3770,982998,3,10,3770,0,998000
3,2,2140,3600,3,8,1680,460,625000
4,2.5,2820,8408,3,9,2820,0,625000
3,1.75,1260,11775,5,6,1260,0,353000
2,1,1400,10800,4,7,1400,0,325000
3,2.5,1670,8023,5,7,1170,500,696000
6,3.5,2410,6000,3,9,2220,190,767500
4,2.5,2810,10613,3,9,2810,0,810000
8,3.25,4300,10441,4,8,2800,1500,430000
2,2.5,980,895,3,8,670,310,369000
3,2.25,2090,7450,3,7,1350,740,485000
3,2.5,2030,6500,3,8,2030,0,618080
6,3,3110,5000,5,7,1810,1300,725000
3,2.5,1600,3073,3,8,1600,0,502000
3,1,1460,8400,3,7,1460,0,235000
5,3.25,3370,7313,4,8,2140,1230,690000
3,1.75,1750,11340,4,7,1300,450,491300
4,2.5,4120,22370,3,10,4120,0,863000
4,3.5,3470,8580,3,11,2500,970,1.45E+06
3,1.75,1270,4800,3,7,1270,0,335000
3,2.5,1490,4078,3,8,1490,0,316000
4,2.5,1847,8000,3,7,1847,0,215000
3,2,1380,4500,3,7,1380,0,275000
4,3,4160,13170,3,11,3040,1120,1.15E+06
4,2.5,3030,9500,3,8,3030,0,367950
3,1.5,2240,5300,5,7,1120,1120,635000
3,1.75,1590,8219,5,6,970,620,400000
3,2.75,3150,5520,4,8,2130,1020,1.21E+06
4,2.5,2110,4178,3,7,2110,0,324950
3,1.75,2000,9416,4,6,2000,0,374000
3,2,1410,4800,4,8,1410,0,655000
3,2,1320,6500,3,7,1320,0,445800
3,2.75,3450,5350,4,9,2590,860,1.30E+06
3,2.25,1820,7420,4,8,1820,0,390000
4,2.5,1980,6660,4,7,1980,0,463000
3,1,1220,6000,4,7,1220,0,213500
3,1,1790,6000,2,8,1790,0,425000
3,1.5,1720,7119,4,7,1720,0,341000
4,1,1460,4600,3,6,780,680,445000
3,2.5,2828,4050,3,8,2828,0,367000
4,2.5,2860,9159,4,8,1530,1330,750500
3,2,1530,1442,3,9,1530,0,649000
2,2.25,1620,1841,3,8,1540,80,395000
4,3,2820,11500,3,10,2820,0,692500
5,2.5,3150,50094,4,9,3150,0,1.00E+06
3,1,1460,7200,3,7,1260,200,538000
4,2.75,2640,9000,3,10,2640,0,790000
5,4,4430,9000,3,10,4430,0,2.45E+06
3,1.75,1840,2310,4,8,1140,700,650000
3,3.25,1720,1587,3,9,1410,310,638000
3,1.75,1300,7030,3,7,1300,0,385000
5,2.25,3040,8111,3,8,3040,0,562000
5,2.25,3260,7969,4,8,3260,0,353950
3,1.5,1530,10827,4,8,1530,0,865000
4,2.5,3610,13292,3,10,3610,0,875909
4,3,3150,7778,3,9,3150,0,700000
2,1,1240,12092,3,6,960,280,240500
3,2.5,1990,3614,3,7,1990,0,309000
3,1,1020,8610,5,7,1020,0,265000
4,2,2300,3400,5,8,1550,750,619000
4,2.5,2960,6031,3,9,2960,0,449000
3,2.75,1900,8200,4,7,1900,0,314000
2,1,750,2020,3,7,750,0,370000
5,1.75,2860,12293,4,8,1430,1430,411000
4,2,1980,7200,3,8,1700,280,900000
4,2.5,3240,35083,4,9,3240,0,975000
3,2.5,2260,33042,3,9,1660,600,610000
3,1.75,1260,6223,3,7,820,440,210000
3,2,3040,41072,4,8,1520,1520,500000
4,2.75,3950,10214,3,10,2050,1900,900000
4,1,1920,6480,3,7,1920,0,535000
4,1,1750,12528,4,7,1750,0,432000
3,1.5,1600,10440,3,7,1600,0,390000
4,1,1480,7560,3,7,1480,0,440000
3,2.5,1890,3880,4,8,1460,430,726000
3,2.5,1940,37565,4,8,1940,0,500000
3,2.25,1840,6750,4,7,1270,570,265000
4,1.75,2260,6600,5,8,1220,1040,864000
3,1,1460,11880,2,7,1460,0,175000
3,1.75,1620,4200,5,7,830,790,500000
2,1,710,4618,3,5,710,0,375000
1,1,660,3570,3,6,660,0,385000
4,2.75,3060,35380,3,9,1810,1250,657000
5,2.5,2530,8564,4,8,2530,0,875000
4,2,1660,6150,3,6,850,810,452000
3,1,1300,8184,3,6,1300,0,252000
3,2.5,1420,3542,3,8,1310,110,290000
3,1.75,1780,11440,3,8,1350,430,399000
6,2.75,2410,10763,5,7,1310,1100,320000
3,1.75,1150,10240,3,6,1030,120,475000
4,3.5,1800,6400,3,8,1800,0,958000
2,1,1220,6300,3,7,760,460,400000
6,2.25,2660,13579,3,7,2660,0,452000
4,2,1960,7560,5,7,1160,800,250000
4,2.5,3400,247421,3,9,3400,0,712000
5,2.75,2910,5802,3,7,2910,0,410000
3,1.5,1520,9041,4,7,1520,0,810000
3,1.75,2020,11050,4,8,1320,700,330000
2,1,760,5280,3,6,760,0,122000
2,1.75,1030,1106,3,7,765,265,345000
2,2,1340,1635,3,8,1340,0,376000
3,2.25,1530,7906,3,7,1150,380,315000
4,2.25,1960,12436,3,8,1960,0,500000
4,1.75,2160,19283,3,8,2160,0,475000
4,3.25,4740,49091,3,11,4740,0,1.15E+06
4,1.75,1800,4180,4,8,1800,0,865000
3,2,1720,5525,5,7,960,760,500000
4,4,3680,18804,3,10,3680,0,675000
3,1.75,1300,4127,4,6,650,650,270000
3,2.25,1790,2240,4,8,1790,0,432100
3,2.5,2350,9051,4,8,1570,780,235000
3,3,3450,16740,4,9,1960,1490,2.23E+06
3,2.5,1420,814,3,8,1140,280,451300
4,1,1330,9729,3,6,1330,0,1.05E+06
3,2,1010,5973,5,6,1010,0,675000
3,1.75,1790,15142,3,7,1360,430,415000
3,2.5,2000,7414,4,7,2000,0,290000
4,2.5,1900,2766,3,8,1900,0,425000
4,2.5,2910,15016,3,10,2910,0,765000
5,3.25,3950,11438,3,10,3430,520,1.42E+06
3,1.75,1930,13350,3,8,1930,0,295000
3,1.75,1650,221720,3,7,1650,0,610000
5,4.75,5305,8401,3,11,3745,1560,2.70E+06
3,1,960,5030,3,7,960,0,235000
3,1.75,1180,14292,3,7,1180,0,455000
4,4,3530,10935,3,10,3530,0,510000
4,3.25,3930,10929,3,10,3930,0,1.88E+06
6,2.5,3010,17864,3,8,3010,0,847000
3,1.5,1300,7600,4,7,1300,0,235000
3,1.75,1390,4602,3,7,930,460,400000
3,2.75,1920,7700,4,8,1320,600,329000
3,2.25,2130,11782,4,8,1590,540,780000
4,2.5,2740,9599,3,8,1820,920,625000
4,3.25,2510,5311,3,9,2510,0,450800
3,2,1650,9641,3,7,1650,0,410000
4,1.5,1740,8160,4,7,1400,340,515000
3,2.5,1620,7320,3,7,1620,0,276900
3,1.75,1840,4030,5,7,1050,790,457500
3,1.75,1810,41800,5,7,1210,600,314000
3,2,2140,4923,4,8,1070,1070,710000
3,2.25,1500,8100,3,7,1210,290,294900
3,3,2440,15540,3,9,2440,0,483000
4,3.25,3860,7199,3,9,2870,990,1.50E+06
4,1.75,2060,4080,3,7,1460,600,562000
3,1,1040,8910,3,6,1040,0,190000
2,1,1270,4500,4,7,1270,0,510000
4,2.5,2570,13450,3,8,1510,1060,795000
4,2.75,2240,5400,4,7,1540,700,590000
4,2.5,2120,8448,4,9,2120,0,690000
3,1.75,2210,7920,3,7,1400,810,343000
3,1.75,1760,26055,3,7,920,840,225000
3,2.25,1930,3462,3,7,1930,0,326000
4,2.5,2190,7125,5,8,2190,0,320000
2,2,1200,3624,3,6,1200,0,234000
3,2.25,1450,7562,3,7,1450,0,297000
3,2.25,3060,16000,3,10,3060,0,1.76E+06
4,5.5,6550,217374,3,11,5400,1150,1.50E+06
3,1,1060,9946,4,7,1060,0,230000
4,2.5,2260,9696,3,9,2260,0,608700
2,1,1060,5200,3,6,1060,0,216500
3,2.5,1750,4797,4,7,1750,0,575000
4,2.25,1980,15086,3,8,1980,0,530000
4,2.5,2930,4875,3,9,2930,0,442515
3,1.5,1360,9980,4,7,1360,0,244900
2,2,1310,2550,3,6,1310,0,219000
4,1.75,1970,5160,3,7,1970,0,432000
4,2.5,2620,7553,3,8,2620,0,605000
3,2.5,1600,7982,3,8,1600,0,315000
0,0,4810,28008,3,12,4810,0,1.30E+06
2,1,930,7740,1,5,930,0,105500
5,3,2400,10126,3,8,2400,0,745000
4,2.25,2610,24931,3,8,2610,0,659000
2,1,1250,3825,3,7,850,400,459500
4,2.25,2510,11585,4,8,2510,0,799000
3,2.5,2140,10136,3,8,1320,820,550000
3,2,2350,8459,3,9,2350,0,339000
3,1,1310,4163,4,7,1310,0,415885
4,2,1600,15044,3,7,1600,0,436000
4,1.5,2720,37258,3,10,2720,0,632500
4,2.5,2598,5553,3,9,2598,0,428900
3,1.75,1340,9975,4,7,1340,0,410000
3,2.5,2070,8400,4,8,2070,0,250000
5,1.5,2120,7700,5,7,2120,0,290000
2,2,1480,804,3,8,1480,0,459000
3,2.25,2140,11266,3,7,2140,0,400000
3,2.5,2810,435600,3,9,2810,0,745000
2,2.5,1720,3132,3,8,1720,0,234950
4,2,1870,7700,3,8,1870,0,325000
3,2.5,1890,6300,3,7,1890,0,310000
4,4.5,4750,13912,3,10,3600,1150,1.31E+06
4,2.25,2940,5735,3,9,1470,1470,1.60E+06
3,2.25,2220,4060,3,7,1330,890,330000
5,2.75,1790,5000,4,7,1060,730,294000
2,1.75,2090,11317,5,7,1090,1000,275000
3,1,2000,15900,3,6,1000,1000,244000
5,2.75,3890,9130,3,9,3890,0,772500
2,1.5,1110,1200,3,8,1110,0,320000
3,2.75,2340,8828,4,9,2340,0,1.57E+06
4,2.5,2280,5000,3,7,2280,0,345000
4,2.5,1540,1870,3,8,1540,0,484998
3,1.75,1560,21000,3,7,1560,0,284000
3,3.25,2320,6744,3,9,1930,390,674000
3,2.5,2400,9701,3,9,2400,0,355000
3,2.5,2720,62310,3,8,2040,680,550000
3,2.5,2029,3906,3,9,2029,0,384435
4,3.5,3920,9555,3,9,3920,0,889000
3,1.75,1940,10245,3,7,1940,0,650000
5,3.75,4170,8142,3,10,4170,0,1.09E+06
4,2.75,3230,12651,4,8,3230,0,409000
3,1,1380,7015,4,7,1380,0,408000
3,1.75,1870,8250,3,7,1870,0,355000
5,1.5,2240,6337,3,8,1280,960,534950
3,1.75,2170,12220,5,8,2170,0,907000
3,3.25,1530,1612,3,8,1530,0,607500
3,1,930,6060,4,6,930,0,250000
4,2,1760,8400,3,7,1060,700,247500
3,1,900,10511,4,6,900,0,178500
4,2.25,2370,6000,3,8,1440,930,899000
3,1.5,1370,8671,3,7,1370,0,815000
3,2.5,3280,6750,3,9,2440,840,750000
3,2,2800,185130,3,8,2320,480,540500
3,2.5,1830,4997,3,7,1830,0,286651
4,2.5,1540,1994,3,8,1540,0,439990
3,2,1570,5250,3,7,1570,0,278500
2,1,840,7425,4,6,840,0,218450
3,2.75,2500,35245,3,7,1580,920,397900
2,1,1080,9067,3,6,1080,0,203000
3,2,1790,6800,4,7,1240,550,472500
4,1,1360,5766,5,7,1360,0,540000
2,1,880,6345,3,7,880,0,312500
3,2.25,1810,8158,3,8,1450,360,507000
4,2.5,1900,5790,3,8,1900,0,535800
2,1,2360,105850,2,6,1180,1180,370000
3,2.25,1740,8491,3,8,1240,500,435000
3,1.75,1480,2211,3,7,1480,0,402500
3,1.75,1740,3060,5,8,950,790,733000
3,2.25,1780,1429,3,8,1570,210,620000
3,2.75,3040,24192,4,10,3040,0,825000
3,2.5,2290,2798,4,9,2290,0,660000
3,1.75,1740,29597,4,7,1740,0,350000
2,1,880,5100,4,7,880,0,415000
3,2,1840,6000,5,7,1720,120,778000
3,1.75,1570,5120,3,7,980,590,440000
2,1.75,2120,6350,4,6,1440,680,300000
3,1.75,1370,9288,4,7,1370,0,301950
3,1,1540,37950,4,7,1090,450,429000
5,2.5,2990,7500,3,9,1800,1190,575000
3,2.25,1640,12000,3,7,1180,460,575950
4,3,1830,9548,3,7,1830,0,415000
3,1.75,1320,17390,4,7,1320,0,199000
4,2.25,2240,8376,3,8,1740,500,530000
4,2.25,2390,8858,4,8,1740,650,606000
4,3.5,3915,6364,3,9,3915,0,963990
4,2.5,1970,2601,3,7,1440,530,499000
2,1,1180,10200,4,7,1180,0,244000
2,1.5,893,965,3,8,893,0,359950
2,1,950,7692,3,6,950,0,192500
4,2.5,3770,35081,3,10,3770,0,950000
4,1.5,2750,128502,2,7,1500,1250,550000
3,2.5,1640,29970,3,7,1640,0,463000
3,2,1330,8100,4,7,1330,0,386000
4,1.75,2000,25700,4,7,1150,850,310597
2,1,850,6800,3,7,850,0,290000
4,2.5,2580,3943,3,8,2580,0,899000
3,1.75,1510,8433,4,7,1220,290,490000
4,3.25,4110,15488,3,11,4110,0,935000
3,1,1610,58370,3,7,1610,0,590000
3,2,1790,32379,3,7,1790,0,440000
3,3.25,2660,4000,3,9,2170,490,915000
2,1,800,3330,3,7,800,0,373500
4,1.75,1730,7210,4,7,1010,720,280400
3,1,1390,2640,3,7,1230,160,345000
4,2.75,2910,18700,3,9,2210,700,749950
3,1.75,1490,9800,4,7,1140,350,745000
2,1,980,5000,3,6,980,0,452000
3,2.5,1900,1258,3,7,1700,200,645000
3,2.25,1720,5234,3,9,1240,480,608000
3,1,1290,4000,3,7,1290,0,402500
2,1,1210,8400,3,8,780,430,824000
4,2.5,2980,13341,5,8,1800,1180,1.60E+06
4,2.5,3220,38448,3,10,3220,0,775000
4,2.25,2010,15375,4,8,2010,0,660000
4,2.5,2770,19116,4,8,1600,1170,318700
3,1.75,1600,7500,3,7,1600,0,285000
3,2.5,2026,7611,3,8,2026,0,358000
5,2.5,2570,7412,3,8,2570,0,472000
4,2.5,2470,33305,3,9,2470,0,633100
3,2.25,1260,915,3,8,1020,240,282000
2,2,2180,21392,3,8,2180,0,750000
3,1.75,1720,2218,3,7,1270,450,565000
3,1.75,1840,10723,4,7,1220,620,310000
2,1,770,2971,3,7,770,0,407500
3,1,1270,16800,4,7,1270,0,254000
3,1.75,1720,7202,3,7,1720,0,404000
4,2.5,3510,28052,3,10,3510,0,915000
4,1.75,1600,6380,3,8,1130,470,495000
3,1.75,1770,10125,3,7,1770,0,487000
3,2.5,2620,4874,3,7,2620,0,470000
4,2.5,2660,5043,3,9,2660,0,765000
3,1.75,1700,5750,5,7,1450,250,545000
2,1,900,4600,3,6,900,0,370000
1,1.25,1100,638,3,9,1100,0,516500
3,3.5,1420,1217,3,8,1180,240,579950
4,2,1310,8454,4,7,1310,0,304000
3,2.5,1860,43170,3,8,1860,0,526500
4,2.75,3780,10308,3,10,3780,0,833000
4,2,1300,7054,3,7,1300,0,312000
3,1,1340,10260,3,7,1340,0,172000
3,1.75,1010,5355,3,6,1010,0,160000
4,2.75,2200,8580,3,8,1860,340,315000
3,1,1080,6250,2,5,1080,0,157000
3,1.75,1210,4400,4,8,1210,0,635000
3,1.75,2259,26831,5,7,1491,768,262500
4,2.5,2240,7589,3,8,2240,0,330000
2,1.5,1210,1278,3,8,1020,190,414500
5,1.75,2460,16000,3,7,1230,1230,240000
4,1.75,2250,13515,4,8,2150,100,350000
5,2,1750,10284,4,5,1750,0,190000
4,2.25,1790,13200,3,7,1220,570,197000
4,2,1700,8043,3,7,850,850,220000
4,2.5,2970,4400,3,8,2970,0,775950
3,1,1710,6195,3,7,1410,300,670000
3,2.25,1440,4667,3,7,1440,0,447000
2,2.25,1180,1253,3,8,840,340,419000
4,2.5,2050,2772,3,8,2050,0,689500
4,3.25,2930,25020,3,9,2930,0,1.05E+06
5,1.75,2650,11340,3,8,2650,0,1.39E+06
4,2.75,2440,15349,4,7,2440,0,425000
3,1,1240,5200,3,6,1240,0,150000
3,1,1040,6720,3,7,1040,0,361000
3,1,1660,7210,3,7,1100,560,225000
3,1.5,1930,11092,3,7,1500,430,475000
3,2.5,2010,6857,4,9,1450,560,960000
2,1,940,5000,3,7,940,0,350000
3,2,1460,2610,3,8,1460,0,444000
2,1.75,1610,4104,3,7,950,660,397000
3,1.75,2080,9162,3,7,1370,710,638700
3,1.75,1410,9315,5,7,1410,0,255000
3,2,1410,6413,4,7,910,500,590000
3,1.75,1840,9401,3,8,1840,0,550000
4,1.75,2700,7875,4,8,2700,0,390000
5,3.5,3080,7759,3,8,2310,770,455000
2,1,1510,3844,4,7,1510,0,335000
4,2.25,2130,7172,4,8,2130,0,593450
3,3.75,3710,34412,3,10,2910,800,998000
4,2.5,3270,9650,4,9,2320,950,700000
3,2,2520,3959,5,8,1270,1250,861000
4,2.5,4190,7504,3,7,4190,0,460000
2,1,850,6174,4,7,850,0,308500
4,2.25,1930,7452,3,7,1430,500,312000
3,2.5,1550,3569,3,7,1550,0,259000
4,3.5,3060,4573,3,9,2410,650,775000
3,3.25,1370,913,3,8,1100,270,390000
4,1.75,1920,4862,5,7,1060,860,589000
3,2,2150,3880,3,8,1080,1070,575000
3,1,1270,8920,5,7,1270,0,422500
3,2.25,2060,47318,4,8,1600,460,335000
3,1,1210,6650,3,6,1210,0,355000
4,2.5,2720,7991,3,9,2720,0,635000
3,2.5,2540,6093,3,9,2540,0,567000
3,2.5,2380,19860,4,8,2380,0,582000
3,3,2990,30869,3,10,2990,0,900000
4,2.5,2190,6300,3,7,1240,950,1.10E+06
5,4,4700,22326,3,11,4700,0,1.40E+06
2,1,1480,6210,3,7,1080,400,331000
2,1,1010,5000,2,7,1010,0,429000
3,1.75,1530,10731,3,7,1530,0,400000
2,1.75,1440,11210,4,6,1130,310,282500
4,1.75,1900,8800,3,8,1140,760,675000
4,2.5,2040,7000,3,7,1250,790,264900
3,2.75,1990,19991,3,7,1340,650,335000
3,1,1140,7560,4,6,1140,0,218000
3,1.75,1460,7862,3,7,1460,0,305000
2,1,1740,5719,3,8,1740,0,800000
4,3.75,2540,20662,3,10,2540,0,800000
3,2.5,1890,6088,3,7,1890,0,265000
3,2.25,3740,22464,5,8,2330,1410,999950
4,3.25,3330,7809,3,9,3330,0,830000
5,4,3040,6000,3,8,2280,760,605000
4,1.5,2440,8040,4,8,1440,1000,849000
2,1,700,4836,4,6,700,0,380000
3,1.75,1720,6960,3,7,1140,580,450000
2,1,1000,31505,3,6,1000,0,265000
4,2.5,2670,5895,3,8,2670,0,603000
3,1,1180,13650,4,7,1180,0,255000
3,1.75,1530,6125,3,7,1120,410,526000
5,4.25,3530,7924,3,10,3530,0,1.40E+06
3,2.75,2550,11160,3,8,2550,0,430000
4,2.75,3160,37200,3,8,2310,850,942000
4,3.25,4110,14219,4,10,2570,1540,825000
4,2.25,2060,12155,4,8,2060,0,575000
3,2,1560,8509,3,8,790,770,465000
5,1.5,3360,5225,3,9,3360,0,834995
3,1,1160,8800,4,7,1160,0,480000
3,2.5,1020,2040,3,7,720,300,225000
4,1.75,2040,15000,4,7,1360,680,355000
4,2.5,1867,15314,3,9,1867,0,378950
3,2.5,1940,3211,3,8,1940,0,555000
4,2.5,2910,4680,5,9,1850,1060,945000
4,3.75,4260,9800,3,10,4260,0,1.07E+06
4,1,1100,7110,4,7,880,220,225800
3,2.5,1700,1156,3,9,1320,380,585000
3,1.75,1760,7482,4,8,1760,0,264000
4,3.5,1930,5400,3,7,1930,0,690000
3,2,1880,10758,5,6,940,940,320000
4,2.5,3470,4160,3,9,2480,990,1.30E+06
3,2.5,2660,1967,3,9,1870,790,1.23E+06
3,1.5,1040,1264,3,9,900,140,230000
3,1.5,1690,9144,4,7,1140,550,379950
3,2,1520,7456,3,7,1520,0,167000
4,1,1420,4875,3,7,1420,0,400000
2,2.5,1700,2513,3,8,1700,0,378000
4,3.75,4090,24825,4,11,3400,690,2.40E+06
3,2.5,2850,36585,3,10,2850,0,700000
3,2.5,2240,10800,3,8,2240,0,390000
3,2.5,1830,65340,3,8,1520,310,427000
4,2.5,2460,9296,3,9,2460,0,722500
4,1.75,2790,17476,3,7,1450,1340,568000
2,1,760,7272,4,7,760,0,183000
3,2.25,1350,944,3,8,1050,300,388500
4,1.5,1600,5750,4,6,1600,0,286000
4,2.5,2690,8036,4,9,2690,0,790000
4,3.5,2160,3600,3,8,1660,500,601000
6,4.5,3830,4800,3,9,3050,780,989000
4,2.5,2770,4432,3,9,2770,0,438800
4,1.5,1470,5100,3,7,1470,0,551000
3,2.25,2180,7741,3,9,2180,0,621138
4,3,3150,6599,3,9,3150,0,649500
4,2.5,2240,7200,3,8,2240,0,497000
3,1,950,10080,4,7,950,0,435000
4,2.5,3520,15420,3,10,3520,0,810000
3,1.5,1820,5756,3,7,1640,180,683500
2,1,990,57499,2,6,990,0,329000
3,2,2350,266151,3,7,2350,0,510000
8,4,7710,11750,5,12,6090,1620,3.30E+06
3,1.5,1900,9737,4,7,1200,700,275000
4,2.5,3440,23954,5,10,2260,1180,2.49E+06
3,2.5,1690,1760,3,8,1410,280,338000
2,2.5,1460,1296,3,8,1160,300,449000
2,1.5,770,850,3,7,770,0,290000
3,2.25,1660,8188,4,7,1660,0,254000
3,1,940,1948,5,6,940,0,551000
4,3,3280,4904,3,7,3280,0,634800
4,2.5,2990,8622,3,9,2990,0,645500
4,3.75,4030,503989,3,10,4030,0,920000
3,2.5,3240,108366,4,10,3240,0,651000
3,1,900,4770,3,6,900,0,146000
3,2.5,1720,4515,3,7,1720,0,389000
4,2.5,2450,55387,3,9,2450,0,620000
3,1.75,1410,5100,4,7,1110,300,445000
2,1,930,5077,3,6,930,0,358000
3,2,1670,13775,3,8,1670,0,375000
3,3,3030,5156,4,9,2080,950,879000
3,2.25,1670,7150,4,7,1670,0,282500
4,2,1440,4855,4,7,1440,0,332500
4,2.5,2130,7300,4,7,1230,900,732600
2,1,930,3447,4,8,930,0,178500
2,1.75,1660,11437,3,7,1660,0,335000
3,1,1190,11120,3,6,1190,0,260000
3,1.75,1350,4000,4,7,1350,0,700000
3,2.5,1720,3407,3,7,1720,0,245000
3,2.5,2260,5500,3,7,1280,980,625000
4,2.25,2100,8290,4,8,2100,0,625000
2,1.5,1260,9693,3,7,1260,0,245560
5,2.5,4150,96574,3,10,4150,0,930800
5,2.75,2710,4136,3,8,2710,0,515805
4,1.75,2350,11914,4,8,2350,0,850000
4,2.5,2690,7947,3,8,2690,0,419000
4,3,2000,5304,4,7,2000,0,775000
4,2,1540,9279,3,7,1540,0,235000
4,2,1200,8460,5,7,1200,0,173000
5,2.75,2540,8250,4,7,1440,1100,760250
4,2.5,2540,5001,3,9,2540,0,487000
3,2,2320,9420,5,7,2320,0,436300
2,1.5,1170,1079,3,7,1170,0,459500
3,1.5,1280,7742,4,7,1280,0,220000
3,3.25,2460,4182,5,8,2100,360,990000
3,1,2120,31564,3,7,1220,900,200000
5,5,5000,32909,3,10,5000,0,1.25E+06
3,2.5,2010,5200,3,8,2010,0,559000
4,2.5,1940,10133,3,8,1940,0,311500
5,2.75,2130,6222,3,7,1300,830,325000
3,2.25,1410,8909,3,7,1410,0,318000
3,3.5,3490,4000,3,9,2570,920,1.62E+06
3,2.25,2160,9540,3,8,2160,0,402500
2,1,890,5000,4,6,890,0,302000
4,2.25,2480,36974,4,9,2480,0,855000
3,1,980,2490,4,6,980,0,90000
3,1.75,2340,4206,5,7,1170,1170,640000
3,1.75,1480,7700,3,8,1480,0,395000
4,2.5,3080,13870,4,9,3080,0,841000
4,2.75,2020,15810,4,9,1620,400,650000
3,1.5,1280,4452,3,6,1280,0,187000
3,1,1310,9554,3,7,960,350,195000
5,3.5,4220,26784,3,10,2110,2110,1.64E+06
3,1,1370,8162,3,6,1370,0,350000
4,2.75,1800,5453,3,7,1050,750,344500
3,1,1690,13184,4,7,1690,0,260000
2,1,1040,7200,4,6,1040,0,687500
4,2.25,3680,26266,4,9,3680,0,425000
3,1.75,2280,139392,3,8,2280,0,413000
4,2.5,2120,15000,4,8,2120,0,637000
4,2.5,1960,7133,3,7,1960,0,369990
3,1,1390,10500,3,6,1390,0,392500
3,2,1270,3090,5,7,1270,0,570000
2,2.25,1460,1851,3,9,1180,280,655000
4,1.5,1890,10707,3,7,1890,0,319990
1,1,720,7540,4,6,720,0,570000
3,1,1060,5000,3,7,1060,0,320000
4,2,2030,4033,4,7,1630,400,435000
4,2.75,3488,9614,3,10,3488,0,815000
3,1,1020,6000,3,5,1020,0,210000
2,1.75,2330,7280,3,7,1450,880,535000
4,2.5,2820,5612,3,9,2820,0,585000
2,1,1680,9250,3,7,860,820,308000
4,3,3280,11060,3,8,2270,1010,580000
3,1,1220,5038,5,6,1220,0,250000
2,2.25,860,696,3,9,860,0,345000
4,4.5,5770,10050,5,9,3160,2610,1.54E+06
3,2,2660,4500,4,7,1330,1330,605000
3,1.5,1460,8505,4,7,1460,0,265000
5,3.25,4475,6642,3,9,4475,0,1.04E+06
3,2.5,1710,1296,3,8,1510,200,416000
3,2.25,1680,9090,4,7,1130,550,480000
3,2.5,2680,5497,3,9,2680,0,699000
4,2.75,3040,2800,3,9,2100,940,840000
2,2,1090,934,3,8,1090,0,427500
5,4,3400,5000,3,8,2320,1080,870000
4,2.5,2760,6850,3,9,2760,0,602500
1,2,1780,188465,3,10,1780,0,316000
4,1,1740,37238,4,7,1740,0,470000
4,2.25,2270,8196,5,7,1150,1120,500000
3,3,3790,5001,3,10,2810,980,1.17E+06
4,1,1120,7104,3,7,1120,0,554000
3,2,1410,5760,3,7,1410,0,245000
3,2.25,2520,212137,3,9,1590,930,620000
3,2.5,1880,12368,4,7,1260,620,565000
3,2,1979,8470,4,7,1329,650,339000
5,2.5,2410,15300,4,8,1400,1010,899100
4,2.25,2330,14190,3,8,1740,590,480000
5,3.25,3570,5425,3,7,3570,0,627000
4,2.25,3200,15367,4,9,3200,0,1.22E+06
5,2,2250,5472,5,7,1750,500,319450
3,1,1790,7055,5,8,1520,270,420000
3,2,1470,4640,4,7,1470,0,640000
4,2.5,2095,4400,5,8,1295,800,711000
2,1.75,1180,904,3,10,780,400,659000
3,2.5,2030,1800,3,9,2030,0,906000
3,2.5,1870,5449,3,8,1870,0,445830
4,3.5,2370,3692,3,8,2370,0,400000
3,1.75,1680,7389,3,8,1150,530,377000
3,1,1000,5454,3,7,1000,0,210000
4,1,1400,8684,3,7,1400,0,185000
4,1.75,2120,5400,4,8,1060,1060,710000
3,1.75,1870,4320,4,7,970,900,680000
3,2.25,1820,9694,3,7,1240,580,415000
1,1,820,1060,3,8,760,60,194000
4,2.5,2460,4862,3,8,2460,0,495000
3,2.75,1310,7300,3,7,1310,0,405000
5,2.75,2910,9480,3,8,2910,0,1.20E+06
3,3.25,1380,1225,3,7,1380,0,322000
3,2,2460,41343,4,8,2460,0,620000
4,2.75,3140,24800,4,8,2080,1060,375000
3,1.75,2080,5200,3,7,1040,1040,350500
2,1,1120,7350,3,7,1120,0,315000
4,2,2490,4600,3,8,2090,400,950000
3,1,1330,40259,4,7,1330,0,535000
4,2.5,2590,11018,3,8,2590,0,346300
4,2.75,2440,7150,3,7,1200,1240,270000
3,2,1880,8494,4,7,1200,680,860000
4,2.5,2290,9120,4,8,2290,0,660000
3,1.75,2360,7291,4,8,1360,1000,615000
4,2,1480,6324,3,7,1480,0,278000
5,2.75,2830,18050,5,7,1630,1200,1.10E+06
5,2.75,3000,25175,4,7,1500,1500,379000
5,3,4180,8561,3,7,4180,0,673200
4,2.5,2780,3969,3,7,2780,0,315000
3,1,1040,4240,4,7,860,180,626000
3,1.75,1150,8079,4,7,1150,0,177000
2,1.5,1290,1749,3,8,660,630,268500
2,1,1010,4000,3,6,1010,0,385000
3,2.25,1860,7200,4,7,1240,620,445000
3,2,1320,10720,3,8,1320,0,393000
3,2.5,2370,6840,3,9,2370,0,300523
3,2.5,1950,7263,3,7,1950,0,409000
4,2.5,1840,13493,3,7,1840,0,190000
6,2.25,2930,15949,4,8,1730,1200,429300
3,2.5,2280,213879,3,8,2280,0,364250
4,3.75,3610,7904,3,11,3290,320,830005
3,2.25,1930,8192,3,7,1470,460,273000
5,1,1670,6400,3,8,1670,0,1.30E+06
3,1.5,1990,5978,4,7,1990,0,625000
4,1.75,2400,7700,4,7,1500,900,389000
4,2.5,2000,10051,3,7,2000,0,320000
6,2.75,2830,10579,4,8,1430,1400,705000
2,1,810,4755,3,7,810,0,155000
3,1.75,1610,11200,3,7,1610,0,450000
3,2.5,2260,3640,3,8,2260,0,496500
3,1.5,1010,9600,4,7,1010,0,160000
4,2.5,3056,11385,3,9,3056,0,524225
4,2.75,2260,5705,3,8,2260,0,359950
4,2.5,2835,6598,3,8,2835,0,522000
3,3,1670,4120,3,7,1140,530,294000
4,1.75,2030,5688,4,9,1730,300,550000
4,2.5,1930,8660,3,7,1120,810,250600
5,3.5,4410,13000,3,10,2920,1490,1.88E+06
5,3.5,5150,12230,3,10,3700,1450,1.38E+06
3,2.25,1450,1540,3,8,1180,270,465000
3,1,1200,9800,4,7,1200,0,374000
3,1.75,3150,9258,3,8,2370,780,450000
3,1,1300,10139,3,7,1300,0,260000
4,3.5,2550,8698,3,7,2550,0,516000
4,2.25,2340,13406,4,9,2340,0,995000
3,1.5,1390,48257,3,6,1390,0,275000
2,1,1550,4600,4,7,1050,500,555000
4,2.5,2920,252648,3,10,2920,0,820000
4,2.5,2060,8451,3,8,2060,0,543000
2,1,1640,5200,4,7,1040,600,515000
4,2.5,2280,9827,3,8,2280,0,649800
3,1,1710,10190,3,6,1310,400,340000
3,2.5,1870,1436,3,7,1870,0,289950
5,2.75,2720,193406,4,7,1700,1020,456000
5,4.5,3100,7260,3,8,3100,0,460000
3,2.25,1900,18000,4,7,1280,620,212000
7,2.25,3260,8145,5,8,3260,0,770000
3,3,4020,435600,3,10,4020,0,1.08E+06
4,2.5,1990,6671,3,7,1990,0,260000
4,3.25,2980,3600,3,9,2150,830,1.63E+06
3,1.75,1410,2052,3,8,1410,0,279800
3,2,1630,8018,3,7,1630,0,260000
4,1,1220,7980,3,6,1220,0,260000
2,2,1070,8400,4,7,1070,0,217500
3,3.5,3030,11550,3,8,3030,0,700000
2,1,1050,9600,4,6,1050,0,198500
4,2.5,2310,5526,3,9,2310,0,651100
4,2.75,2690,9240,3,8,2690,0,346290
3,1,1180,7455,4,7,1180,0,350000
4,1,2100,9200,3,7,1050,1050,211000
5,2.75,2710,6220,3,8,2710,0,450000
4,5.5,6530,871200,3,11,6530,0,1.60E+06
4,2.5,2760,6440,3,10,2760,0,686000
4,2.25,3270,6000,5,8,2180,1090,1.21E+06
3,2.5,1460,1238,3,8,1200,260,436000
3,1,1430,7599,4,6,1010,420,235000
4,1.75,1520,15398,4,7,1370,150,533250
3,2.25,2210,11585,4,7,1510,700,507000
3,1.75,2290,14800,3,8,1620,670,470000
3,2.25,1560,9706,4,7,1560,0,288000
4,2.5,3880,7208,3,10,3880,0,815000
6,2.25,3550,11780,4,8,2960,590,450000
5,3.5,5050,16500,3,11,5050,0,1.03E+06
3,1.75,1360,15210,3,7,1360,0,260000
4,2.5,2920,7901,3,9,2920,0,760000
4,3.75,3790,8797,3,11,3290,500,1.87E+06
3,2.5,1730,3600,3,8,1730,0,328423
2,1.75,1310,10200,4,6,1310,0,306500
4,2,1770,3332,3,7,1630,140,447500
4,2.5,2680,12215,3,9,1590,1090,1.31E+06
5,3.25,3930,5500,3,9,2910,1020,1.74E+06
4,2.5,2170,14024,3,8,2170,0,442500
5,2.75,2760,5000,3,9,2760,0,682000
4,3.25,3580,43093,4,8,3580,0,700000
5,2.5,2500,13034,3,7,1300,1200,323000
4,1.75,1780,5000,5,7,890,890,349950
3,1.75,1730,14270,3,7,1730,0,299000
4,1.75,1460,9750,4,7,1460,0,427000
3,2.5,3680,35617,3,10,2390,1290,770000
3,2.25,2530,27227,3,8,2530,0,450000
4,2.5,2110,3825,3,7,2110,0,324500
2,1,1890,4700,4,7,1030,860,618000
6,1.5,1930,8400,3,7,1030,900,175000
3,1.75,1280,7524,4,7,1280,0,242000
3,2.5,2070,39768,3,8,2070,0,542950
5,5.25,8010,45517,3,12,5990,2020,5.11E+06
2,2.25,1061,2884,3,7,1061,0,223990
2,1,1030,4400,3,7,1030,0,469000
3,1.75,1930,5000,3,9,1230,700,716500
4,2.5,2110,8990,3,8,2110,0,260000
5,2.5,2640,7096,3,7,2640,0,632500
3,1.5,1510,11200,4,8,1510,0,340768
3,1,1230,6380,3,7,1230,0,740000
3,1,890,7110,3,6,890,0,169000
3,1,1450,8820,3,6,1050,400,274950
3,2,2270,11989,4,9,2270,0,815000
3,2,1510,6710,3,7,1070,440,397500
3,2.5,2540,5612,3,9,2540,0,425000
4,2.75,2090,8400,4,8,1240,850,610000
3,2,1410,7998,4,7,1410,0,220000
3,1,940,7200,4,7,940,0,163500
4,2,1780,10622,4,7,900,880,325000
2,1,1040,4590,3,7,1040,0,210000
5,3.25,4020,4500,3,9,3120,900,1.42E+06
3,1.5,1350,7800,3,7,1350,0,275000
3,1.5,1410,9647,3,8,1410,0,367500
1,1,680,6600,3,5,480,200,510000
1,1,1080,3230,3,6,1080,0,112000
4,2.5,2240,9934,4,8,1490,750,650000
4,3.5,5050,9520,3,11,3610,1440,2.32E+06
2,1,1320,1824,4,6,1320,0,395000
3,2.5,1830,7062,3,7,1830,0,275000
2,1.5,1000,5125,3,7,1000,0,488000
4,2,1960,190357,2,8,1960,0,460000
3,2.25,1990,6350,3,7,1990,0,180000
3,2,1830,17321,4,7,1100,730,295000
2,1,900,4800,4,6,780,120,529500
2,2,1460,9052,5,6,1460,0,1.01E+06
3,1.75,2050,9580,3,8,1400,650,540000
2,1,710,5120,3,6,710,0,216000
4,2.5,2370,9517,3,9,1630,740,655000
3,2.5,1700,6000,3,8,1700,0,250000
2,1,700,7457,3,6,700,0,395000
5,2,2190,9072,5,7,1110,1080,600000
3,1.5,2500,4774,3,7,1450,1050,725000
2,1.75,1370,3125,3,7,1090,280,689800
5,3.5,3760,10207,3,10,3150,610,998000
4,1,2240,7620,3,7,1120,1120,242000
4,2.5,2340,5600,3,7,2340,0,535000
3,1.75,1430,9857,4,7,1140,290,390000
3,1.5,1010,5000,3,6,1010,0,194000
4,2.5,4120,14866,3,8,2070,2050,1.85E+06
5,2.5,4600,23250,3,9,3600,1000,2.41E+06
2,1.5,2370,184231,3,11,2370,0,1.06E+06
3,1.75,1470,13068,4,7,1470,0,265953
3,1,1960,9583,2,5,1960,0,180000
2,1.5,1200,1687,3,8,1200,0,504200
4,2.5,2160,4500,3,7,2160,0,359000
4,3.75,3320,8030,3,10,3320,0,802500
4,2,2360,6000,5,7,1260,1100,730000
5,3,2230,8560,3,8,1150,1080,750000
2,1.75,1340,7380,3,6,1340,0,192000
3,1.75,1540,8885,4,7,1440,100,244000
4,2.5,2000,4700,4,7,1220,780,530000
3,1.75,2080,11866,3,8,2080,0,813000
3,1,1150,7156,4,6,1150,0,203000
9,7.5,4050,6504,3,7,4050,0,450000
4,2.5,1850,9136,3,8,1850,0,405000
3,1,1700,8645,3,6,1700,0,149000
3,2.5,2550,45254,3,9,2550,0,695000
3,2.25,2980,7700,3,9,2530,450,1.23E+06
3,2.5,2920,8113,3,8,2920,0,1.09E+06
3,1.75,1650,8400,3,8,1470,180,685000
5,3,3045,5030,3,8,3045,0,414000
3,1.75,1320,9450,5,7,1320,0,338995
3,2,1530,8749,3,7,1530,0,247500
3,2,2220,94300,5,7,1640,580,416000
5,3,4290,20445,4,11,4290,0,2.68E+06
4,1.75,1720,4240,4,7,1460,260,540000
3,1.75,1410,7700,4,7,1410,0,399500
4,2.25,2220,130244,3,8,2220,0,652500
2,1,910,5000,3,7,910,0,520000
3,1,1150,7080,3,7,1150,0,522000
3,2.5,1920,12244,3,7,1920,0,380600
4,1,1720,4410,3,7,1720,0,772500
5,4,3760,22763,4,11,1910,1850,1.38E+06
5,2.5,2840,5000,4,7,1620,1220,739000
3,2.5,1400,4800,3,7,1200,200,340000
2,1,750,4000,2,6,750,0,425000
3,1.75,1390,7700,5,7,1390,0,190000
3,1,1390,9112,4,7,1390,0,745000
3,2.25,2880,7599,3,9,1710,1170,1.54E+06
4,2.5,2110,3825,3,7,2110,0,327000
3,2.5,1730,2631,3,8,1730,0,596000
3,1,940,4200,3,7,940,0,341000
2,2.5,3090,47044,4,10,2250,840,602500
3,3.5,2100,12384,3,9,2100,0,356000
3,3,2110,4000,4,7,1110,1000,565000
3,2,1800,12669,3,7,1800,0,470000
2,1,620,14823,3,6,620,0,325000
4,2.5,2420,7744,3,9,2420,0,600000
2,1,670,6750,4,5,670,0,185000
4,1.75,1820,6600,5,7,1820,0,525000
3,3,1990,9600,3,7,1440,550,245000
4,3,2900,15535,4,7,1870,1030,650000
2,1,1150,6098,3,7,950,200,282000
3,2.25,1940,5980,3,7,1520,420,580000
3,4.5,3950,6134,3,11,2880,1070,1.93E+06
4,2.75,1660,5150,5,7,1280,380,685000
3,3.5,1890,1710,3,8,1640,250,587206
3,1,1180,7210,4,7,1180,0,383001
3,1,1170,7395,4,7,1170,0,255000
2,1,1190,5000,3,7,1190,0,487500
3,1.75,2280,3446,3,8,2280,0,718000
3,1.5,1540,4773,3,8,1540,0,525000
3,2.75,2210,7660,4,7,1460,750,710000
2,1,930,12724,4,6,930,0,230950
4,2.5,3220,5262,3,9,3220,0,825000
4,1,2420,15520,4,7,2420,0,550000
3,1.75,1810,8048,4,7,1290,520,325000
4,2.5,3340,123600,3,10,3340,0,749950
2,1,750,5217,4,6,750,0,135000
2,1,2120,6897,4,7,1060,1060,600000
5,2.75,3030,7000,4,7,1540,1490,321000
3,1.75,1430,8505,4,7,1430,0,225000
2,1,840,5265,5,6,840,0,209000
4,2.5,2100,19680,3,6,2100,0,370000
3,2.5,1780,4320,4,8,1780,0,679000
3,1,1250,7280,3,7,1250,0,405000
3,2.25,1650,7800,3,7,1260,390,385000
4,2.5,3050,32450,4,8,1550,1500,465000
4,2.5,1840,9611,3,7,1840,0,360000
5,2,1680,3240,3,5,840,840,380000
3,1.75,2200,9840,5,8,1500,700,689000
3,2.75,2300,5090,3,8,1700,600,452000
4,1.75,1250,8840,4,7,910,340,293550
2,1,750,4000,4,6,750,0,422000
3,2.5,1660,15000,4,7,1660,0,432000
4,2.75,3400,7081,3,9,3400,0,828200
4,2.75,2560,7961,4,8,1450,1110,880000
3,1.75,2640,8000,4,9,1320,1320,1.03E+06
3,1.5,1630,4080,4,8,1630,0,740000
4,1.5,1550,19800,4,7,1050,500,252000
4,2,1640,7200,5,6,820,820,299999
3,1.5,1480,9606,4,7,1100,380,147000
4,2.5,3050,7238,3,8,3050,0,635000
4,1,1280,10521,3,7,1280,0,199000
2,1,1060,6504,3,6,1060,0,275053
3,2.5,1730,4065,3,8,1730,0,435000
4,2.25,2350,18600,4,9,2350,0,747500
3,2.75,1770,3172,3,8,1770,0,415000
3,2.25,2030,9791,4,8,1500,530,572500
4,3.25,3100,3900,5,9,2090,1010,1.45E+06
4,2.5,2850,12429,3,9,2850,0,750000
3,2.5,2070,25710,5,6,2070,0,312000
3,2.5,1490,2138,3,7,1490,0,237000
4,1.75,2330,4000,5,8,1300,1030,840000
4,1.75,1910,6731,4,7,1210,700,545000
3,2,2590,108900,3,8,1980,610,503000
4,2.5,2230,5500,3,7,2230,0,334950
2,1,820,5700,5,5,820,0,208000
3,1,1360,9310,4,7,1020,340,230000
3,1.75,1250,9605,3,7,1250,0,458500
3,3,3920,13085,4,11,3920,0,3.10E+06
4,2,2350,4815,4,7,1450,900,767500
4,2.5,2560,5428,3,8,2560,0,350000
3,2.5,1970,6295,3,7,1970,0,530000
3,2.5,2320,98445,4,8,1380,940,675000
4,2.75,1910,11356,5,7,1160,750,630100
3,1.5,1260,1270,3,7,1040,220,245000
3,1.5,2510,3600,4,8,2510,0,675000
3,1,1510,4178,3,8,1510,0,799000
3,2.5,2370,4200,3,8,2370,0,351999
4,2.25,2070,20280,4,7,2070,0,495000
4,2.5,3260,5974,3,9,2820,440,1.05E+06
3,1,1160,7854,3,7,1160,0,422000
4,1.75,2320,9240,3,7,1160,1160,324950
4,2.5,3040,6425,3,8,3040,0,776000
5,2,2140,5000,4,7,2020,120,680000
4,2.25,2290,12174,3,7,1490,800,840500
3,2.5,1800,3265,3,8,1800,0,437718
2,2.5,1900,3690,3,8,1900,0,541500
3,2.75,2290,14810,5,7,1400,890,481000
4,2.5,2400,6078,3,8,2400,0,299000
2,1,1800,9236,3,7,1800,0,228000
3,1.5,880,6600,5,6,880,0,253000
3,1,960,6400,4,6,820,140,289500
3,1,1750,7800,4,7,1150,600,329950
4,2.5,2423,7292,3,8,2423,0,290000
4,2.5,2830,5010,3,9,2170,660,738000
5,3.25,4180,49222,4,8,2880,1300,869000
3,1.5,1540,9800,3,7,1010,530,180500
3,2.5,2830,9680,3,10,2830,0,710000
4,2.25,2410,14985,4,7,1950,460,530000
2,1,1040,3600,4,7,1040,0,600000
3,1,840,8470,4,6,840,0,169950
2,2.5,1360,1349,3,8,1050,310,553650
4,1.75,2630,9645,4,9,2630,0,968000
3,2,1770,6610,4,7,960,810,449500
4,2,1650,5974,5,7,860,790,251000
2,1,700,13500,3,4,700,0,152000
2,1,750,4515,3,6,750,0,263500
4,2,1820,9450,3,7,1100,720,330000
1,1,800,533610,5,5,800,0,375000
3,1.75,1980,6250,5,7,1090,890,564000
3,2.5,3160,13603,3,8,3160,0,488000
3,1,1220,8119,4,7,1220,0,875000
3,1,1980,18730,4,7,1280,700,207000
2,1.75,2110,8700,4,9,1760,350,802000
3,2.25,1750,1879,3,8,1750,0,525000
3,2,1130,9879,3,6,1130,0,340000
3,1.75,2020,10031,5,7,1370,650,535000
3,1.5,1860,10379,3,7,1240,620,310000
2,1.75,1990,6549,3,7,1170,820,582500
4,1,1000,7134,3,6,1000,0,239900
3,2.5,2620,78843,4,7,1310,1310,355000
4,1,1590,4280,3,7,1590,0,599000
4,2.5,2840,8820,5,8,1420,1420,814000
4,2,2000,6250,3,7,1480,520,465000
3,2,1700,6498,3,7,1700,0,290000
4,1.5,2020,9583,4,7,2020,0,459000
4,2.5,2680,7700,4,8,2680,0,363500
6,4,2700,7416,3,7,1350,1350,385000
3,1.75,1995,18360,3,7,1995,0,271500
4,2.5,1850,50662,3,8,1430,420,830000
3,1.75,1340,196020,4,7,1340,0,340000
4,3.75,4100,61419,3,9,4100,0,1.35E+06
3,1.75,1860,6000,4,8,1860,0,725000
3,2,1430,7125,4,7,1430,0,465000
3,1,1020,7874,3,7,1020,0,218000
3,2,2550,4794,3,9,2550,0,799000
2,1,910,6000,3,6,910,0,254000
4,1,1770,7345,3,7,1770,0,275000
3,1,840,5525,5,6,840,0,191000
4,2.25,3010,10925,4,9,3010,0,433495
4,3.5,4270,117176,3,9,4270,0,997950
3,2,1200,10212,5,6,1200,0,251000
3,3,2270,5175,3,9,2130,140,640000
3,1,950,4250,5,6,950,0,469000
5,3.25,2950,67475,3,8,2530,420,810000
4,2.5,1950,3720,3,8,1950,0,585000
5,3,4090,12850,4,10,2090,2000,1.10E+06
2,1,1030,6000,2,7,830,200,230005
4,2.5,2500,50595,3,9,2500,0,545000
2,1,1070,5150,4,6,870,200,455000
4,2.5,3691,11088,3,8,3691,0,800000
4,2.75,3510,9400,3,9,3510,0,659950
4,3,1900,9077,3,7,1900,0,459000
3,2,1620,5101,3,7,590,1030,445000
3,2,3120,9400,5,9,1820,1300,855000
4,2.25,2080,12007,4,8,1220,860,442000
5,2.5,2300,7000,3,8,1290,1010,612000
3,3.5,2130,6150,5,8,1530,600,819000
3,2.5,1920,7200,3,10,1780,140,900000
3,1.75,2340,57499,3,8,2340,0,600000
4,2.5,2090,5040,3,9,2090,0,388000
5,2.5,2980,5377,3,9,2980,0,739900
4,2.5,1830,4694,3,7,1830,0,349000
2,1,910,2002,3,6,910,0,600000
3,1,960,10125,4,7,960,0,179950
2,1,1470,5566,4,7,770,700,338000
3,2.5,1280,1845,3,8,1280,0,545000
4,5,6055,21630,4,12,3555,2500,1.76E+06
3,2.5,4010,12105,5,11,2600,1410,1.51E+06
2,1,1080,2674,4,6,720,360,315000
5,2.75,2280,10319,3,8,1300,980,420000
3,2.75,2070,54557,3,8,2070,0,770000
4,2.25,2350,17709,4,9,2350,0,1.62E+06
4,2.25,2210,7665,4,8,2210,0,530000
2,2.25,2160,2578,3,8,2160,0,798750
2,1,1070,20450,2,6,1070,0,95000
3,1,1010,7560,3,6,1010,0,189000
3,1.75,1760,8400,4,8,1460,300,680000
3,1.75,1910,12596,3,7,1340,570,415000
5,2.5,2750,12350,3,8,2750,0,357000
5,2.75,2440,8000,4,7,1240,1200,525000
4,2.25,2900,9680,3,7,1990,910,630000
3,3.5,2514,1559,3,8,2024,490,575000
5,2.25,3650,13068,4,10,1850,1800,1.09E+06
3,2,1770,7000,3,7,1770,0,241000
2,2.5,1680,1240,3,8,1120,560,653500
4,1,1690,3417,3,7,1690,0,540000
6,3.75,5960,20197,3,10,3900,2060,1.14E+06
2,1,720,6686,3,6,720,0,333000
3,2.75,2180,3703,3,8,2180,0,445000
4,2.5,2350,8001,4,8,2350,0,770000
2,1,1210,9400,2,6,1210,0,235000
4,2.5,3210,18901,3,10,3210,0,825000
2,1,940,9839,3,6,940,0,375000
2,1,970,2970,3,7,970,0,425000
2,1.75,1900,13122,3,7,1100,800,869000
3,1.5,1810,18483,3,8,1810,0,520000
4,2.5,2280,7568,4,7,2280,0,433000
2,1.75,1050,2926,4,8,1050,0,187000
3,2.5,1900,3366,3,9,1900,0,545000
4,2.25,1800,14722,3,7,1440,360,160000
4,2.5,3020,6068,3,9,3020,0,613500
3,2.5,2630,5827,3,8,2630,0,610000
4,2.75,2150,9163,3,8,1340,810,320000
4,2,1610,6650,3,7,1610,0,259950
3,2.25,1264,1536,3,8,1264,0,530000
2,2.5,2470,8840,4,8,1780,690,635000
3,1.75,2240,6050,4,8,1250,990,625000
3,2.5,1960,6058,3,8,1960,0,560000
3,2,2160,15788,3,8,2160,0,1.19E+06
2,1.75,2070,23160,3,7,1260,810,577000
4,2.5,2360,81892,3,8,2360,0,445000
4,2.5,2580,3909,3,8,2580,0,899900
3,3.5,1710,2096,3,8,1290,420,557000
3,1.75,2100,6874,3,7,1300,800,580000
3,3.75,2260,2050,3,9,1170,1090,532000
4,4.25,3770,13058,4,8,3770,0,925000
4,1.75,1710,10440,4,7,1710,0,525000
4,3.75,3480,14850,3,9,1870,1610,2.50E+06
3,1,1370,6000,3,7,1370,0,245000
5,4.25,4640,22703,5,8,2860,1780,2.20E+06
3,1.75,2110,10200,4,7,2110,0,305495
3,2,1610,5100,5,8,1610,0,690000
2,2,1460,1085,3,8,950,510,699999
2,1,1130,3800,4,7,1130,0,485000
4,1.75,1740,7208,3,8,1740,0,329950
4,2.75,3670,15400,4,10,3670,0,1.22E+06
4,2.5,2260,5824,3,8,2260,0,379000
4,2.5,3300,10514,3,10,3300,0,785000
3,1,1300,14000,4,7,1300,0,230000
4,2.25,2040,9565,3,8,1400,640,450000
3,1.5,1390,11340,4,7,1390,0,232000
3,2,1640,7333,4,7,1020,620,560000
2,1,1010,7500,3,7,1010,0,235000
3,2.25,2220,12056,3,8,2220,0,542000
3,3.25,2240,5000,3,9,1540,700,279900
4,2.25,2690,36114,4,9,2690,0,460000
3,2.5,2560,43608,3,9,2560,0,619000
2,1,710,14000,4,6,710,0,239000
4,1.75,1790,11875,4,7,1490,300,410000
3,1.75,1680,9769,3,8,1340,340,265000
4,1.75,1990,7194,4,8,1400,590,328000
4,2.25,2330,8994,3,8,2330,0,639500
4,2.5,2050,6360,3,8,2050,0,530000
3,1.75,4000,11894,3,9,2190,1810,628000
3,2.25,1500,7615,3,7,1150,350,219950
4,2.5,2800,12831,3,8,2800,0,563500
5,2.25,3580,16789,5,9,3580,0,1.41E+06
4,1.5,1370,9750,3,7,1070,300,296000
3,1,1180,6050,3,6,820,360,194000
4,1.75,1990,18900,4,7,1870,120,290000
3,2.25,1530,1396,3,8,1240,290,500000
3,2.25,1850,7480,3,7,1850,0,279950
6,3,4250,4400,4,7,3020,1230,665000
4,2.75,3710,7984,3,9,3710,0,692500
4,2.5,2233,6025,3,7,2233,0,317500
3,1.75,2020,9478,4,9,2020,0,740000
4,2.5,2900,5760,4,8,1660,1240,500000
3,2.25,3530,17450,3,9,1840,1690,2.37E+06
3,2.5,2780,32880,3,9,2780,0,560000
3,2.5,2110,7434,4,7,2110,0,319000
4,3.5,4540,19767,3,11,4200,340,1.15E+06
3,1.75,2120,9350,3,7,1280,840,428000
3,2,1410,10078,4,6,1410,0,375000
2,2,2100,58488,3,9,2100,0,370000
3,2,1760,9900,4,7,1760,0,229000
3,1,1580,5250,5,7,1580,0,299950
4,1.5,1280,8000,3,6,1280,0,245000
4,2.5,2410,4780,3,7,2410,0,440000
3,2,3660,22410,4,9,1830,1830,1.20E+06
2,1.5,1120,17487,3,6,1120,0,188000
3,1.75,1630,8400,4,7,1060,570,499990
4,2.5,3630,42884,3,9,2300,1330,400000
2,1,800,7260,3,7,800,0,325000
2,2.25,1600,80400,4,7,1600,0,492500
3,1.5,1800,8303,3,7,1200,600,442500
3,1.75,2320,10900,3,7,2320,0,737500
5,3.75,4960,13990,3,11,3760,1200,1.36E+06
3,2.5,1580,4698,3,7,1580,0,325000
2,1,780,8271,4,6,780,0,319000
3,2.5,2850,11535,3,8,1680,1170,900000
3,1,1350,7973,3,7,1350,0,272450
4,2.5,2680,5539,3,8,2680,0,502000
4,1.75,2100,7135,4,7,1050,1050,384000
2,1,790,14200,3,7,790,0,198000
5,2.75,1650,5453,3,7,1650,0,183750
3,2.75,1560,77536,3,7,1400,160,500000
2,1,960,4000,3,6,960,0,290000
5,2.75,2910,53898,5,7,1510,1400,600000
3,1,1250,9427,3,6,1250,0,294000
3,3.5,3600,37982,4,8,3600,0,660000
4,3,2400,3340,4,7,1200,1200,675000
4,2.5,2040,8265,3,7,2040,0,355000
4,3,2550,5300,3,8,1720,830,855000
5,2,2030,9804,3,7,1110,920,472000
5,2.25,2410,12000,4,8,2410,0,648000
4,2.5,3360,22111,3,10,3360,0,879000
4,2.5,3310,42998,3,9,3310,0,838000
3,1.75,1440,8050,3,8,1440,0,258950
4,2.5,2960,5054,3,9,2960,0,385000
4,2.5,2150,10098,3,7,1090,1060,414999
4,2.75,2920,6605,3,8,2920,0,625000
4,2.25,2200,7200,4,8,1220,980,610000
4,2,1650,5000,3,7,1650,0,575000
3,2.5,1970,8727,3,7,1970,0,262000
2,1.5,1220,8409,4,6,1220,0,317500
6,3.25,2120,6893,4,7,1060,1060,330000
3,2.5,1700,4125,3,7,1700,0,403000
4,1.75,1660,10757,3,7,1000,660,385000
4,2.5,2060,10125,4,7,1560,500,435000
3,1.5,1400,10853,4,7,1400,0,264950
3,2.25,2800,35362,3,9,2800,0,408000
3,1,1020,5500,3,7,1020,0,180000
4,2.75,2980,42253,4,9,1860,1120,949000
3,1.5,2480,9900,3,10,2130,350,1.47E+06
2,1.5,1000,1075,3,7,840,160,303000
2,1.75,2330,10143,4,7,1220,1110,689000
3,1,1520,9030,3,7,1520,0,415000
3,2.5,1852,4000,3,7,1852,0,298900
5,2,2110,7919,3,7,1110,1000,280000
2,1,700,5829,3,6,700,0,340000
5,3,3110,12429,3,8,1790,1320,436500
4,2.5,2570,7173,3,8,2570,0,719000
4,3,2530,5625,3,8,1470,1060,625000
4,1.75,2190,11625,4,8,2020,170,450000
3,1,980,4800,3,7,980,0,425000
3,1,890,7200,3,7,890,0,371000
2,2,1870,5580,3,8,1870,0,554000
4,2.25,2580,21115,4,9,2580,0,787888
2,1,800,4533,3,6,600,200,330000
3,1.75,1890,10661,5,7,1460,430,315000
4,2,1720,7210,3,7,860,860,350000
2,1,950,7560,3,6,950,0,230000
4,2.5,1900,9428,3,8,1900,0,375000
3,2.25,1840,10500,3,7,1840,0,481500
5,2.5,2870,16238,4,8,2870,0,1.56E+06
3,2.5,1460,4961,4,8,1150,310,475000
3,2.25,2440,9689,4,8,1830,610,954500
3,1.75,1610,38707,3,7,1610,0,319502
4,3.25,3830,10005,3,10,3830,0,860000
4,3.5,2630,3757,3,10,2200,430,749950
5,1.5,1830,94960,3,7,1830,0,220000
3,1.75,2220,132858,3,7,1110,1110,435000
4,1.75,1940,8990,4,8,1560,380,545000
3,1.75,1400,10350,4,7,1400,0,305000
3,2,1340,7200,4,7,1340,0,545000
4,2.5,2170,8518,3,7,1350,820,415000
3,1,1140,7028,3,8,1140,0,560000
2,1,1270,8164,4,6,1270,0,390000
5,2.5,2270,6300,3,8,2270,0,285000
4,2.5,1700,7280,4,7,1700,0,290000
4,2,2410,8712,3,7,1260,1150,446800
3,3,3250,5093,3,10,3250,0,1.05E+06
3,2.5,1510,10875,3,7,1150,360,247000
6,2.75,3610,17580,5,9,2070,1540,968000
3,2.5,2710,6174,3,9,2710,0,564450
3,2,1760,5000,5,7,960,800,629000
2,1,960,112384,3,7,960,0,420000
2,2.5,1380,951,3,9,1380,0,552000
3,2.25,2200,7355,4,8,2200,0,637000
1,1,1220,4160,3,7,1220,0,655100
5,4.25,3920,5823,3,9,3000,920,827500
4,2.5,3280,5232,3,7,3280,0,671300
4,3,5370,69848,3,10,3500,1870,790000
4,2.5,1610,4052,3,7,1610,0,286950
4,1.75,1690,10854,3,7,1690,0,371000
3,1.5,1650,3150,4,8,1650,0,622000
2,1,900,5016,3,6,900,0,243500
3,1,1180,5002,3,7,1180,0,220000
3,2.5,2810,6300,3,8,2810,0,725000
4,2.5,2500,7417,3,9,2500,0,640000
3,1.75,1570,2600,4,8,1570,0,580000
3,1.75,1690,8489,4,7,1690,0,725000
3,2.5,1370,1911,3,9,1370,0,797000
3,1,1660,21514,4,7,1660,0,220000
4,3,3110,7231,3,8,3110,0,367500
4,1.5,1820,22814,3,7,1820,0,229000
3,1,1210,6000,3,7,1210,0,235000
5,3.5,3480,12821,3,10,2890,590,480000
4,3,1940,8170,4,7,1940,0,265000
3,2.5,1810,1585,3,7,1810,0,579950
4,3.5,3950,9600,3,10,3950,0,860000
3,2.5,1300,3612,3,7,1300,0,310000
4,2.25,3010,9800,4,9,3010,0,980000
4,2.5,2080,8504,3,8,2080,0,545000
1,0.75,480,9750,2,4,480,0,145000
3,2.5,2230,5750,3,9,2230,0,1.04E+06
3,1.75,2050,11041,5,9,2050,0,745000
6,3,2880,7560,3,7,2880,0,525000
3,2.5,1570,1452,3,9,1240,330,547000
3,2.5,2770,98881,3,9,2770,0,475000
4,2.25,2510,31584,4,9,2510,0,605000
5,3,2360,5000,3,7,1390,970,504600
3,1.5,1570,12412,3,8,1570,0,425000
3,2.75,2230,14400,4,8,1460,770,550000
5,2.5,1710,7700,3,7,1710,0,431650
3,3.25,1480,983,3,8,1180,300,312500
3,1.75,2130,7140,3,8,1580,550,310000
3,2.5,1870,4657,3,8,1870,0,330000
2,1.5,1180,1034,3,7,1120,60,410000
2,2.25,1280,2574,3,7,1280,0,364000
3,2.5,1400,3368,3,7,1400,0,265000
3,2.25,2750,6203,5,7,1620,1130,1.65E+06
2,1.5,1440,725,3,8,1100,340,427000
3,2.5,2313,5700,3,9,2313,0,370000
6,3.25,3870,24700,3,10,2520,1350,1.13E+06
3,2.5,1990,8991,3,7,1570,420,256750
3,2,1710,8910,5,7,1710,0,390000
5,3.5,2738,6031,3,8,2738,0,395950
3,2.5,2044,5610,4,9,2044,0,1.00E+06
3,1,1310,9612,3,7,960,350,150000
3,2.5,2690,8577,3,9,2690,0,340000
1,1.5,1170,1456,3,8,1070,100,235000
4,2.5,1970,6600,3,7,1970,0,274900
2,1,1140,15624,4,6,1140,0,365500
5,3,3620,12778,5,8,1900,1720,858000
4,2.5,3560,13981,3,10,3560,0,865000
2,1,1150,12861,3,6,1150,0,280000
4,2.5,3140,7260,3,8,2200,940,744000
3,1.75,2380,10450,3,8,2380,0,315000
3,2.25,2100,205603,3,8,2100,0,437500
2,1,1060,8000,3,6,1060,0,205000
2,1,950,5316,3,7,950,0,320000
2,1,1270,19602,3,6,1270,0,260000
4,4.5,3420,7440,3,9,3420,0,1.35E+06
4,1.75,1450,8450,3,7,1450,0,362500
3,3.25,4110,20900,3,9,2630,1480,925000
3,2.5,3230,5000,5,8,2430,800,850000
6,4.5,4520,40164,3,9,3580,940,550000
6,3,2480,9720,3,8,2480,0,665000
5,2.5,2880,6902,3,8,1680,1200,360000
3,1,960,8100,3,7,960,0,299000
3,2.5,2570,10431,3,9,2570,0,399950
4,3,2600,29539,3,8,2600,0,610000
2,1.5,830,1020,3,7,830,0,205000
3,2.25,1290,2500,4,8,1290,0,605000
3,1.5,1010,7683,5,7,1010,0,405000
3,1.5,1072,4339,3,7,1072,0,250000
0,0,1470,979,3,8,1470,0,380000
3,2.5,2010,5399,3,7,2010,0,282000
3,2.5,2480,6180,3,9,2480,0,420000
4,2.5,1767,4500,3,8,1767,0,205000
3,1,1380,12000,3,7,1380,0,300000
4,3.5,3500,8547,3,9,2500,1000,799000
5,1.75,1960,7875,4,7,1960,0,434400
3,2,1550,27003,3,8,1550,0,537000
3,1,880,10800,3,6,880,0,210000
4,2.5,1860,6687,4,7,1220,640,288400
4,2.5,2180,7204,3,8,2180,0,734000
3,1.5,1660,8797,4,7,1660,0,712500
2,1.5,1220,3568,4,8,1220,0,168000
4,2.75,2180,8480,4,7,1210,970,545000
3,2.5,2930,19900,3,9,2930,0,645000
3,2.5,1320,3150,3,7,1320,0,299950
4,2.25,1810,4970,3,7,1810,0,355000
4,4,4260,11765,3,11,3280,980,3.40E+06
4,2.5,2150,6807,4,8,2150,0,316500
2,2.5,1900,2983,3,8,1900,0,530000
2,2.25,1660,2128,4,8,1660,0,410000
4,1.75,1710,8947,4,7,1710,0,571900
3,1.5,1330,1265,3,8,1140,190,500000
4,1.75,2630,11213,4,8,1430,1200,567000
3,2.5,1450,8064,3,8,1450,0,400000
3,1.75,1250,5546,4,7,1250,0,268000
6,2.5,3250,12000,3,8,1800,1450,779000
4,2.75,3190,5408,3,9,3190,0,722000
3,2.5,1520,3041,3,7,1520,0,333000
3,2.5,2250,3757,3,7,2250,0,395000
3,1,1180,7573,4,7,1180,0,355000
4,3,3680,7105,3,10,2890,790,935000
4,2.5,1890,4158,3,8,1890,0,311850
3,1.5,1770,17208,3,8,1160,610,450000
3,2.75,2120,7650,4,7,2120,0,370000
3,2.25,1470,6808,3,7,1160,310,225000
3,2.75,2000,7200,3,7,1000,1000,433000
6,4.25,4310,10000,3,8,2950,1360,780000
4,1.75,2020,9750,3,7,1100,920,390000
3,1.5,1430,5200,4,7,1030,400,195000
2,2,1170,8251,3,7,1170,0,393820
4,2.5,3002,6042,3,8,3002,0,394500
3,2,1470,1691,3,8,1000,470,540000
2,1.75,1620,3640,3,7,900,720,355000
4,2.5,2080,4080,5,7,1040,1040,550000
2,1,970,8185,5,6,970,0,204995
4,2.25,2120,53578,4,7,2120,0,379500
3,1,1420,8800,4,6,1090,330,248000
3,1,1210,9525,3,7,1210,0,299950
4,1.75,2670,189486,3,8,2670,0,400000
5,3.5,3280,4000,3,9,2440,840,989000
5,4.5,3732,4426,3,10,2932,800,1.23E+06
2,1.5,2340,13380,4,7,1280,1060,545000
4,3.75,5090,14823,3,11,4180,910,3.00E+06
3,1,770,9750,3,6,770,0,156000
2,1.75,1700,3618,3,8,1260,440,895000
2,2,1420,9191,5,7,1420,0,592500
4,1.5,2040,6900,3,9,2040,0,825000
3,2,1980,6000,4,7,1380,600,637000
3,2.25,1960,1985,3,7,1750,210,330000
4,1,1290,6034,3,6,1050,240,265000
5,1.75,2510,6000,5,8,2010,500,860000
3,1,1820,5750,3,7,1120,700,532000
3,2.25,1450,1387,3,8,1450,0,497000
3,2.25,1990,4977,3,9,1990,0,715000
6,3.5,3670,3959,3,10,2410,1260,1.50E+06
4,2.5,2050,8424,4,8,2050,0,320000
4,3,2580,209523,3,8,2580,0,799000
3,1.75,1380,9134,5,7,880,500,365000
3,2,1760,43575,3,7,1160,600,322000
5,2.75,3050,8904,4,8,1650,1400,1.04E+06
3,2.5,3120,12406,3,9,1940,1180,850000
4,2.75,2260,7209,3,7,1330,930,500000
2,1,670,2356,5,6,670,0,245000
3,1.75,1080,1306,3,7,580,500,331000
4,1,1210,6380,3,7,1210,0,485000
6,2,2610,9132,4,8,1320,1290,605000
4,2.5,2905,4874,3,9,2905,0,365000
3,1.75,1840,4255,3,7,940,900,645000
4,2.5,2450,6941,3,7,2450,0,340000
4,2.25,3040,5000,4,9,2080,960,1.74E+06
6,4.5,4000,7500,3,7,4000,0,739000
5,2.5,1940,9389,4,7,1290,650,299000
3,1.75,1830,17349,3,8,1230,600,365000
2,1.5,1000,1188,3,8,1000,0,424950
2,1,780,1133,3,7,780,0,370000
3,3,2410,12183,3,9,2410,0,555000
2,1,840,3522,3,6,840,0,405100
2,2,1510,4000,4,7,1010,500,595000
3,2.5,2080,16050,5,8,1360,720,418000
4,3,2050,4000,3,8,2050,0,353500
3,2.5,1900,3255,3,8,1900,0,550000
4,2.75,1970,7213,3,8,1170,800,323000
4,2.5,1800,7620,3,8,1800,0,349000
3,1,940,9272,3,7,940,0,225000
3,2.25,1690,7320,3,7,1690,0,292500
3,2.5,3800,13071,3,10,2730,1070,450000
3,2,1630,6550,5,7,850,780,464000
3,2.25,2370,10890,4,7,2370,0,943500
4,2.75,3600,5040,3,9,2610,990,970000
3,2,2000,3207,4,7,1100,900,677000
4,1.75,2080,8215,4,7,2080,0,385000
2,2.5,2910,19449,5,9,1940,970,1.30E+06
4,1.75,1790,11801,4,8,1790,0,393000
2,1,960,3235,4,7,960,0,432000
4,2.25,2220,36085,3,9,2220,0,625000
4,1.75,1280,6060,3,7,860,420,575000
6,2,2500,5200,3,8,1250,1250,415000
3,1,1260,24550,4,7,1260,0,665000
4,1.75,2420,8400,5,7,1620,800,350000
5,2.25,2130,4360,3,8,1240,890,565000
4,2.5,2480,91911,4,7,1470,1010,495000
4,2.75,3130,21810,4,10,3130,0,840000
5,2.5,3200,7863,5,8,1600,1600,1.31E+06
2,2.25,1640,2128,4,8,1640,0,409000
5,4,3600,14720,5,8,1800,1800,835000
3,1.75,1370,8006,3,7,1370,0,160000
4,1,1460,6000,4,7,730,730,239950
3,3,3110,9015,4,10,1590,1520,1.50E+06
2,1,780,5000,4,6,780,0,285000
3,2,1130,16875,4,7,1130,0,349500
4,2.5,2600,8921,3,8,2600,0,392000
5,2.5,4670,15857,3,11,4670,0,1.00E+06
2,1.75,1000,1760,4,6,600,400,453500
3,2.5,1840,5680,3,7,1840,0,435000
4,4.5,5120,41327,3,10,3290,1830,1.24E+06
4,2,1640,5014,4,7,930,710,377000
3,3.25,4560,13363,3,11,2760,1800,3.20E+06
4,2.5,1630,4473,3,7,1630,0,312900
3,2.5,1600,7829,3,7,1600,0,455000
5,3.5,2790,16952,3,10,1970,820,738000
3,2,1860,5146,3,8,1860,0,477500
3,1,1470,8400,4,7,1470,0,352500
3,2.5,2120,196995,3,9,2120,0,645000
3,2,1640,3440,3,7,1640,0,408000
2,1,1150,3000,3,6,780,370,441000
3,2.75,2015,16807,3,9,2015,0,988500
4,1.5,1780,8000,4,6,1080,700,200000
4,2.5,3200,7535,3,9,3200,0,1.26E+06
3,2,2930,29136,3,8,2240,690,460000
5,4.75,5410,13431,4,10,5050,360,2.54E+06
4,2.25,2130,8078,4,7,1380,750,311100
3,1.75,1620,3975,5,7,940,680,641000
4,2.5,1950,5602,5,7,1120,830,428000
3,2.5,2070,8337,3,8,2070,0,325000
3,2.5,1930,7120,4,7,1420,510,432500
3,2.75,1360,542322,4,7,1140,220,425000
4,2.5,3230,7187,3,9,3230,0,570000
4,2.5,1630,3060,3,7,1630,0,236000
2,1,1410,5101,3,8,1410,0,658500
3,1.75,1340,6300,3,7,1340,0,354000
3,2.25,2060,7080,3,9,1800,260,978500
5,2.75,3090,19865,4,9,3090,0,1.45E+06
3,2.25,2220,3707,4,8,1620,600,850000
3,2.5,2060,7020,4,8,1460,600,420000
3,1,1430,19901,4,7,1430,0,310000
3,1.75,1660,11500,3,7,1130,530,305000
4,2.5,2080,17532,3,9,2080,0,460000
3,1.75,1720,9342,4,7,1140,580,245000
2,1.5,1110,3600,5,7,1110,0,750000
2,1,1210,4800,3,8,1060,150,380000
3,1.5,1320,7695,4,7,1320,0,275000
3,1.5,1980,5800,4,8,1520,460,759000
3,3.5,3950,111078,3,9,2460,1490,784000
3,2.75,1730,4131,3,7,1480,250,260000
2,1.5,1090,4013,3,7,1090,0,430000
3,1,1270,7500,3,6,1270,0,196900
3,1,940,10368,3,7,940,0,354000
4,2.5,2100,7366,3,8,2100,0,333000
1,1,1390,60984,3,6,1390,0,400000
3,1,1310,18135,3,7,1310,0,553000
3,2.5,2010,3667,3,9,2010,0,605000
3,1.75,1990,5560,4,7,1100,890,763101
2,1,1140,5500,3,6,1140,0,249900
2,1,580,7500,3,5,580,0,90000
4,2.5,2650,13684,3,9,2650,0,728000
4,1.75,1970,10358,3,8,1540,430,385000
3,2.5,2870,5490,3,9,2870,0,485000
5,3,3610,9775,3,8,3610,0,540000
3,1.75,1270,7700,4,7,1270,0,455000
3,2.25,2080,111513,3,8,1680,400,450000
4,2,2020,6867,5,8,1010,1010,625000
6,1.5,2550,33740,4,8,1750,800,375900
4,1.75,1250,12705,4,7,1250,0,212000
2,1.5,1480,15641,4,7,1480,0,280000
4,2.5,2650,25248,3,9,2330,320,685000
3,2.5,2110,3600,3,9,2110,0,638000
4,5.5,5060,10320,3,11,5060,0,2.15E+06
3,2.5,1120,1100,3,8,820,300,425000
4,2.25,2330,10451,4,8,2330,0,850000
3,2.25,1445,1606,3,7,1300,145,387000
2,1,940,5000,4,7,940,0,352000
3,1,1650,5102,4,8,1300,350,665000
4,2,2850,14810,5,8,2490,360,993000
5,2.5,1980,10205,4,7,1080,900,418000
3,2.25,1530,1305,3,7,1116,414,380000
4,2.5,2170,9600,3,7,1460,710,550000
4,2.5,3190,10034,3,9,3190,0,925000
4,1,1560,8450,4,6,1560,0,305000
3,1,1010,7838,4,6,1010,0,316000
3,3,2500,6000,3,8,2500,0,432500
3,1.5,1200,9720,4,7,1200,0,242500
3,1.75,1640,47044,3,7,1640,0,500000
2,1.5,1150,7552,3,7,1150,0,350000
4,3.5,3930,5680,3,9,2820,1110,828950
4,2,2600,4800,3,8,1400,1200,780000
3,1,980,3090,3,6,980,0,197500
3,1,1130,12212,3,6,1130,0,126500
3,2.5,1910,5600,3,8,1910,0,498688
3,2.5,2420,43177,4,8,1690,730,739888
4,2.5,1740,7500,4,7,1220,520,518000
3,2.5,3050,158558,4,9,3050,0,555000
3,1,1320,8625,4,7,1320,0,259000
4,2.5,2660,10800,3,7,2660,0,772650
3,1.75,1430,8865,3,7,1430,0,330000
3,2.5,1690,3026,3,7,1690,0,461000
2,2,1610,6160,4,8,1610,0,450000
4,1,1510,7200,4,7,1510,0,350000
3,1.5,1570,12196,4,7,1570,0,458000
3,2.25,1640,11050,4,8,1640,0,352000
3,1,990,7590,3,6,990,0,354000
3,1.75,1470,6250,4,7,1070,400,432000
4,2.5,1950,3225,3,7,1950,0,315000
4,2,2310,5004,3,7,1430,880,440000
4,3.75,4410,9231,3,11,4410,0,1.44E+06
3,3.25,1370,1227,3,8,1370,0,375000
2,1.75,1680,8187,4,8,1680,0,620000
4,2.5,2540,11100,5,7,2540,0,630000
3,1.75,1380,7350,3,7,990,390,195000
3,2,1440,7210,3,8,1440,0,210000
4,1.75,2740,10086,3,7,1440,1300,350000
3,2.25,2000,217800,3,8,2000,0,540000
4,3,3600,9200,4,9,2100,1500,1.08E+06
3,1.75,1270,4800,3,7,1270,0,415000
4,2.5,3100,7250,3,9,3100,0,967000
3,2.25,1800,6875,4,8,1230,570,567000
3,2.5,1770,3993,3,8,1770,0,420000
4,2.5,2500,8282,3,9,2500,0,620000
3,1.5,1390,7417,3,7,1390,0,162500
3,1.75,1510,10248,3,7,1510,0,240000
4,4,2740,8250,4,9,2740,0,415000
3,2.25,1900,3960,3,8,1200,700,580000
3,1,1280,10000,4,7,1280,0,473000
3,2.25,2160,7500,3,10,2160,0,1.01E+06
3,2.5,2400,6474,3,8,1560,840,660000
2,1,860,3880,4,6,860,0,420000
3,3,1430,1249,3,8,1430,0,335000
4,2.75,3100,7501,3,10,3100,0,795000
4,2.25,2840,20242,3,8,2240,600,1.15E+06
4,1.75,1620,4980,4,7,860,760,385000
3,1.5,1200,8404,3,7,1200,0,219950
4,2,2180,8800,5,7,1170,1010,254950
3,1.75,2260,8512,3,7,1130,1130,467500
3,1,1060,7900,3,7,1060,0,215000
3,2.25,2300,7200,4,8,1550,750,287000
3,2.5,1990,9995,3,7,1990,0,330000
3,1.5,1620,7500,4,8,1620,0,780000
4,2.5,2980,12075,3,8,1910,1070,495000
3,1.75,2000,11880,3,8,2000,0,440000
2,2,1510,5133,3,7,1510,0,535000
3,1,1890,36300,3,7,1890,0,355000
3,1.75,1980,3300,4,7,1140,840,660000
4,3.25,3330,33826,5,8,3330,0,911100
4,2.25,2510,9800,3,9,2510,0,541100
4,2.25,2370,9636,3,8,1660,710,670000
3,2,1380,15426,4,7,1380,0,406430
3,2.5,2350,3798,3,8,2350,0,740000
2,1,720,8914,3,6,720,0,179000
4,1,1390,18000,3,7,1390,0,234000
3,2.5,1920,1896,3,8,1920,0,781000
2,1,780,6380,3,6,780,0,165000
3,1.75,1670,11452,3,8,1670,0,245000
4,1.75,2860,48351,3,8,1710,1150,530000
2,1,660,6509,4,5,660,0,227450
5,2.5,2640,4400,5,7,1840,800,593000
5,2.75,2770,6116,3,7,1490,1280,283450
4,2.5,2580,15031,3,9,2580,0,700000
2,1,840,5000,4,7,840,0,457500
4,1,1720,4011,4,7,1720,0,500000
3,3.25,1460,1367,3,8,1460,0,602000
2,2.5,2290,3507,3,9,2290,0,630000
3,1.5,1120,7000,3,7,1120,0,395300
3,1,1860,6360,3,8,1470,390,460000
3,2.5,2680,17707,3,9,2680,0,608095
4,2.5,2160,5455,3,7,2160,0,340000
5,2.75,3260,11700,3,8,1630,1630,681500
4,3.5,3670,4960,3,9,2870,800,796000
2,2.5,2720,4913,4,8,1700,1020,875000
4,1.75,2130,8151,4,7,1330,800,285000
4,1,1130,7400,4,7,1130,0,215000
4,2.25,3060,48787,3,8,3060,0,415000
4,2.5,2800,9538,3,8,2800,0,350000
4,1.5,1420,8063,3,7,940,480,205000
4,2.75,2830,7334,3,8,2830,0,540000
5,2.25,3120,16672,4,9,3120,0,1.94E+06
3,1.75,1460,7800,2,7,1040,420,233000
3,2.5,2540,40106,3,10,2540,0,510000
4,3.25,3580,19989,4,7,3480,100,2.05E+06
3,2.5,2890,7027,3,8,2890,0,715000
5,3.25,4410,58157,4,9,2330,2080,600000
4,2.25,1600,7916,3,7,1600,0,280000
5,1,1840,6710,3,7,1840,0,590000
4,2.5,1820,6753,3,7,1820,0,322500
3,2.5,2060,4200,3,8,2060,0,339989
4,2.5,2720,10000,3,10,2720,0,665000
5,3,2540,11422,3,8,1270,1270,620000
3,2.5,1470,4675,3,7,1470,0,339900
4,2.5,2300,3825,3,7,2300,0,320000
4,2,1540,3740,4,7,770,770,525000
3,2.5,2370,6752,3,8,2370,0,310000
4,1,1360,6000,3,7,1360,0,511500
3,1,1620,30736,4,7,1620,0,428750
4,2.5,2620,11200,4,8,1770,850,1.03E+06
5,4,4580,4443,3,10,4580,0,2.00E+06
4,1.5,1730,10396,3,7,1730,0,302200
2,1.75,1720,5785,3,6,860,860,664000
4,3,2370,8154,3,7,1380,990,522500
4,2,2930,12840,4,8,2930,0,294000
3,2,1540,67756,3,7,1540,0,450000
3,2.5,2780,5467,3,9,2780,0,775000
3,1,1200,9527,3,7,1200,0,150000
3,1.75,1290,7205,3,7,1290,0,365000
6,2.75,3280,16449,4,7,1910,1370,730000
3,2.5,2340,10005,4,8,1460,880,375000
1,1,390,2000,4,6,390,0,245000
4,2,2710,4750,4,7,1460,1250,656500
3,2.5,2180,4226,3,8,2180,0,450000
3,1.5,1340,1110,3,7,1040,300,360000
3,2.5,2410,4656,3,7,2410,0,480000
3,1.75,1680,7455,4,8,1680,0,227000
3,2.5,3090,20785,4,10,3090,0,891500
4,3.25,3120,5000,3,9,2370,750,799000
4,2.75,1810,7350,4,7,1200,610,272000
3,1,1150,8924,3,6,1150,0,175000
3,2.5,1560,2740,3,8,1560,0,292000
4,2.25,2110,10698,4,8,2110,0,565000
3,2.5,2375,4094,3,9,2375,0,712000
4,2.5,3650,8354,3,9,1830,1820,2.40E+06
4,3.25,4670,51836,4,12,4670,0,1.58E+06
3,2.5,1580,991,3,9,1580,0,727000
3,1.75,1550,9720,3,7,1050,500,255000
3,2.5,1300,1590,3,8,1100,200,675000
4,2.25,2390,13002,3,8,2390,0,350000
5,3.25,4290,7019,4,10,3590,700,1.16E+06
3,2.25,1190,1137,3,7,960,230,475000
2,1,970,4800,3,6,970,0,313300
2,1,1010,11919,3,6,1010,0,300000
3,1.75,1250,8084,4,7,1250,0,209000
3,2.5,1769,7324,3,9,1769,0,334888
2,2.25,1630,1686,3,10,1330,300,729999
4,3.5,4140,7089,3,10,3160,980,850000
2,1,790,5150,4,6,790,0,342888
3,2,1860,12944,3,9,1860,0,400000
4,2.25,2080,7526,4,7,1280,800,231500
2,1,840,7020,4,7,840,0,450600
4,2.25,1900,10950,4,7,1400,500,290000
3,2.5,1920,7415,3,7,1920,0,260000
4,2.5,3270,6055,3,9,3270,0,725000
5,3,5530,38816,3,10,5530,0,1.35E+06
4,2.5,3190,24170,3,10,3190,0,807500
3,2.5,1520,3003,3,7,1520,0,330000
6,1,1430,20620,3,7,1430,0,800000
3,2,1230,11502,4,7,1230,0,475000
3,1.75,2410,8944,4,8,1860,550,415000
2,1,1150,8138,3,7,1150,0,332000
3,2.5,2300,18540,3,8,1800,500,579000
3,2,1550,12262,4,7,1550,0,725000
3,2.5,2410,64073,4,8,1820,590,625000
2,2.5,2830,8630,3,10,2830,0,795000
3,1,1250,8412,4,7,1250,0,440000
4,2.5,3670,7000,3,10,3670,0,820000
3,2.5,2014,4500,3,7,2014,0,321000
3,2.5,1608,4800,3,8,1608,0,279950
2,1,720,4760,5,5,720,0,217000
2,1,1080,3600,3,7,1080,0,429000
5,2.5,3290,5029,3,8,3290,0,739900
3,2.5,1590,3480,3,7,1590,0,320000
3,2.5,1730,3600,3,8,1730,0,329780
6,3.75,2770,5000,3,8,1870,900,890000
4,1.5,1620,5444,3,8,1620,0,451000
4,2.5,1780,11130,5,8,1780,0,800500
4,3.5,4680,9700,3,10,3360,1320,1.16E+06
5,1.75,1940,6654,4,7,1940,0,390000
5,2.5,2400,4496,3,7,2400,0,338000
5,3.25,3340,9075,3,8,2600,740,690000
3,2,1520,5040,3,7,1520,0,434900
5,1,1940,8875,3,7,1940,0,300000
5,2.5,2040,9597,4,7,1240,800,480000
3,1.75,1660,16275,3,7,1660,0,342000
3,1,1010,8863,4,6,1010,0,180000
3,2.5,2110,4099,3,8,2110,0,548000
2,1,770,2191,3,6,770,0,252500
3,2.25,1900,7479,4,7,1900,0,316000
3,1,1090,6125,4,6,790,300,392000
4,1.75,1700,10642,4,7,850,850,437000
5,2.25,2020,8400,4,7,1010,1010,750000
4,2.5,2790,8111,3,9,2480,310,445000
4,2.75,2290,7000,3,8,2290,0,347500
3,1.5,1190,785,3,8,920,270,277140
4,2.25,1900,5000,3,7,1400,500,658500
3,3.25,1370,915,3,8,1100,270,388000
3,3,3850,38830,3,10,3850,0,820000
4,3.25,3140,3680,3,10,2310,830,760000
4,1.5,1780,7914,4,7,1780,0,372000
3,1.75,1920,5405,4,7,960,960,490000
4,2.75,2690,25000,3,8,1750,940,563750
3,2.5,1740,1251,3,9,1180,560,601000
3,1,1410,8250,3,7,1410,0,325000
4,2.25,2620,10920,3,9,2620,0,950000
4,1.75,1780,11436,5,9,1780,0,1.00E+06
2,1.5,1010,2102,3,7,1010,0,370000
3,1.75,1480,6120,3,7,1480,0,500000
4,1.75,1760,5356,4,7,920,840,585000
4,2.5,2840,4500,3,8,2840,0,557000
2,1,770,4840,4,7,770,0,275000
3,2.5,1870,3480,3,7,1870,0,325000
3,1.75,1580,7000,3,7,1180,400,370000
3,2.25,1920,9680,4,7,1300,620,260000
2,1,920,7569,4,6,920,0,202000
2,1,810,7158,5,6,810,0,206000
4,2,3100,8000,5,7,2040,1060,1.00E+06
4,1.75,2390,5880,3,8,1390,1000,695000
3,2.75,2030,7700,5,8,1400,630,643000
3,3.75,2670,6517,4,8,2020,650,732000
2,1.75,1350,4023,3,7,1350,0,250000
4,2.5,1830,5175,3,7,1830,0,312000
3,2.5,2420,6847,3,9,2420,0,649950
2,1,1510,19874,3,7,1510,0,226000
3,2.25,1530,12000,3,7,1070,460,245000
6,4.5,2810,11214,3,8,2010,800,290000
4,3.5,3530,8126,3,10,3530,0,1.28E+06
4,3.5,3270,15160,3,8,1660,1610,600000
4,2.75,3620,35429,3,10,3620,0,680000
4,1.75,1310,9690,4,7,1310,0,323000
4,2.5,3402,14355,3,10,2846,556,498000
3,2.25,1760,10835,4,8,1290,470,440000
4,2.75,3150,7035,3,9,3150,0,800000
3,1.75,1630,9450,4,7,1080,550,240000
4,1,2140,4217,3,6,1320,820,236500
3,2.5,3220,6409,3,9,3220,0,625000
2,1.75,1000,3554,4,8,1000,0,210000
4,3.5,4030,4200,3,9,4030,0,950000
4,3.5,3640,6049,3,9,3640,0,939000
4,2.25,1700,7056,3,7,1700,0,269500
6,3.5,2580,13572,3,8,1290,1290,604000
2,1.75,1210,7733,3,6,1210,0,456200
3,2.25,1490,4539,3,7,1490,0,390000
3,2,940,5000,3,7,880,60,575000
5,2.75,2990,6370,3,8,2990,0,559950
4,2.5,2050,4502,3,7,2050,0,369950
2,1,1040,4880,3,7,1040,0,596000
3,2.25,2670,7500,4,7,1640,1030,465000
4,2.75,3410,35040,3,9,3410,0,545000
4,2.75,3160,7143,3,8,2100,1060,845000
3,3.25,1600,1882,3,8,1360,240,345000
4,2.75,3280,24440,3,10,3280,0,862500
4,1,1460,7200,4,7,1460,0,320000
4,2.5,1770,9858,3,8,1770,0,675000
4,3,2250,12142,3,8,2250,0,363000
5,1.75,2690,21357,4,7,1420,1270,730000
3,1.75,2340,51836,3,8,1510,830,459900
3,2.5,1500,7420,3,7,1000,500,379000
3,1.75,1470,10390,3,7,1470,0,262500
3,2.25,1445,1087,3,7,1300,145,355000
4,2.5,3180,10319,4,11,3180,0,1.23E+06
4,1.75,1580,8856,3,7,1580,0,259000
4,3.5,2650,3127,3,8,2230,420,674950
3,1.75,1800,23103,3,7,1800,0,284000
4,2.5,1860,6325,4,7,1860,0,291000
3,2.5,2290,6302,3,9,2290,0,440000
2,1,1060,10423,3,7,1060,0,220000
4,2.5,2650,5880,3,9,2650,0,329000
4,2.5,2518,4663,3,8,2518,0,643000
3,1,1090,6435,4,7,1090,0,365000
3,1.75,2050,11313,3,7,1520,530,252000
3,1.75,1100,1307,3,7,780,320,285000
3,1.75,1550,5000,3,7,1250,300,650000
4,2.5,2700,4004,3,9,2700,0,723000
1,1,620,8685,4,5,620,0,175000
4,2.5,2410,15899,3,9,2410,0,610000
5,1.5,1710,8100,4,7,1710,0,158550
4,2.5,1770,8155,4,6,1770,0,500000
3,2,1610,3600,5,8,1610,0,735000
4,3.25,4860,181319,3,9,4860,0,1.39E+06
5,2.25,2140,7910,3,7,1070,1070,530000
4,3.25,3420,6752,3,9,3030,390,635000
5,3.25,4300,50405,3,8,3220,1080,593500
3,1.75,2650,11774,3,8,2240,410,499000
3,1,980,7480,3,6,830,150,280000
3,2.5,1840,8250,3,8,1340,500,485000
2,1.5,1940,5700,3,7,970,970,535000
3,1,880,9238,5,6,880,0,291500
2,1.75,1510,4555,3,8,1510,0,473000
4,3.25,4160,35654,3,8,2760,1400,530000
2,2.25,1640,2240,3,8,1640,0,375000
2,1,1070,4500,3,7,1070,0,415000
4,2.75,2520,8433,3,8,2520,0,689950
4,2.75,3590,5625,3,10,3590,0,1.10E+06
4,2.75,3660,5637,3,9,3660,0,839990
4,3,2380,20277,3,8,1500,880,340000
3,1.75,2430,4524,4,7,1830,600,780000
3,3.5,4110,15720,3,10,2230,1880,1.45E+06
4,2.25,2480,6000,3,10,2380,100,979700
3,1.75,1320,2500,3,7,870,450,530000
3,2.5,2753,65005,5,9,2165,588,1.35E+06
5,1,1420,6250,4,8,1420,0,569950
4,2.25,2190,6800,5,7,1340,850,411800
3,2.5,1600,1936,3,7,1600,0,395000
2,1,1050,4125,4,7,1050,0,392500
4,1.5,1340,6200,5,6,1340,0,474905
2,1,1440,3225,3,7,960,480,445000
4,2.5,2740,7140,3,8,2740,0,651000
4,2.5,2280,14290,4,7,1510,770,622100
4,2.5,2540,6688,3,9,2540,0,365000
4,2.75,2400,20000,3,8,1170,1230,420000
3,1.5,1530,23660,3,7,1530,0,450000
5,2.25,3120,10400,3,8,3120,0,341500
3,2,1390,13464,4,7,1390,0,206600
3,1,1010,7384,5,6,1010,0,254000
3,2,2360,18000,4,8,2180,180,709000
3,2,1280,7633,3,7,1280,0,280000
4,2.75,2410,5225,3,8,2410,0,379000
5,1.75,1990,27810,3,7,1990,0,185000
4,2.5,2350,6958,3,9,2350,0,299000
2,1,850,5225,3,7,850,0,354000
4,2,1580,9600,5,7,1050,530,300000
3,2,1690,5100,5,7,1690,0,515000
4,1.75,2500,7000,3,7,1250,1250,585000
4,2,2020,2849,3,7,2020,0,595000
4,2.75,2620,13777,4,9,1720,900,978000
3,1,1450,7850,5,7,1450,0,257000
4,2.5,2210,6080,4,8,1410,800,334000
4,1.75,1820,9824,5,7,1820,0,261000
3,1.75,2150,4200,5,8,1140,1010,950000
4,2.5,2100,8220,4,8,1300,800,607000
5,1.75,1680,8400,4,7,1680,0,175000
2,1.75,1510,5319,4,8,1510,0,406500
4,2.75,1920,4400,4,6,960,960,399950
2,1,820,3000,4,7,820,0,532500
4,2.5,2840,8746,3,8,2840,0,339000
3,1.75,2300,12682,3,8,2300,0,600000
5,3.25,5790,13726,3,10,4430,1360,1.24E+06
5,3.25,3160,13238,5,8,3160,0,1.25E+06
3,1.5,1500,8272,4,7,1500,0,419000
2,1,1290,5376,3,6,1290,0,970000
2,1,960,21850,3,6,960,0,242000
3,1.75,1520,8100,5,6,760,760,475000
4,2.75,2400,104108,3,8,2400,0,590000
4,2,1830,9610,3,7,1830,0,488250
3,1,1460,8290,3,8,1460,0,399000
3,2.25,3290,5000,3,9,2730,560,1.48E+06
3,2.25,2630,9705,4,8,2630,0,1.44E+06
3,2.5,2185,6042,3,9,2185,0,374000
3,2,2250,222156,3,7,2250,0,474950
4,3.25,4190,10259,3,11,3150,1040,1.15E+06
3,2.5,1760,3097,3,8,1760,0,485000
3,1,1730,21183,3,7,1030,700,292000
4,1,1760,8906,3,7,1230,530,185000
3,1.75,1690,8190,4,8,1690,0,530000
4,2,2060,6400,3,7,1170,890,257500
4,3,2010,8171,3,8,2010,0,434000
3,2.5,1740,10050,3,7,1740,0,225000
3,2.75,3510,92347,3,10,3510,0,674950
4,2.5,1660,9760,3,7,1660,0,294999
3,2.5,2760,35171,3,9,2760,0,500000
1,1,720,6000,3,6,720,0,155000
3,2.5,1950,13227,4,9,1950,0,540000
3,2.5,1790,3078,3,8,1790,0,530000
4,1.75,2260,17711,4,9,2260,0,980000
2,1.75,1740,6620,3,8,1740,0,350000
4,4,5320,20041,3,11,5320,0,1.06E+06
3,1,870,5200,5,6,870,0,183000
4,3.5,3180,12528,4,9,2060,1120,1.00E+06
3,1.75,1460,7884,3,8,1460,0,315000
2,1.5,1940,4400,3,7,970,970,790000
3,2.5,2340,1919,4,9,2340,0,850000
4,2,1830,21183,4,7,1060,770,383000
3,2,2060,2900,5,8,1330,730,685000
3,2.25,1870,1900,3,8,1870,0,770000
2,1,1480,4080,3,7,1050,430,410000
3,1,1220,9600,5,7,1220,0,210500
3,2.5,1690,10336,4,7,1690,0,267000
6,2,2390,8660,4,7,2390,0,516250
5,2.75,3595,5639,3,9,3595,0,861990
3,1.5,1810,14400,4,7,1810,0,229500
4,2.5,2870,6776,3,8,2870,0,555000
4,1.75,2290,7380,3,7,1390,900,326000
3,1.75,1610,6480,4,7,1610,0,438750
4,1.75,2020,16120,3,7,2020,0,640000
4,3.25,3810,8519,3,10,2680,1130,1.13E+06
4,2,2200,7700,3,7,1100,1100,279000
4,2.25,2290,9900,4,8,1550,740,571000
2,1.75,1320,3420,3,7,1080,240,475000
4,2,1510,4235,3,7,1510,0,254000
4,2.75,3120,7644,3,10,3120,0,575000
4,3.5,3130,52322,3,9,2430,700,975000
4,2.5,3160,13194,5,10,3160,0,1.19E+06
3,1,1300,12600,4,7,1300,0,315500
3,2,1050,18304,4,7,1050,0,169100
3,1,1280,9000,4,6,1280,0,240000
3,1,1140,8775,3,6,990,150,197200
5,2.5,3150,9134,4,8,1640,1510,345000
3,1,1050,5156,3,7,1050,0,165000
4,3.25,2550,11524,3,8,2550,0,406250
3,1.75,1960,5000,5,6,980,980,415000
3,3.75,1950,8625,3,8,1360,590,345100
4,2.5,2710,49044,3,9,2710,0,623000
4,3.25,2290,4785,3,9,2290,0,359950
3,1.5,1800,12196,4,7,1800,0,305000
4,2,1970,6480,5,7,1130,840,423000
3,3.5,2480,3200,3,10,2480,0,910000
3,2.5,1620,1377,3,8,1100,520,640000
2,1,700,5100,4,5,700,0,208000
4,3,3000,4000,3,8,1970,1030,688000
4,2.25,1500,5393,3,7,1500,0,210000
3,2.25,2260,13209,3,9,2260,0,675000
3,2.5,2420,49928,3,8,1860,560,429000
3,1.75,2910,37461,4,7,1530,1380,570000
3,1,1400,2250,3,7,1400,0,710000
3,1,1010,7245,3,7,1010,0,199950
3,2,2880,5100,4,7,2080,800,660000
3,2,1910,11576,3,7,1410,500,390000
5,2,2270,2400,3,7,2270,0,631000
3,2.5,1540,6100,3,6,770,770,515000
4,3.25,3040,4155,3,8,2350,690,825000
4,2.25,3220,7700,4,8,3220,0,359999
3,2.5,1610,3600,3,8,1610,0,415000
1,0.75,590,5650,3,6,590,0,202000
3,1,1250,21303,3,6,1250,0,385000
3,1.75,1930,9000,4,7,1150,780,345000
4,2.5,2300,6087,3,7,2300,0,431000
5,1.75,2550,71874,5,7,1810,740,525888
2,1,1100,3598,4,7,1100,0,403000
4,2.25,2710,22860,4,7,1850,860,359000
3,1,1010,11880,3,7,1010,0,255000
4,2.5,2700,5150,3,9,2700,0,550000
3,2,1380,7476,3,7,1380,0,272000
4,2.5,2580,7465,3,8,2580,0,620000
4,2.25,1850,9911,4,7,1850,0,485000
5,1.75,2810,9360,4,7,1520,1290,368500
4,3.25,2420,4000,5,9,1870,550,920000
4,2.5,3520,8095,3,9,3520,0,760000
4,3.5,4320,8490,3,10,3280,1040,1.04E+06
3,1,1830,3000,3,7,1430,400,499950
3,2,1010,12252,3,8,1010,0,400000
4,1.75,1930,7650,4,8,1280,650,245000
3,2,1640,4802,3,8,1640,0,342000
4,3.25,4890,13402,3,13,4890,0,1.78E+06
5,2.5,3597,4972,3,7,3597,0,330000
5,2.5,2170,2752,3,8,2170,0,359800
3,1.75,1610,7350,3,8,1610,0,313500
3,2.5,1800,4400,5,7,1350,450,680000
2,1.75,1090,1950,4,8,1090,0,149900
3,1.75,1610,11950,3,7,1210,400,510000
3,3.5,1970,5079,3,8,1680,290,590000
4,3.25,4430,21000,3,10,4430,0,2.75E+06
3,1,1120,7250,4,7,1120,0,343000
4,1.75,1760,6000,3,7,880,880,620047
3,2.25,1380,1621,3,8,1140,240,475000
3,2.5,2460,108900,4,9,1860,600,600000
3,2,1490,7651,3,7,1490,0,253000
5,2.75,2160,4000,5,7,1530,630,671500
3,1.75,1440,9065,4,8,1440,0,409000
5,2.25,3020,10010,3,7,1510,1510,465000
4,2.5,3670,49658,3,10,3670,0,885250
3,2.5,3280,29111,3,11,3280,0,1.88E+06
3,1.75,2280,77972,3,8,1460,820,749700
4,1.75,2580,19607,4,8,1290,1290,383000
6,2.75,3970,9500,4,10,2180,1790,810000
3,2.5,2430,88426,4,7,1570,860,452500
3,2.5,1350,187313,4,7,1350,0,600000
3,1.75,1560,7207,3,7,1250,310,440000
5,3.25,3450,6360,5,9,1860,1590,1.38E+06
3,1,1370,56628,3,7,1370,0,229000
5,3,3640,6930,3,8,3640,0,555000
3,1,970,4700,4,6,720,250,172000
3,2.5,2410,34848,3,8,2410,0,500000
2,1,1210,4895,3,6,710,500,285000
3,2.5,1910,2091,3,8,1910,0,494815
2,1.5,1340,1210,3,8,1120,220,345000
4,2.5,3150,5757,3,9,3150,0,475000
3,1.75,1840,19501,4,8,1270,570,248000
2,1.75,1400,2500,5,7,710,690,395000
4,2.5,2110,5306,3,8,2110,0,380000
5,2,1940,6000,5,7,970,970,580000
5,2.5,3200,6455,3,9,3200,0,675000
2,2.5,1620,3196,3,8,1620,0,386000
2,1,1410,7000,3,7,1410,0,335000
3,1.75,1480,7725,4,7,1480,0,370000
4,1.75,1680,6758,3,8,1680,0,540400
2,1,1070,9750,3,7,1070,0,327000
4,2.5,2440,7322,3,9,2440,0,562500
4,3.5,3770,37034,3,10,2830,940,1.23E+06
4,2,1740,9000,5,8,1740,0,710000
4,2.5,2630,6100,3,8,2630,0,576925
3,1,1280,12928,3,6,1280,0,279900
5,2.5,2240,7770,3,7,1340,900,455000
4,1.75,1320,4978,4,7,940,380,420000
3,2,1640,5650,3,7,1640,0,279000
2,0.75,850,7710,5,6,550,300,360000
5,2,2330,6783,3,7,1310,1020,630000
4,2.5,2830,10677,3,9,2830,0,627250
3,2.5,2140,40173,4,8,2140,0,545000
4,2.5,2230,5743,3,7,2230,0,415000
3,1,1540,24500,3,7,1540,0,1.00E+06
5,1,1170,6757,4,6,800,370,397000
4,3.75,4610,40202,4,10,2500,2110,630000
3,1.5,1750,12500,3,7,1150,600,315000
4,1.75,1870,6000,5,8,1670,200,700000
2,1,840,4000,3,6,840,0,275000
4,2.5,1900,15123,3,8,1900,0,410000
3,2.5,3080,13880,3,9,3080,0,569999
5,4.5,4000,6713,3,9,4000,0,771005
3,2,1560,8640,5,7,1560,0,465000
3,2,1190,6445,3,7,1190,0,322500
3,1.5,1660,15600,3,7,1660,0,220000
3,1.75,1090,4500,5,8,1090,0,292000
3,2.25,1230,7420,5,7,1230,0,200000
3,2.25,2450,49658,3,7,1770,680,325000
3,1,1010,6120,3,6,1010,0,550000
4,2.5,3620,16000,3,9,3620,0,480000
4,2.5,3490,9030,4,8,3490,0,414000
4,3.25,3080,4287,3,10,2230,850,830000
3,2,1680,8080,3,8,1680,0,510000
3,1,1110,8423,3,7,1110,0,249000
3,2.5,2070,3599,3,8,2070,0,575000
3,2.25,1445,1471,3,7,1300,145,389999
2,1,1120,5329,3,6,750,370,320000
3,2.5,1470,1204,3,8,1470,0,408000
5,2.5,3220,5751,3,8,3220,0,315000
3,3,1720,70567,5,7,1720,0,550388
4,2.5,3148,9612,3,9,3148,0,550000
3,3.75,6030,39317,3,11,4440,1590,1.83E+06
5,3.5,3920,5150,3,9,2820,1100,918000
4,3.25,5010,34460,3,12,5010,0,1.47E+06
2,1.5,1180,1722,3,8,1180,0,399500
4,2.5,2240,9701,3,9,2240,0,335000
3,2.5,3450,8000,4,8,2970,480,685000
4,2.5,2400,10070,3,7,1510,890,525000
3,2.25,1570,7200,3,8,1570,0,447450
3,1,1120,2300,4,7,820,300,552000
4,2.25,1940,8270,5,7,1940,0,530000
4,3.5,3200,8049,3,8,2700,500,935100
4,2.5,2560,43560,3,8,2560,0,390000
3,2,1820,7750,3,8,1820,0,270000
3,2.5,3420,25150,4,10,1750,1670,789900
3,2,2020,38332,4,7,1010,1010,420000
3,1.75,1350,9793,4,7,1350,0,225000
3,1,970,7700,4,7,970,0,205000
3,2,2330,6346,3,6,1600,730,420000
4,2.5,2620,8960,5,7,1520,1100,405000
2,1,990,8140,1,6,990,0,210000
4,1.75,2110,7208,3,8,1170,940,324000
3,1.75,1490,8357,4,7,1490,0,260250
4,1.5,1980,3240,4,8,1780,200,615000
2,1,910,7000,3,7,910,0,389000
3,1,1200,7220,3,6,1200,0,225205
4,2.25,2650,8149,4,8,1610,1040,665000
3,1.75,1650,8073,3,7,1100,550,234975
4,2.5,3080,4553,3,8,3080,0,750000
2,1,1090,5000,4,7,730,360,356700
3,2.5,2390,8000,3,8,2390,0,363000
2,2.75,1950,1610,3,8,1950,0,555000
5,2.5,3000,7912,3,9,1610,1390,770000
3,2,2010,4000,5,7,1210,800,875000
1,1,630,1362,3,7,630,0,430000
3,1.75,1560,5760,5,6,780,780,353900
5,3,2800,5700,3,8,2800,0,639983
4,1,1540,7350,4,6,770,770,160000
3,2.5,2210,9226,3,8,2210,0,432900
3,2,1660,10000,4,7,1010,650,529941
4,2.5,1740,7895,3,7,1740,0,302000
4,2.25,2400,7000,4,8,1800,600,487000
3,1,1010,5400,3,6,1010,0,317000
3,2.5,1940,4000,5,7,1940,0,725000
3,2.5,2790,6720,3,8,2790,0,650000
3,1.75,2080,5969,3,7,1080,1000,329950
5,2.5,2300,23345,5,7,1170,1130,453500
5,3.25,2750,7500,3,7,2150,600,750000
5,2.5,3340,24755,3,10,3340,0,699000
4,2.75,3310,6166,3,9,3310,0,658000
3,1,1080,10500,3,7,1080,0,132500
4,2.5,2390,5071,3,9,1760,630,845000
2,1,1210,7440,3,6,780,430,326000
4,1.75,2520,8442,4,7,1640,880,770000
3,2,1280,6994,3,7,1280,0,215000
4,2.25,1800,9018,3,7,1800,0,272000
4,2.5,2303,3826,3,8,2303,0,300000
4,4,4090,51908,3,11,4090,0,1.04E+06
2,1.75,1670,6460,3,8,1670,0,507000
3,2.5,2010,2261,3,8,1390,620,550000
4,3,2230,52983,3,8,2230,0,460000
4,2.5,2927,6000,3,7,2927,0,407000
7,2.25,2620,6890,4,7,2620,0,539000
2,2,1270,3881,4,6,610,660,512000
3,2.25,1620,997,3,8,1540,80,425000
4,2.5,2090,11645,3,7,1200,890,311000
3,2.5,2500,7746,4,10,1910,590,895000
2,1,850,2850,4,7,850,0,489000
3,2.5,3545,9816,3,10,2610,935,1.03E+06
4,2,1770,5000,4,7,1770,0,632500
4,2.5,2650,5706,3,9,2650,0,370000
5,1.75,2020,6565,3,8,1120,900,640000
3,1.75,1540,8400,3,7,1540,0,900000
3,2.5,1840,5011,3,8,1840,0,317000
3,1.5,1500,6337,5,7,1500,0,270000
3,1.5,1370,9720,3,7,1370,0,375000
4,2.75,2310,4020,5,8,2310,0,890000
4,2.25,2100,7305,4,7,1050,1050,335000
3,3,1833,1706,3,9,1833,0,719000
4,1.75,2780,9900,4,10,2780,0,660000
2,2.5,1900,5065,3,8,1900,0,505000
3,2.5,1850,7777,5,8,1850,0,623000
2,2,1690,4500,3,8,1690,0,564000
4,2.5,2200,4000,5,8,1430,770,930000
3,1,1800,7200,3,7,1020,780,500000
3,2.5,2150,8221,3,8,2150,0,470000
4,2.25,2770,13500,3,8,2770,0,890000
3,3.25,3870,33980,3,10,3150,720,900000
3,2.5,1190,3000,3,7,1190,0,229000
2,2,2280,641203,3,9,2280,0,849900
4,2.75,2740,6200,4,8,1820,920,775000
3,1.75,1610,7200,3,8,1090,520,1.18E+06
3,1.75,1580,7416,3,7,1150,430,600000
3,1.75,1899,11325,3,7,1899,0,289900
4,3,2920,33976,5,8,1460,1460,1.05E+06
4,2.5,2000,13300,4,7,1200,800,290000
2,1,1480,4080,3,7,1050,430,778100
4,2.5,2510,7245,3,9,2510,0,375000
2,1.5,1800,4500,3,7,1000,800,930000
4,3,2770,2650,3,9,2180,590,1.11E+06
4,2.5,2600,11951,3,10,2600,0,402500
2,1,1020,8102,3,7,1020,0,310000
3,2.5,2060,8893,3,8,2060,0,610000
3,1,1250,7320,3,7,1250,0,309500
4,1.75,1560,4290,3,7,1560,0,270000
5,4,2980,4500,3,7,2070,910,850000
3,1,1070,6440,4,7,1070,0,194000
4,2.25,1980,9714,3,7,1170,810,286285
4,2.5,3281,5354,3,9,3281,0,471835
3,2.5,1040,2643,3,7,720,320,210000
4,3.5,3440,6000,4,8,3440,0,455000
3,1.75,1330,13102,3,7,1330,0,225000
3,1.75,1490,10125,4,7,1490,0,184000
3,2.5,2210,5750,3,7,1710,500,426000
3,1.75,1490,11360,3,8,1490,0,490000
3,1,1160,7912,4,7,1160,0,330000
4,2.5,2500,11070,4,8,1300,1200,380000
3,2.5,1980,4500,3,7,1980,0,317750
3,2.5,1530,3840,3,8,1530,0,449950
4,2,1710,8288,3,7,1710,0,211000
6,3.75,4210,6105,3,9,3280,930,900000
3,2.5,2590,4961,3,9,2590,0,690000
4,2.75,1750,5080,3,8,1750,0,750000
3,1.5,1060,6954,4,6,1060,0,310000
3,2.25,1910,8390,3,7,1910,0,531000
3,1,940,19000,3,6,940,0,600000
3,1,1400,4800,4,6,700,700,435000
3,1.75,2040,273556,3,7,2040,0,467500
4,2,1610,5000,5,7,1610,0,630000
4,2.5,2450,20348,3,8,1410,1040,450000
2,2.5,1430,1201,3,8,1430,0,505000
3,2.25,1920,9672,4,8,1920,0,625000
3,1.75,1650,9480,3,7,1220,430,305000
2,2.5,1730,1037,3,8,1730,0,479000
3,2.5,1670,8364,4,7,1300,370,270000
3,1.75,1240,13869,4,7,1240,0,675000
4,2.25,2380,128937,4,7,2380,0,276500
4,2.25,3780,5160,4,9,2510,1270,1.40E+06
3,2.25,2140,10256,3,8,2140,0,393000
3,1.75,1950,6504,3,8,1530,420,447500
4,2.75,2730,9112,3,9,1740,990,510000
3,2.25,2140,9775,4,7,1470,670,210000
3,2.25,1920,4833,4,7,1060,860,385000
4,2.75,4270,25807,3,11,4270,0,1.61E+06
4,2,1940,5000,4,7,980,960,639000
4,3.25,3410,34939,4,9,2470,940,585000
4,2.5,1990,2660,3,8,1990,0,537000
3,2.5,1600,26977,3,8,1600,0,330000
4,2.5,3130,10860,3,10,3130,0,745000
3,2.75,1670,1350,3,9,1350,320,649950
4,2.5,2470,3811,3,8,2470,0,449950
4,2.5,2680,7513,3,8,2680,0,437500
2,2.5,1278,987,3,7,1002,276,358000
4,2.5,2790,4650,3,8,2790,0,378000
5,4.5,4280,8465,3,10,4280,0,995500
4,2.75,2890,46609,4,9,2890,0,655000
3,3.25,4340,4947,3,11,3060,1280,2.48E+06
2,2.5,1310,2915,3,8,1310,0,330000
2,1,1100,7323,3,7,780,320,179950
3,1.75,1490,16200,5,8,1490,0,685650
3,2,1360,3090,3,8,1360,0,532170
2,1.5,1490,5750,4,7,1190,300,625000
3,2.25,2880,7200,3,8,1710,1170,499950
4,1,1640,6305,5,6,1640,0,519000
5,1.75,2080,217800,5,7,2080,0,480000
3,2,1520,7131,3,8,1520,0,241000
5,3.5,3450,28324,5,8,2350,1100,850000
3,2.5,1509,1418,3,8,1509,0,410000
3,1.5,1210,5200,5,6,1210,0,132825
2,1.5,830,1119,3,7,830,0,329445
2,1,1020,15000,3,6,1020,0,245000
4,1.75,1000,7200,4,6,1000,0,305000
4,2.75,3120,34040,3,9,3120,0,615000
2,1.5,1850,4945,4,7,1850,0,700000
4,2.75,2880,4000,3,9,2100,780,755000
5,1.75,1970,8925,5,7,1170,800,255000
4,2.5,3330,9557,3,10,3330,0,905000
5,3.5,4000,9234,3,9,4000,0,802945
3,2.5,1970,14876,3,7,1320,650,540000
2,1,690,5200,3,6,690,0,340000
3,2.5,1590,4094,3,7,1590,0,454000
3,1,920,4429,3,7,920,0,250000
4,2.5,2910,7364,3,10,2910,0,1.43E+06
2,1,910,9000,3,5,910,0,244500
4,3,2490,4325,3,8,1690,800,1.08E+06
4,3.5,2540,5808,5,8,1820,720,799990
3,1,1300,10236,4,6,1300,0,350000
3,2.5,1610,3517,3,8,1610,0,249900
3,3.5,2880,11340,3,8,1690,1190,1.02E+06
3,2,2660,257875,4,8,1530,1130,650000
3,2.5,2320,5760,3,7,1480,840,375000
3,2.25,1240,949,3,8,1240,0,543000
3,1,1110,5000,3,7,1110,0,560000
2,2.5,1470,2034,4,8,1470,0,419000
4,2.5,2730,7649,3,7,2730,0,507000
4,2.75,3110,11225,3,8,3110,0,600000
2,3.25,1400,1243,3,8,1400,0,474800
3,2,1720,4200,3,8,1720,0,713500
3,2.5,1730,8076,3,8,1730,0,297262
2,1.75,1120,758,3,7,1120,0,305000
4,2,1470,7000,4,8,1470,0,215000
4,1.75,1730,9520,4,7,1730,0,320000
3,1.75,1650,16200,3,7,1650,0,264500
4,2.5,1960,3543,3,7,1960,0,325000
4,2.5,2700,4275,3,9,2700,0,1.20E+06
5,5.25,5090,23669,3,12,5090,0,3.10E+06
3,1.75,1880,45738,4,8,1410,470,550000
2,2,1670,3507,3,9,1670,0,539950
2,2,1270,5500,4,8,1270,0,605000
4,2.75,2300,37533,5,8,1550,750,453000
3,1,1100,7650,3,7,1100,0,392500
4,3.5,5490,14300,3,12,2910,2580,1.79E+06
3,1.75,1330,10523,3,7,1000,330,295500
2,1,1000,4950,3,7,800,200,525000
2,1,1180,5100,3,7,1180,0,447500
3,2.5,2080,9827,3,8,2080,0,300000
2,1.75,3490,88909,3,10,2320,1170,952000
2,2,970,9750,5,6,970,0,303000
3,2.5,3910,14000,3,10,3910,0,961500
4,2.75,2840,4864,3,9,2840,0,779950
3,1.75,1670,24650,4,7,1670,0,245000
4,2.75,3540,13515,3,10,3540,0,820000
2,1,1390,8336,4,6,910,480,365000
3,1.75,1400,8640,3,7,1400,0,395000
3,1,1120,8321,4,6,1120,0,401000
3,1.75,1330,36537,4,7,1330,0,257000
3,2.5,2540,4775,3,7,2540,0,310000
3,1.5,1090,5003,3,7,1090,0,350000
3,1.5,1200,9120,3,7,1000,200,203000
3,1.5,1250,7500,3,7,1250,0,225000
4,2.75,3160,42733,3,9,3160,0,1.08E+06
4,1.5,2310,68824,4,7,2310,0,407450
4,1.75,1820,22043,4,7,1820,0,290000
3,1.5,1620,21929,3,7,1620,0,387000
5,2.5,2270,10700,4,8,1570,700,526750
3,1.75,2720,149410,3,9,2720,0,535000
2,2,1660,5200,5,7,1120,540,601150
3,2.75,2500,6350,5,9,2370,130,990000
4,2,1220,9147,5,7,1220,0,287500
4,2,2390,23972,3,7,1720,670,307000
4,2.5,2470,35073,3,9,2470,0,485000
3,2.5,1430,8470,3,7,1190,240,270000
3,2.25,2190,8775,4,8,2190,0,587450
3,1,980,7228,3,7,980,0,340000
4,2.5,2100,14773,3,8,2100,0,305000
3,2.5,2230,5348,3,8,2230,0,490000
4,4,4420,5940,3,10,3410,1010,909500
3,3.25,1610,1275,3,8,1220,390,630000
5,3,3850,14990,4,9,2290,1560,1.40E+06
4,1,1650,9750,4,7,1650,0,282500
4,1.75,1960,8400,4,8,1960,0,260000
3,1,1190,4120,3,6,1190,0,320000
3,1,1050,6240,5,5,1050,0,208000
3,2,1640,4218,4,7,910,730,645000
3,2.25,1680,8450,3,8,1340,340,385000
4,1.75,3020,10714,5,8,1510,1510,622000
4,3.5,4210,6481,3,9,3260,950,1.05E+06
5,1,1120,9022,4,7,1120,0,340000
3,2.5,2160,3000,3,7,1260,900,378750
3,2.5,2580,23925,3,9,2580,0,499950
3,1.5,1440,28516,4,7,1440,0,456000
3,2.5,1940,10800,3,8,1340,600,432500
4,3,2950,5000,3,9,1980,970,650000
2,2.5,1400,1262,3,8,1160,240,299000
4,2.5,3190,14565,3,11,3190,0,870000
2,1.75,1370,4495,4,8,1370,0,276200
4,2.5,2714,12558,3,9,2714,0,485230
2,1,1210,7040,3,7,1210,0,320000
3,2.5,1220,1330,3,8,1010,210,457000
2,2,1500,1408,3,7,1500,0,308625
6,3.5,2400,8620,3,8,1640,760,435000
4,3.5,4700,10183,3,11,2660,2040,1.24E+06
3,1,1430,3455,3,7,980,450,511000
3,2.5,2670,12187,3,8,2670,0,744000
4,2,2510,9750,3,8,1630,880,479900
5,4.25,4660,16200,3,11,4660,0,2.64E+06
3,2.25,1620,7566,3,7,1620,0,280500
3,1,1010,11880,3,7,1010,0,145000
3,1,1880,5450,4,8,1880,0,1.00E+06
5,3,3100,5250,3,7,3100,0,539950
1,1,700,2550,3,6,700,0,415000
4,2.25,1600,15312,4,7,1080,520,299500
3,2.5,1580,6860,3,7,1580,0,290000
3,3,2010,2554,3,7,1860,150,475000
5,3.5,3580,21343,4,8,2140,1440,600000
4,3.75,4160,35000,3,11,4160,0,1.15E+06
3,1.5,2120,4370,3,8,2120,0,733500
2,1,980,4120,3,7,830,150,535000
3,1.75,1790,7650,3,9,1790,0,299950
4,2.5,2370,10000,5,8,1660,710,715000
4,2,1730,3884,5,7,1060,670,569000
6,4.5,6040,219542,3,11,4100,1940,1.15E+06
4,5,5810,7440,3,10,3790,2020,1.88E+06
4,2.5,2150,3721,3,8,2150,0,275000
2,1.5,720,5120,3,6,720,0,181000
3,2.5,2060,4200,3,8,2060,0,326989
4,2.5,3220,4400,3,9,2180,1040,862500
3,2,1130,7200,4,6,1130,0,262500
3,2.5,2020,26670,3,7,2020,0,309900
3,1,970,6180,3,6,970,0,360500
3,2,1570,14992,3,8,1570,0,340000
3,2.5,3070,22098,3,9,3070,0,529000
3,1.75,1590,27200,4,6,1590,0,280000
3,2,1770,9685,3,5,1770,0,315000
4,1,1450,6820,3,6,1450,0,375000
4,2.5,3140,12792,4,9,3140,0,400000
2,1.75,1230,1107,3,8,1230,0,360000
4,2.5,2506,7206,3,8,2506,0,350000
4,1.5,1240,8158,4,7,1110,130,265000
4,3.5,4270,40097,4,12,4270,0,1.10E+06
3,1.75,1980,273556,3,6,1040,940,350000
3,2.5,2180,7508,4,7,1420,760,400000
2,1,840,4239,3,7,840,0,325000
4,2.75,3020,13530,4,8,1540,1480,670000
3,2.5,2415,2186,3,9,2415,0,815000
5,3.5,3290,5600,3,9,2670,620,775000
3,1,1040,7288,3,7,1040,0,324950
4,1,2020,18150,4,7,2020,0,345000
1,1,670,4920,3,5,670,0,310000
2,1,840,6654,3,7,840,0,130000
3,2.5,1320,1780,3,7,880,440,221000
2,1,1000,6500,4,7,1000,0,431000
7,8,13540,307752,3,12,9410,4130,2.28E+06
3,2.5,2160,3920,3,9,2160,0,856000
2,1,1460,6000,2,7,1260,200,312000
5,3.75,5340,10655,4,10,3740,1600,2.10E+06
3,2.5,2590,7720,3,9,2590,0,809000
3,1.75,1510,18439,3,7,1510,0,374000
3,1,1400,4980,3,6,950,450,359950
3,1.75,1880,16262,5,7,1880,0,334950
3,2.5,1680,11193,3,8,1680,0,306000
3,1,1160,10500,4,7,1160,0,315500
2,1,790,7252,3,5,790,0,115000
3,2.5,1630,8346,3,8,1630,0,264500
2,0.75,1040,4000,3,7,930,110,550000
2,1,870,5000,3,6,870,0,235000
3,1.75,1240,8611,4,7,1240,0,380000
4,2.75,3370,8103,3,9,1970,1400,1.14E+06
3,2,1290,5757,3,7,1290,0,200000
4,2.5,2390,53941,3,8,2390,0,682000
3,1.75,1210,8864,3,7,1210,0,244500
3,2.5,1620,5250,3,8,1620,0,240000
5,4.25,3920,16258,3,9,2900,1020,1.00E+06
2,2,1350,4220,3,8,1350,0,480000
4,2.5,2420,4500,3,7,2420,0,597400
4,2.25,1750,10160,3,8,1320,430,542500
3,1.5,1180,9048,3,7,1180,0,193000
4,2.5,2860,12394,3,10,2860,0,655000
4,2.5,2660,5500,3,9,2660,0,753888
4,2.5,2070,4310,3,7,2070,0,430000
3,2.5,1850,6676,3,7,1850,0,268000
4,1.75,1820,6000,3,7,930,890,425000
4,2.5,1930,7862,3,7,1930,0,339500
4,2,1760,4500,5,7,1760,0,720000
3,2.25,1570,3109,3,8,1570,0,273950
4,4.25,3720,5750,3,9,2960,760,1.05E+06
4,2.5,1990,8034,4,10,1990,0,639000
4,2.25,2040,8315,4,8,1480,560,760000
5,3.25,3480,6507,3,9,3480,0,864327
3,2.5,2240,6097,3,8,2240,0,315000
4,3.25,5050,20100,3,11,4750,300,2.90E+06
4,1.5,2670,10026,3,8,2670,0,347000
2,2,1470,2541,3,6,1470,0,249900
4,2.5,2370,9135,4,8,1600,770,600000
3,1.75,1480,6360,3,7,1480,0,465000
5,2.75,3490,8230,3,10,3490,0,759000
5,2.5,2630,8470,4,8,2630,0,270000
2,1.75,1930,5570,3,8,1930,0,515000
3,1.5,1960,2400,3,8,1330,630,792500
4,1.75,1870,10450,3,8,1620,250,660000
5,1.5,1940,3430,4,6,1220,720,565000
3,1.75,2320,6090,3,8,2040,280,1.07E+06
5,2.5,3410,4726,3,9,3410,0,800000
2,1,780,2750,4,7,780,0,464050
3,1.75,1400,4000,3,7,870,530,510250
3,1.5,1630,16170,3,7,1630,0,375000
4,2.75,2190,6740,3,7,2190,0,361500
4,2.5,2210,4861,3,9,2210,0,650000
3,2.25,3280,79279,3,10,3280,0,645000
3,1.75,1650,9500,3,8,1650,0,485000
4,3.5,4380,74052,3,11,4380,0,1.30E+06
2,1.75,1600,4000,5,7,850,750,690000
3,2.25,1820,8316,5,7,1320,500,680000
2,1.75,1070,1276,3,8,1070,0,462550
2,2.5,1175,1366,3,8,740,435,342000
3,1.5,1230,10125,3,7,1230,0,147500
3,1.75,1400,4000,4,7,1400,0,545000
2,1,910,5525,2,6,910,0,370000
3,2.25,1950,3600,5,8,1430,520,850000
3,2.25,2040,435600,4,7,2040,0,525000
4,1.75,2000,3988,4,7,1000,1000,810000
4,2.5,2620,9873,3,8,2620,0,600000
2,1,720,4222,4,5,720,0,151000
3,1,1010,7690,4,6,1010,0,255000
3,3.75,2460,7630,5,8,1940,520,750000
3,3.5,3940,11632,3,10,3940,0,857326
3,1,930,7590,3,6,820,110,200000
4,1.5,2220,12385,3,8,1270,950,456000
4,2.5,2940,6000,3,8,2940,0,560000
2,1.75,1230,5418,3,8,990,240,575000
4,3,4040,19700,3,11,4040,0,988000
4,2.5,3100,5700,3,9,3100,0,499000
2,2.5,1380,889,3,7,1140,240,294000
4,2.75,2840,11900,4,9,1640,1200,790000
0,2.5,1810,5669,3,7,1810,0,240000
3,2.5,2040,3810,3,8,2040,0,208633
4,1.75,2050,8913,3,7,1330,720,485000
3,2,1340,1480,3,8,1340,0,369000
2,2.5,2330,3000,3,8,2330,0,577500
3,2,2570,233481,4,8,2570,0,435000
4,3.5,2490,18042,3,8,2490,0,495000
4,2,2070,7830,5,7,1180,890,699950
4,2.25,2240,9600,3,8,2240,0,327500
4,2.5,2550,7312,3,9,2550,0,699000
5,2.75,2350,4178,3,8,1520,830,585000
2,1.75,1170,2400,4,7,740,430,499000
3,1.75,2040,4125,4,8,1540,500,710500
4,3.5,3060,4777,3,9,3060,0,740000
2,2.25,1350,1248,3,7,1180,170,482000
3,2.5,2180,37042,3,9,2180,0,650000
3,2.5,1870,1058,3,8,1380,490,565000
3,2.25,3530,13000,4,10,3530,0,583500
4,1.75,1700,6000,3,7,1700,0,148900
4,2.5,2301,6452,3,9,2301,0,375500
4,2,2530,5650,4,8,1910,620,631500
3,1.75,1550,7820,4,7,1210,340,440000
4,1.75,2450,13300,4,9,1630,820,760000
4,1.75,2440,11793,3,8,1420,1020,925000
2,1,720,6687,3,6,720,0,329350
4,2.75,2420,10962,3,8,1530,890,725000
2,1,1540,6872,4,7,820,720,615000
4,1.5,2070,7245,4,7,1060,1010,235000
3,2,1590,11222,4,7,1590,0,485000
4,1.75,2640,8215,4,7,1500,1140,650000
2,1,780,4132,3,7,780,0,289000
5,1.75,2460,6846,5,7,1340,1120,445000
5,3.5,3890,13261,3,9,2870,1020,985000
3,2.5,1500,3060,3,7,1500,0,295000
3,2.5,2110,9773,3,9,2110,0,780000
4,1.5,1730,7020,4,5,1730,0,268000
3,1.75,1970,8000,4,8,1970,0,525000
3,2.5,2260,9577,3,8,1700,560,900000
5,1.75,2040,5280,4,7,1020,1020,520000
4,2.5,3190,27806,3,9,3190,0,625000
